id,CPU (cores),Memory (GB),Executor,Arrival Time (T_A),Start Time (T_S),Finish Time (T_F),Waiting Time (T_W),Estimated Finish Time (T_est),Deadline Violation Time (T_D),Deadline Satisfied,Placement List
job-0,1,6,7,68,68,117,0,49,128,true,L-l-0 L-l-0 L-l-0 L-l-0 L-l-0 L-l-0 L-l-0 
job-1,6,7,2,112,112,752,0,640,997,true,C-m-0 L-m-0 
job-2,4,4,6,171,752,785,581,33,437,false,L-m-0 L-s-0 L-l-0 L-l-0 L-m-0 L-l-0 
job-3,4,6,8,228,752,838,524,86,555,false,C-l-2 C-l-2 C-m-0 C-l-0 C-l-2 C-l-0 C-l-0 C-m-0 
job-4,2,7,5,285,752,931,467,179,666,false,C-l-1 C-l-1 C-l-1 C-l-1 C-l-1 
job-5,4,11,8,338,785,1061,447,276,804,false,C-s-0 L-l-0 L-l-0 C-s-1 L-l-0 L-m-0 L-s-0 L-m-0 
job-6,4,4,2,395,1061,1126,666,65,654,false,L-m-0 L-m-0 
job-7,3,10,5,455,1061,1361,606,300,996,false,L-s-0 L-l-0 L-l-0 L-l-0 L-l-0 
job-8,5,5,5,504,1361,1378,857,17,813,false,L-l-0 L-l-0 C-l-0 L-m-0 C-l-0 
job-9,6,8,6,556,1361,1814,805,453,1307,false,C-m-0 C-l-1 C-l-1 C-m-1 C-l-2 C-l-2 
job-11,5,10,2,667,1814,1836,1147,22,938,false,C-m-0 L-m-0 
job-10,6,9,2,614,1814,1860,1200,46,771,false,L-l-0 L-l-0 
job-12,6,7,3,716,1814,2025,1098,211,1174,false,C-l-0 C-l-0 C-m-1 
job-13,3,12,5,780,2025,2060,1245,35,938,false,L-l-0 L-s-0 L-l-0 L-l-0 L-l-0 
job-14,6,4,7,832,2025,2127,1193,102,1037,false,L-m-0 C-l-1 C-l-0 C-l-0 C-l-1 C-l-2 C-l-2 
job-15,5,9,6,877,2127,2249,1250,122,1290,false,L-m-0 C-l-0 C-l-0 C-m-0 L-l-0 L-l-0 
job-17,2,4,7,976,2249,2264,1273,15,1158,false,C-m-0 L-m-0 L-m-0 C-m-0 C-m-0 L-m-0 C-m-0 
job-18,1,7,4,1021,2249,2266,1228,17,1126,false,C-s-1 L-m-0 C-s-1 L-m-0 
job-16,2,5,8,929,2249,2273,1320,24,1230,false,L-l-0 L-s-0 L-l-0 L-l-0 L-l-0 L-s-0 L-l-0 L-l-0 
job-19,5,9,2,1061,2249,2321,1188,72,1395,false,C-l-0 C-l-0 
job-20,1,8,7,1111,2249,2533,1138,284,1606,false,C-l-1 C-l-1 C-l-1 C-l-0 C-l-1 C-l-1 C-l-0 
job-21,3,11,2,1159,2533,2583,1374,50,1450,false,L-m-0 L-m-0 
job-22,4,7,3,1208,2533,2704,1325,171,1423,false,L-l-0 L-l-0 L-l-0 
job-23,2,9,3,1258,2704,2736,1446,32,1570,false,L-m-0 L-m-0 L-m-0 
job-24,5,4,6,1317,2704,2812,1387,108,1442,false,C-l-0 L-l-0 C-l-1 C-l-1 C-l-0 L-l-0 
job-25,1,10,7,1374,2704,2945,1330,241,1903,false,L-s-0 C-l-1 L-l-0 C-l-0 C-l-1 L-l-0 C-l-0 
job-26,3,12,3,1424,2704,3108,1280,404,1843,false,C-m-0 C-m-0 C-s-1 
job-27,1,8,4,1478,3108,3157,1630,49,1643,false,L-m-0 L-m-0 L-m-0 L-m-0 
job-28,4,4,3,1518,3108,3404,1590,296,2008,false,L-l-0 L-l-0 L-l-0 
job-29,2,7,4,1581,3404,3422,1823,18,1609,false,L-m-0 L-m-0 L-m-0 L-m-0 
job-30,4,9,5,1621,3404,3422,1783,18,1685,false,C-s-1 L-s-0 L-l-0 L-l-0 L-l-0 
job-31,6,8,1,1683,3404,3467,1721,63,1790,false,C-m-0 
job-32,4,12,3,1725,3467,3486,1742,19,1998,false,L-m-0 L-m-0 L-s-0 
job-33,5,11,6,1784,3467,3778,1683,311,2152,false,L-l-0 C-l-1 C-l-0 C-l-1 C-l-0 L-l-0 
job-34,6,8,2,1839,3778,3818,1939,40,2103,false,L-l-0 L-l-0 
job-36,2,5,7,1942,3778,3847,1836,69,2020,false,L-m-0 C-l-1 C-l-1 C-l-1 C-l-1 C-l-1 C-l-1 
job-35,3,11,7,1891,3778,3883,1887,105,2059,false,L-s-0 C-l-0 C-l-0 L-m-0 C-l-0 C-l-0 L-m-0 
job-37,5,10,3,1992,3883,3903,1891,20,2264,false,L-l-0 L-l-0 L-m-0 
job-38,2,12,3,2042,3883,3904,1841,21,2311,false,L-s-0 L-l-0 L-m-0 
job-40,1,10,3,2125,3904,3939,1779,35,2264,false,L-m-0 L-m-0 L-s-0 
job-39,1,6,1,2078,3904,4006,1826,102,2403,false,L-s-0 
job-41,1,7,7,2172,3904,4038,1732,134,2332,false,L-l-0 L-l-0 L-m-0 L-l-0 L-l-0 L-l-0 L-l-0 
job-42,5,10,3,2224,3904,4154,1680,250,2486,false,C-l-0 C-m-0 C-l-0 
job-44,6,5,8,2318,4154,4172,1836,18,2500,false,C-l-0 C-l-2 C-l-0 C-l-1 C-l-1 C-l-2 C-m-1 C-m-0 
job-43,4,5,5,2274,4154,4214,1880,60,2453,false,L-m-0 L-l-0 L-l-0 L-l-0 L-m-0 
job-45,2,12,8,2369,4154,4264,1785,110,2595,false,C-s-2 C-m-2 C-s-0 C-s-1 C-m-2 C-m-0 L-s-0 C-m-1 
job-46,5,9,1,2424,4264,4274,1840,10,2648,false,L-m-0 
job-47,6,7,7,2465,4264,4366,1799,102,2624,false,C-m-0 C-l-1 C-l-0 L-l-0 C-l-0 C-l-1 L-l-0 
job-49,6,7,6,2555,4366,4389,1811,23,2800,false,C-m-0 C-l-1 L-m-0 L-l-0 C-l-1 L-l-0 
job-48,1,11,2,2513,4366,4405,1853,39,2571,false,L-m-0 L-m-0 
job-52,5,5,8,2707,4405,4448,1698,43,2915,false,C-m-0 C-l-2 L-l-0 C-l-2 C-l-1 L-l-0 C-l-1 L-m-0 
job-51,1,12,6,2656,4366,4489,1710,123,2959,false,C-l-0 C-m-0 C-m-0 C-l-0 C-l-0 C-l-0 
job-53,5,10,5,2758,4489,4509,1731,20,2932,false,C-l-0 L-l-0 L-l-0 L-m-0 C-l-0 
job-50,4,6,1,2601,4366,4513,1765,147,3034,false,L-s-0 
job-54,6,8,6,2823,4489,4528,1666,39,3059,false,C-m-1 C-l-1 C-l-1 C-m-0 C-l-2 C-l-2 
job-55,6,10,3,2867,4509,4533,1642,24,2937,false,L-l-0 L-l-0 L-m-0 
job-56,4,11,3,2902,4528,4539,1626,11,3133,false,L-s-0 C-m-1 C-m-1 
job-58,3,8,8,2968,4528,4618,1560,90,3100,false,C-l-0 C-l-1 C-l-1 C-l-1 C-l-1 C-l-0 C-l-0 C-l-0 
job-57,2,7,6,2932,4528,4624,1596,96,3067,false,C-l-2 C-l-2 L-m-0 C-l-2 C-l-2 C-l-2 
job-59,6,11,2,3010,4528,4755,1518,227,3446,false,C-m-0 C-m-2 
job-60,6,10,8,3071,4618,4763,1547,145,3355,false,C-m-1 C-l-1 C-l-0 C-l-0 C-l-1 L-l-0 L-l-0 L-m-0 
job-62,5,6,5,3162,4763,4855,1601,92,3438,false,L-m-0 C-m-0 L-l-0 C-m-1 L-l-0 
job-61,2,8,3,3117,4755,4928,1638,173,3432,false,L-s-0 C-m-1 L-m-0 
job-63,5,10,3,3213,4763,5114,1550,351,3841,false,C-l-0 C-m-2 C-l-0 
job-64,3,6,8,3265,5114,5146,1849,32,3368,false,C-s-1 L-l-0 L-s-0 L-l-0 L-l-0 L-l-0 L-m-0 L-m-0 
job-65,5,4,1,3305,5114,5420,1809,306,3866,false,C-m-0 
job-66,3,11,6,3349,5420,5450,2071,30,3648,false,L-m-0 L-l-0 L-l-0 L-l-0 L-m-0 L-l-0 
job-67,3,4,1,3409,5420,5534,2011,114,3791,false,L-s-0 
job-68,2,11,4,3458,5420,5548,1962,128,3749,false,C-l-0 C-l-0 C-l-0 C-l-0 
job-70,6,7,7,3564,5534,5554,1970,20,3700,false,L-m-0 C-l-2 C-l-1 C-m-0 C-l-2 C-l-1 C-m-1 
job-69,1,11,4,3514,5534,5577,2020,43,3625,false,L-l-0 L-l-0 L-l-0 L-l-0 
job-71,1,6,4,3606,5554,5609,1948,55,3709,false,L-m-0 L-m-0 L-m-0 L-m-0 
job-72,6,8,2,3649,5554,5849,1905,295,4055,false,C-l-0 C-l-0 
job-73,2,8,5,3698,5849,5971,2151,122,4024,false,L-l-0 L-l-0 L-l-0 L-l-0 L-l-0 
job-74,3,7,8,3745,5849,6011,2104,162,4097,false,L-s-0 C-l-0 C-l-0 C-l-0 C-l-0 L-m-0 C-s-1 L-m-0 
job-75,1,12,1,3799,6011,6085,2212,74,4172,false,L-s-0 
job-76,6,4,4,3851,6011,6085,2160,74,4140,false,L-m-0 L-l-0 L-l-0 C-m-0 
job-77,6,8,1,3900,6085,6119,2185,34,3966,false,C-m-1 
job-78,5,9,7,3936,6085,6432,2149,347,4359,false,C-l-0 C-l-1 C-l-1 C-l-2 C-l-0 C-m-2 C-l-2 
job-79,4,5,3,3976,6085,6471,2109,386,4539,false,C-s-1 C-s-2 L-s-0 
job-80,3,11,5,4028,6432,6488,2404,56,4288,false,L-l-0 L-m-0 L-m-0 L-l-0 L-l-0 
job-82,3,8,5,4110,6488,6508,2378,20,4140,false,L-l-0 L-l-0 L-m-0 L-l-0 L-l-0 
job-81,2,9,2,4065,6488,6531,2423,43,4188,false,L-m-0 L-m-0 
job-83,5,5,6,4161,6488,6619,2327,131,4404,false,C-l-0 C-l-1 C-l-2 C-l-2 C-l-0 C-l-1 
job-85,2,11,3,4259,6619,6769,2360,150,4699,false,L-l-0 L-l-0 L-l-0 
job-84,1,5,2,4205,6619,6919,2414,300,4552,false,L-s-0 L-s-0 
job-86,5,10,5,4310,6619,7019,2309,400,4718,false,C-m-0 L-l-0 C-l-2 L-m-0 C-l-2 
job-87,4,11,1,4363,7019,7050,2656,31,4608,false,L-s-0 
job-88,3,7,2,4413,7019,7055,2606,36,4559,false,L-m-0 L-m-0 
job-90,1,9,5,4499,7050,7078,2551,28,4531,false,L-m-0 C-m-0 L-m-0 C-m-0 C-m-0 
job-92,5,10,1,4596,7050,7111,2454,61,4871,false,C-m-1 
job-91,5,7,4,4544,7050,7124,2506,74,4883,false,C-l-0 C-l-0 C-l-1 C-l-1 
job-93,6,12,6,4647,7111,7129,2464,18,4875,false,L-m-0 C-l-2 C-m-1 C-m-0 C-l-2 C-m-2 
job-89,3,11,4,4458,7019,7147,2561,128,4742,false,L-l-0 L-l-0 L-l-0 L-l-0 
job-94,5,4,8,4699,7129,7156,2430,27,4971,false,C-m-0 C-l-1 C-l-0 C-l-2 C-l-1 C-l-2 C-l-0 L-m-0 
job-95,1,6,6,4757,7156,7176,2399,20,4938,false,L-l-0 L-l-0 L-l-0 L-l-0 L-l-0 L-l-0 
job-96,3,7,7,4804,7156,7235,2352,79,4941,false,L-l-0 C-l-0 C-l-0 L-m-0 C-l-0 C-l-0 L-m-0 
job-97,2,12,2,4857,7156,7397,2299,241,5126,false,L-s-0 L-m-0 
job-99,3,12,5,4959,7397,7415,2438,18,5128,false,C-s-1 C-l-1 C-l-1 C-l-1 C-l-1 
job-100,5,9,3,5012,7397,7426,2385,29,5073,false,C-l-0 C-l-0 C-m-0 
job-98,4,10,6,4912,7397,7427,2485,30,4987,false,L-m-0 L-s-0 L-l-0 L-l-0 L-m-0 L-l-0 
job-101,2,10,6,5064,7397,7527,2333,130,5341,false,C-l-2 C-l-2 C-l-0 C-m-0 C-l-2 C-l-2 
job-102,1,10,2,5117,7527,7539,2410,12,5355,false,L-m-0 L-m-0 
job-103,4,8,5,5170,7527,7631,2357,104,5289,false,L-s-0 L-l-0 L-l-0 L-m-0 L-l-0 
job-104,1,9,7,5225,7527,7652,2302,125,5518,false,C-l-1 C-l-1 C-l-1 C-m-0 C-l-1 C-l-1 C-m-0 
job-105,4,6,6,5282,7652,7668,2370,16,5514,false,L-m-0 L-s-0 L-l-0 L-l-0 L-m-0 L-l-0 
job-106,6,10,5,5326,7652,7673,2326,21,5619,false,C-l-0 C-l-2 C-l-0 C-l-2 C-m-0 
job-107,4,8,3,5377,7652,7800,2275,148,5571,false,C-l-1 C-l-1 C-l-1 
job-108,5,12,2,5425,7652,7845,2227,193,5703,false,C-m-2 C-m-1 
job-110,5,8,3,5532,7845,7863,2313,18,5578,false,L-l-0 L-l-0 C-m-0 
job-109,2,5,3,5476,7845,7875,2369,30,5513,false,L-m-0 L-m-0 L-m-0 
job-111,4,4,7,5585,7845,8064,2260,219,5884,false,C-l-1 C-l-0 C-l-0 C-l-0 C-l-1 C-l-1 L-s-0 
job-113,5,7,7,5671,8064,8096,2393,32,5707,false,C-l-2 C-l-0 C-l-0 L-m-0 C-l-1 C-l-1 C-l-2 
job-114,5,6,2,5727,8064,8111,2337,47,5795,false,C-m-0 C-m-1 
job-115,5,5,7,5790,8096,8158,2306,62,5974,false,C-l-2 C-l-1 C-l-0 C-l-2 C-l-0 C-l-1 L-m-0 
job-112,3,5,3,5624,8064,8178,2440,114,5965,false,L-l-0 L-l-0 L-l-0 
job-116,5,7,2,5835,8111,8228,2276,117,6178,false,C-m-0 C-m-1 
job-117,4,7,6,5883,8111,8434,2228,323,6482,false,C-s-2 C-s-0 C-m-2 L-s-0 C-m-2 C-s-1 
job-118,2,10,8,5931,8434,8476,2503,42,6083,false,L-m-0 L-s-0 L-l-0 L-l-0 L-l-0 L-l-0 L-m-0 L-m-0 
job-119,1,9,1,5982,8434,8507,2452,73,6167,false,C-s-1 
job-120,2,7,3,6023,8434,8539,2411,105,6311,false,L-l-0 C-s-1 C-s-2 
job-121,1,11,3,6066,8434,8802,2368,368,6610,false,C-l-0 C-l-0 C-l-0 
job-123,3,10,7,6168,8802,8836,2634,34,6369,false,L-s-0 C-l-0 C-l-0 C-s-0 C-l-0 C-l-0 C-s-1 
job-124,6,12,5,6209,8802,8868,2593,66,6434,false,C-l-1 C-l-2 C-l-1 C-m-1 C-l-2 
job-122,6,8,3,6116,8802,8870,2686,68,6313,false,L-l-0 L-l-0 L-m-0 
job-125,2,4,1,6258,8870,8940,2612,70,6543,false,L-s-0 
job-127,1,7,8,6360,8940,8958,2580,18,6453,false,L-s-0 L-m-0 L-m-0 C-m-0 C-m-0 C-m-0 L-s-0 C-m-0 
job-126,3,4,6,6304,8870,8981,2566,111,6671,false,L-m-0 L-l-0 L-l-0 L-m-0 L-l-0 L-l-0 
job-128,6,5,4,6409,8940,9058,2531,118,6696,false,C-l-0 C-l-1 C-l-1 C-l-0 
job-130,6,9,5,6504,9058,9124,2554,66,6593,false,L-l-0 C-l-0 L-l-0 L-m-0 C-l-0 
job-129,5,10,2,6449,8940,9207,2491,267,6764,false,C-l-2 C-l-2 
job-131,2,8,3,6566,9207,9262,2641,55,6918,false,L-m-0 L-m-0 L-m-0 
job-132,5,11,8,6619,9207,9283,2588,76,6814,false,C-l-2 C-l-1 C-l-0 C-l-0 C-l-1 L-l-0 C-l-2 L-l-0 
job-134,6,12,7,6742,9283,9349,2541,66,6871,false,L-m-0 C-l-0 L-l-0 C-l-1 C-l-0 C-l-1 L-l-0 
job-133,4,5,6,6683,9207,9361,2524,154,7133,false,C-m-0 C-s-1 C-m-1 C-m-0 C-m-1 L-s-0 
job-136,4,11,2,6832,9283,9370,2451,87,7179,false,C-m-2 C-m-2 
job-135,6,11,2,6786,9283,9394,2497,111,6962,false,C-l-2 C-l-2 
job-137,6,7,3,6877,9349,9403,2472,54,7174,false,L-l-0 L-m-0 L-l-0 
job-138,3,7,1,6923,9349,9425,2426,76,7054,false,C-s-2 
job-139,4,9,8,6967,9361,9461,2394,100,7239,false,L-s-0 C-l-1 C-l-1 C-m-0 C-l-1 C-m-1 C-m-1 C-m-0 
job-140,6,9,1,7017,9461,9487,2444,26,7097,false,L-m-0 
job-141,1,6,2,7062,9487,9499,2425,12,7185,false,L-s-0 L-s-0 
job-142,5,8,4,7113,9487,9556,2374,69,7208,false,L-m-0 L-l-0 L-l-0 C-m-0 
job-143,2,9,7,7158,9556,9573,2398,17,7300,false,L-m-0 L-l-0 L-l-0 L-l-0 L-l-0 L-l-0 L-m-0 
job-145,6,10,2,7268,9556,9742,2288,186,7717,false,C-l-1 C-l-1 
job-144,4,6,5,7211,9556,9842,2345,286,7697,false,L-s-0 C-l-0 L-m-0 C-l-0 C-l-0 
job-146,3,5,6,7320,9842,9856,2522,14,7444,false,L-m-0 L-l-0 L-l-0 L-m-0 L-l-0 L-l-0 
job-148,5,4,4,7414,9842,10038,2428,196,7635,false,C-l-2 C-l-1 C-l-1 C-l-2 
job-147,6,5,2,7370,9842,10063,2472,221,7851,false,C-l-0 C-l-0 
job-149,5,8,6,7459,10038,10080,2579,42,7669,false,L-m-0 C-l-1 L-l-0 C-m-0 C-l-1 L-l-0 
job-150,6,9,5,7495,10063,10083,2568,20,7689,false,C-l-2 C-l-2 C-l-0 C-m-1 C-l-0 
job-151,1,4,5,7534,10080,10177,2546,97,7644,false,L-s-0 C-m-1 L-s-0 L-s-0 C-m-1 
job-152,2,8,8,7590,10177,10223,2587,46,7658,false,L-l-0 L-l-0 L-l-0 L-l-0 L-l-0 L-s-0 L-l-0 L-s-0 
job-153,2,6,7,7645,10223,10234,2578,11,7858,false,L-l-0 L-l-0 L-s-0 L-l-0 L-l-0 L-s-0 L-l-0 
job-155,3,10,5,7733,10223,10296,2490,73,8066,false,C-s-1 C-l-2 C-l-2 C-l-2 C-l-2 
job-154,1,12,5,7694,10223,10316,2529,93,8043,false,L-m-0 C-m-0 L-m-0 C-m-0 L-l-0 
job-156,3,6,1,7783,10316,10335,2533,19,7921,false,L-s-0 
job-157,5,4,5,7833,10316,10391,2483,75,8079,false,L-m-0 C-l-0 C-l-0 L-l-0 L-l-0 
job-158,2,11,4,7893,10391,10435,2498,44,8083,false,L-l-0 L-l-0 L-l-0 L-l-0 
job-159,2,5,8,7940,10391,10495,2451,104,8240,false,L-s-0 L-m-0 L-s-0 C-s-1 L-m-0 L-m-0 C-s-1 L-m-0 
job-160,5,6,4,7994,10391,10737,2397,346,8369,false,C-l-0 C-l-2 C-l-2 C-l-0 
job-162,4,6,7,8088,10737,10769,2649,32,8347,false,C-l-0 C-l-2 C-l-0 C-s-1 C-l-2 C-l-0 C-l-2 
job-161,4,4,8,8042,10737,10813,2695,76,8280,false,L-m-0 L-l-0 L-l-0 L-l-0 C-m-0 L-s-0 L-m-0 C-m-0 
job-163,2,11,4,8144,10813,10824,2669,11,8425,false,L-l-0 L-l-0 L-l-0 L-l-0 
job-165,4,8,5,8231,10813,10869,2582,56,8471,false,C-m-0 C-l-1 C-l-1 C-l-1 C-m-0 
job-164,2,9,4,8187,10813,11108,2626,295,8674,false,L-s-0 L-m-0 L-m-0 L-m-0 
job-166,4,9,1,8286,11108,11147,2822,39,8403,false,L-s-0 
job-167,2,9,1,8340,11108,11378,2768,270,8883,false,L-m-0 
job-168,1,9,5,8385,11378,11423,2993,45,8660,false,L-l-0 L-l-0 L-l-0 L-l-0 L-l-0 
job-169,5,11,2,8438,11378,11428,2940,50,8733,false,C-m-0 L-m-0 
job-170,2,12,5,8474,11378,11543,2904,165,8828,false,L-s-0 C-m-1 L-m-0 C-m-0 C-m-1 
job-171,1,10,1,8527,11378,11677,2851,299,8974,false,C-s-1 
job-172,6,8,6,8567,11677,11692,3110,15,8843,false,C-m-0 C-l-0 L-l-0 L-m-0 C-l-0 L-l-0 
job-173,2,8,8,8618,11677,11724,3059,47,8928,false,C-m-1 L-s-0 L-s-0 C-m-0 L-m-0 C-m-1 C-m-1 C-m-1 
job-174,4,5,6,8658,11677,11745,3019,68,8949,false,C-l-1 C-l-2 C-l-2 C-l-1 C-l-2 C-l-1 
job-175,3,6,3,8702,11677,12141,2975,464,9283,false,C-m-2 C-m-2 C-s-1 
job-176,3,5,2,8745,12141,12158,3396,17,8782,false,L-m-0 L-m-0 
job-177,2,5,6,8790,12141,12237,3351,96,9154,false,L-l-0 L-l-0 L-m-0 L-l-0 L-l-0 L-l-0 
job-178,1,5,6,8837,12141,12306,3304,165,9260,false,L-l-0 L-s-0 L-l-0 C-s-1 L-s-0 L-s-0 
job-180,4,8,5,8929,12306,12321,3377,15,9073,false,L-s-0 L-m-0 L-m-0 C-m-0 C-m-0 
job-179,2,7,5,8881,12306,12360,3425,54,9086,false,L-l-0 L-l-0 L-l-0 L-l-0 L-l-0 
job-181,6,11,7,8971,12306,12402,3335,96,9115,false,C-m-1 C-l-1 C-l-1 C-l-2 C-l-0 C-l-0 C-l-2 
job-182,2,7,7,9015,12306,12471,3291,165,9312,false,C-m-2 C-s-2 C-m-1 C-m-2 C-m-2 C-s-2 L-l-0 
job-183,5,5,3,9066,12471,12516,3405,45,9135,false,L-l-0 L-l-0 L-m-0 
job-185,3,12,8,9174,12471,12539,3297,68,9341,false,C-m-1 C-l-2 L-s-0 C-l-2 C-l-2 C-l-2 C-m-1 L-m-0 
job-184,6,7,5,9118,12471,12565,3353,94,9240,false,C-l-0 C-l-1 C-l-0 C-m-0 C-l-1 
job-186,2,11,4,9229,12539,12577,3310,38,9332,false,L-l-0 C-m-0 L-l-0 L-l-0 
job-187,6,8,4,9276,12539,12611,3263,72,9535,false,L-m-0 C-l-2 L-l-0 C-l-2 
job-189,3,4,8,9370,12539,12710,3169,171,9743,false,L-s-0 C-m-2 C-s-0 C-s-1 C-m-2 C-m-1 C-s-2 C-m-1 
job-188,1,12,3,9319,12539,12771,3220,232,9612,false,L-s-0 L-m-0 L-m-0 
job-191,6,9,4,9465,12771,12781,3306,10,9698,false,L-l-0 C-l-0 C-l-0 L-m-0 
job-190,3,10,1,9421,12710,12783,3289,73,9672,false,L-l-0 
job-192,2,12,4,9516,12771,12783,3255,12,9536,false,L-s-0 L-l-0 C-s-1 L-m-0 
job-193,4,5,2,9561,12771,12814,3210,43,9794,false,C-m-0 C-m-0 
job-195,2,7,2,9663,12771,12846,3108,75,9890,false,C-s-2 C-s-2 
job-194,1,10,4,9605,12771,12866,3166,95,9810,false,C-m-1 L-l-0 C-m-1 C-m-1 
job-196,5,7,3,9711,12771,13021,3060,250,10101,false,C-m-2 C-l-1 C-l-1 
job-199,4,8,5,9851,13021,13104,3170,83,10082,false,C-m-0 C-l-2 C-l-2 C-m-0 C-l-2 
job-197,5,10,3,9758,13021,13117,3263,96,10017,false,L-l-0 L-l-0 L-m-0 
job-200,3,4,7,9905,13104,13160,3199,56,10052,false,C-s-2 C-l-1 C-l-1 C-s-1 C-l-1 C-l-1 L-s-0 
job-198,1,12,5,9801,13021,13164,3220,143,10012,false,L-s-0 L-m-0 L-l-0 C-s-1 L-l-0 
job-201,2,7,3,9954,13104,13172,3150,68,10047,false,C-s-0 C-s-0 L-m-0 
job-202,4,9,4,9996,13104,13472,3108,368,10414,false,C-m-0 C-m-1 C-m-0 C-m-1 
job-203,6,6,3,10053,13472,13530,3419,58,10305,false,L-l-0 L-l-0 L-m-0 
job-204,4,7,5,10106,13472,13557,3366,85,10422,false,L-s-0 C-l-1 C-l-1 C-s-1 C-l-1 
job-205,2,11,5,10146,13472,13597,3326,125,10480,false,C-l-0 C-l-0 L-m-0 C-l-0 C-l-0 
job-207,1,5,6,10237,13472,13602,3235,130,10403,false,C-m-1 C-m-1 C-m-1 C-m-1 C-m-1 C-m-1 
job-206,2,7,6,10189,13472,13619,3283,147,10411,false,C-l-2 C-l-2 C-l-2 C-l-2 C-l-2 C-l-2 
job-208,3,8,8,10284,13530,13798,3246,268,10838,false,L-m-0 L-m-0 L-l-0 L-l-0 L-l-0 C-m-0 L-l-0 C-m-0 
job-210,6,4,3,10366,13798,13832,3432,34,10556,false,L-l-0 L-m-0 L-l-0 
job-209,4,9,1,10321,13798,13850,3477,52,10409,false,L-s-0 
job-211,6,6,5,10409,13798,13897,3389,99,10805,false,C-m-0 C-l-2 C-l-0 C-l-2 C-l-0 
job-212,5,8,6,10467,13832,13954,3365,122,10858,false,L-m-0 L-l-0 C-l-1 C-m-1 C-l-1 L-l-0 
job-213,5,8,4,10505,13897,13983,3392,86,10856,false,C-l-2 C-l-0 C-l-0 C-l-2 
job-214,5,11,5,10555,13954,14336,3399,382,10979,false,L-m-0 L-l-0 L-l-0 C-l-1 C-l-1 
job-215,4,6,3,10615,14336,14366,3721,30,10775,false,L-l-0 L-l-0 L-l-0 
job-216,5,9,4,10672,14336,14565,3664,229,11189,false,C-m-0 C-l-0 C-l-0 L-m-0 
job-217,4,10,7,10714,14565,14655,3851,90,10987,false,L-l-0 L-m-0 L-s-0 L-l-0 L-m-0 L-l-0 C-s-1 
job-219,5,7,1,10819,14565,14667,3746,102,11066,false,C-m-1 
job-218,3,10,7,10767,14565,14686,3798,121,11029,false,C-s-0 C-l-0 C-l-0 C-m-0 C-l-0 C-l-0 C-m-0 
job-220,2,5,5,10875,14686,14702,3811,16,10989,false,L-l-0 L-l-0 L-l-0 L-l-0 L-l-0 
job-221,5,10,3,10937,14686,14764,3749,78,11102,false,L-m-0 C-l-0 C-l-0 
job-222,5,7,7,10984,14686,14851,3702,165,11302,false,C-m-1 C-l-1 C-l-2 C-m-0 C-l-1 C-l-2 C-m-2 
job-223,3,10,8,11037,14851,14906,3814,55,11280,false,L-l-0 L-s-0 L-l-0 L-l-0 L-l-0 L-m-0 C-s-0 L-m-0 
job-224,6,12,8,11081,14851,15200,3770,349,11672,false,C-l-0 C-l-2 C-l-1 C-l-1 C-l-2 C-m-1 C-l-0 C-m-0 
job-225,5,8,7,11132,15200,15303,4068,103,11304,false,C-l-1 L-l-0 C-l-0 C-l-1 C-l-0 L-l-0 L-m-0 
job-226,5,4,8,11185,15303,15336,4118,33,11446,false,L-l-0 C-l-0 C-l-1 C-l-1 C-l-0 L-l-0 C-m-0 L-m-0 
job-227,4,6,5,11232,15303,15517,4071,214,11708,false,L-s-0 C-l-2 C-l-2 C-s-1 C-l-2 
job-228,3,4,1,11274,15517,15581,4243,64,11445,false,L-s-0 
job-229,2,8,8,11330,15517,15823,4187,306,11923,false,L-m-0 L-l-0 L-l-0 L-l-0 L-l-0 L-l-0 L-l-0 L-m-0 
job-230,6,10,6,11377,15517,15824,4140,307,11881,false,C-l-0 C-l-2 C-l-1 C-l-2 C-l-0 C-l-1 
job-231,1,7,4,11441,15823,15858,4382,35,11749,false,L-m-0 L-m-0 L-m-0 L-m-0 
job-233,3,8,5,11581,15823,15892,4242,69,11706,false,C-m-0 C-m-1 C-s-1 C-m-1 C-m-0 
job-232,2,5,7,11513,15823,15957,4310,134,11753,false,L-l-0 L-s-0 L-s-0 L-l-0 L-l-0 L-l-0 L-l-0 
job-235,5,8,4,11693,15957,15987,4264,30,11751,false,L-m-0 L-l-0 L-l-0 C-m-0 
job-234,6,8,3,11628,15824,15994,4196,170,11895,false,C-l-0 C-m-2 C-l-0 
job-236,2,5,8,11741,15957,16118,4216,161,11993,false,L-m-0 C-s-1 C-s-1 L-l-0 L-s-0 C-m-2 L-s-0 C-m-0 
job-237,2,7,5,11799,15957,16135,4158,178,12146,false,C-l-1 C-l-1 C-l-1 C-l-1 C-l-1 
job-238,2,7,4,11856,15957,16167,4101,210,12291,false,C-m-1 C-m-1 C-l-1 C-m-1 
job-239,1,7,7,11905,16118,16205,4213,87,12080,false,L-l-0 L-l-0 C-m-1 L-l-0 L-l-0 L-l-0 L-l-0 
job-240,5,6,3,11951,16167,16206,4216,39,12213,false,L-m-0 L-l-0 C-m-1 
job-242,4,6,8,12047,16206,16218,4159,12,12344,false,C-s-1 L-l-0 C-l-1 C-l-1 C-l-1 L-l-0 L-s-0 L-l-0 
job-241,5,7,1,11987,16206,16226,4219,20,12117,false,L-m-0 
job-244,1,10,8,12153,16206,16235,4053,29,12404,false,C-l-0 C-l-2 C-l-0 C-l-2 C-l-2 C-l-0 C-l-2 C-l-0 
job-245,6,11,4,12211,16226,16238,4015,12,12352,false,C-l-1 L-l-0 L-l-0 C-l-1 
job-243,1,7,4,12107,16206,16265,4099,59,12332,false,L-m-0 L-m-0 C-s-2 L-m-0 
job-247,3,12,5,12312,16265,16331,3953,66,12517,false,L-m-0 L-l-0 L-l-0 L-l-0 L-l-0 
job-246,2,9,1,12262,16265,16357,4003,92,12611,false,L-s-0 
job-249,4,9,8,12391,16331,16419,3940,88,12656,false,L-l-0 C-l-0 L-l-0 C-l-0 C-l-0 L-l-0 C-s-1 L-m-0 
job-248,1,9,2,12348,16331,16477,3983,146,12584,false,L-m-0 L-m-0 
job-250,1,9,4,12431,16331,16546,3900,215,12837,false,C-l-1 C-l-1 C-l-1 C-l-1 
job-251,3,12,8,12483,16331,16735,3848,404,13052,false,C-l-2 C-l-2 C-l-2 C-l-2 C-l-1 C-m-2 C-s-2 C-m-2 
job-252,3,12,6,12528,16735,16883,4207,148,12777,false,L-m-0 L-l-0 L-l-0 L-l-0 L-m-0 L-l-0 
job-253,5,11,5,12581,16735,17028,4154,293,12881,false,C-l-0 C-l-1 C-l-1 C-m-0 C-l-0 
job-254,5,4,7,12629,17028,17041,4399,13,12784,false,C-l-1 L-l-0 C-l-0 C-l-1 C-l-0 L-l-0 L-m-0 
job-255,6,10,8,12669,17041,17326,4372,285,12954,false,L-l-0 C-l-0 C-l-2 C-l-2 C-l-0 L-l-0 C-m-0 L-m-0 
job-256,5,7,7,12720,17326,17444,4606,118,13036,false,C-l-1 L-l-0 C-l-0 C-l-1 C-l-0 L-l-0 L-m-0 
job-257,6,5,4,12758,17444,17460,4686,16,12925,false,L-m-0 L-l-0 L-l-0 C-m-0 
job-258,6,11,7,12810,17444,17506,4634,62,12968,false,C-m-1 C-l-2 C-l-1 C-l-1 C-l-0 C-l-0 C-l-2 
job-260,5,12,3,12914,17460,17533,4546,73,13083,false,L-m-0 L-l-0 L-l-0 
job-259,3,11,5,12864,17444,17543,4580,99,13133,false,C-s-1 C-m-2 L-s-0 C-m-2 C-s-2 
job-261,5,4,8,12977,17506,17677,4529,171,13339,false,C-m-1 C-l-2 C-l-0 C-l-1 C-l-0 C-l-2 C-l-1 C-m-0 
job-262,5,4,6,13022,17677,17809,4655,132,13361,false,L-m-0 C-l-0 C-l-0 C-m-0 L-l-0 L-l-0 
job-263,2,12,4,13069,17809,17853,4740,44,13374,false,L-l-0 L-l-0 L-l-0 L-l-0 
job-264,2,11,8,13130,17809,17879,4679,70,13348,false,L-s-0 C-l-0 C-l-0 C-l-0 C-l-0 L-m-0 C-s-1 L-m-0 
job-265,6,4,6,13200,17809,17945,4609,136,13625,false,C-m-0 C-l-2 C-l-1 C-l-1 C-l-2 C-m-1 
job-266,1,4,6,13255,17879,17956,4624,77,13439,false,C-m-1 C-m-1 L-s-0 C-m-0 C-m-0 L-s-0 
job-267,1,9,1,13301,17956,17975,4655,19,13419,false,L-s-0 
job-269,5,12,3,13409,17956,17984,4547,28,13581,false,L-l-0 L-l-0 C-m-1 
job-268,6,11,1,13360,17956,17996,4596,40,13641,false,L-m-0 
job-270,2,5,3,13455,17984,18026,4529,42,13662,false,L-s-0 L-s-0 L-m-0 
job-271,5,6,3,13505,17984,18048,4479,64,13721,false,L-l-0 L-l-0 C-m-0 
job-272,2,10,3,13563,17984,18265,4421,281,13943,false,C-s-1 L-l-0 C-m-0 
job-275,4,4,6,13713,18265,18375,4552,110,14064,false,L-m-0 C-l-0 C-l-0 C-s-1 C-l-0 L-l-0 
job-273,2,11,3,13623,18265,18398,4642,133,13987,false,L-m-0 L-m-0 L-s-0 
job-274,6,11,1,13677,18265,18424,4588,159,14112,false,L-l-0 
job-278,5,10,5,13850,18424,18479,4574,55,14160,false,L-l-0 L-l-0 C-l-0 C-m-1 C-l-0 
job-276,5,4,1,13760,18265,18487,4505,222,14189,false,C-m-0 
job-277,6,10,1,13803,18424,18539,4621,115,13934,false,L-m-0 
job-279,1,6,1,13898,18539,18638,4641,99,14227,false,L-s-0 
job-280,3,8,1,13948,18638,18731,4690,93,14044,false,L-s-0 
job-281,6,10,7,13992,18638,18743,4646,105,14394,false,L-l-0 C-l-1 C-l-0 L-l-0 C-l-1 C-l-0 L-m-0 
job-282,1,8,5,14040,18731,18768,4691,37,14149,false,C-s-1 L-m-0 L-m-0 C-s-1 L-s-0 
job-283,3,12,1,14091,18731,18792,4640,61,14228,false,C-s-2 
job-284,6,5,5,14135,18731,18799,4596,68,14382,false,C-m-2 C-m-1 C-l-2 C-m-0 C-l-2 
job-285,6,10,7,14192,18743,18872,4551,129,14458,false,L-l-0 L-l-0 L-m-0 C-l-1 C-l-1 C-l-0 C-l-0 
job-287,4,7,4,14288,18799,18930,4511,131,14554,false,C-m-0 C-m-2 C-m-2 C-m-0 
job-286,4,4,7,14248,18799,18953,4551,154,14404,false,L-s-0 C-l-2 C-l-2 C-m-1 C-l-2 C-s-1 C-m-1 
job-288,6,12,5,14343,18872,18972,4529,100,14496,false,L-l-0 C-l-0 L-l-0 L-m-0 C-l-0 
job-290,5,10,6,14435,18972,19055,4537,83,14749,false,L-m-0 C-l-0 L-l-0 C-m-1 C-l-0 L-l-0 
job-289,4,10,8,14392,18930,19115,4538,185,14868,false,C-l-1 C-s-2 C-l-1 C-l-1 C-m-0 C-m-2 C-m-0 C-m-2 
job-293,6,12,4,14588,19115,19140,4527,25,14709,false,L-l-0 C-l-0 C-l-0 L-l-0 
job-291,2,8,1,14490,19115,19147,4625,32,14542,false,L-s-0 
job-294,3,5,8,14631,19115,19224,4484,109,14889,false,C-l-1 C-l-1 C-l-2 C-l-2 C-l-1 C-l-2 C-l-1 L-m-0 
job-292,3,12,1,14541,19115,19224,4574,109,14757,false,L-m-0 
job-295,2,4,6,14676,19224,19243,4548,19,14778,false,L-m-0 L-l-0 L-m-0 L-l-0 L-l-0 L-l-0 
job-296,2,6,5,14731,19224,19276,4493,52,14811,false,L-s-0 L-l-0 L-s-0 C-s-1 L-l-0 
job-297,6,7,2,14781,19224,19414,4443,190,15064,false,C-l-0 C-l-0 
job-298,1,5,5,14827,19414,19492,4587,78,15088,false,L-m-0 L-m-0 L-m-0 L-m-0 L-m-0 
job-299,6,4,8,14884,19414,19750,4530,336,15225,false,L-l-0 C-l-0 C-l-0 C-l-2 C-l-1 L-l-0 C-l-2 C-l-1 
job-301,4,8,6,14975,19750,19775,4775,25,15098,false,C-s-1 L-l-0 L-m-0 L-l-0 L-s-0 L-l-0 
job-300,1,6,4,14931,19492,19782,4561,290,15447,false,L-m-0 L-m-0 L-m-0 L-m-0 
job-302,5,12,8,15029,19750,20001,4721,251,15388,false,C-m-1 C-l-1 C-l-1 C-l-2 C-l-0 C-l-2 C-l-0 C-m-0 
job-304,5,9,1,15129,20001,20047,4872,46,15324,false,C-m-0 
job-303,4,4,7,15063,20001,20057,4938,56,15293,false,L-l-0 L-m-0 L-s-0 L-l-0 L-m-0 L-l-0 C-s-1 
job-305,2,6,2,15178,20001,20074,4823,73,15513,false,C-s-2 C-m-0 
job-306,1,8,2,15235,20074,20145,4839,71,15440,false,L-s-0 L-s-0 
job-307,5,10,5,15278,20074,20171,4796,97,15442,false,L-l-0 L-l-0 C-l-0 L-m-0 C-l-0 
job-308,2,4,5,15324,20074,20330,4750,256,15613,false,C-s-1 C-l-0 L-m-0 C-s-1 L-l-0 
job-309,4,6,4,15366,20330,20433,4964,103,15470,false,L-l-0 L-l-0 L-s-0 L-l-0 
job-310,3,10,1,15414,20330,20436,4916,106,15672,false,L-m-0 
job-314,6,11,3,15596,20436,20467,4840,31,15735,false,C-l-1 C-l-1 C-m-0 
job-313,5,4,4,15549,20436,20486,4887,50,15847,false,L-l-0 L-l-0 C-l-0 C-l-0 
job-315,2,12,7,15641,20436,20486,4795,50,15872,false,L-l-0 C-l-2 C-l-2 C-l-2 C-m-0 C-l-2 C-l-0 
job-312,1,6,4,15500,20436,20536,4936,100,15683,false,L-s-0 L-m-0 L-m-0 L-m-0 
job-317,2,4,6,15744,20436,20548,4692,112,15998,false,C-m-2 C-m-2 C-m-1 C-m-2 C-m-1 C-m-2 
job-311,5,10,1,15462,20436,20569,4974,133,15846,false,L-m-0 
job-316,2,10,3,15691,20436,20592,4745,156,15890,false,C-m-1 C-m-1 L-s-0 
job-318,5,7,4,15784,20486,20700,4702,214,16146,false,L-l-0 L-l-0 C-l-0 C-l-0 
job-321,4,10,7,15934,20700,20738,4766,38,16069,false,C-l-0 C-l-1 C-l-1 L-s-0 C-l-1 C-l-0 C-l-0 
job-319,4,11,2,15837,20700,20757,4863,57,16070,false,L-m-0 L-m-0 
job-322,6,6,7,15982,20738,20818,4756,80,16210,false,C-l-0 C-l-0 C-l-1 C-m-0 C-l-1 C-l-2 C-l-2 
job-323,2,11,6,16037,20738,20840,4701,102,16344,false,L-s-0 C-m-1 C-m-2 C-m-2 C-m-1 C-m-0 
job-320,4,8,3,15888,20700,20844,4812,144,16286,false,L-l-0 L-l-0 L-l-0 
job-324,6,7,8,16087,20818,20913,4731,95,16431,false,C-l-0 C-l-0 C-l-2 C-l-1 C-l-1 C-m-0 C-l-2 L-m-0 
job-325,6,4,5,16134,20913,20947,4779,34,16365,false,L-m-0 C-l-0 L-l-0 L-l-0 C-l-0 
job-327,3,11,7,16251,20913,20961,4662,48,16578,false,L-s-0 C-l-2 C-l-2 C-m-0 C-l-2 C-l-2 C-m-0 
job-326,3,11,4,16187,20913,20992,4726,79,16411,false,C-l-1 C-l-1 C-l-1 C-l-1 
job-328,1,8,2,16312,20992,21007,4680,15,16538,false,L-s-0 L-s-0 
job-331,5,7,8,16448,20992,21028,4544,36,16498,false,C-l-0 C-l-1 C-l-2 C-l-2 C-l-1 C-m-2 C-m-1 C-m-0 
job-330,1,8,6,16405,20992,21032,4587,40,16531,false,C-l-0 C-l-0 C-l-0 C-l-0 C-l-0 L-m-0 
job-329,3,10,6,16356,20992,21082,4636,90,16549,false,L-l-0 L-m-0 L-m-0 L-l-0 L-l-0 L-l-0 
job-332,6,7,5,16489,21028,21154,4539,126,16621,false,C-l-2 C-l-2 C-l-1 C-l-0 C-l-1 
job-333,4,6,8,16536,21154,21185,4618,31,16825,false,L-m-0 L-l-0 L-l-0 L-l-0 C-m-0 L-s-0 L-m-0 C-m-0 
job-334,5,10,6,16588,21154,21209,4566,55,16657,false,C-l-0 C-l-1 C-l-1 C-l-2 C-l-0 C-l-2 
job-335,2,9,4,16647,21185,21217,4538,32,16789,false,L-s-0 C-l-0 C-l-1 C-l-2 
job-336,3,11,5,16700,21185,21299,4485,114,17007,false,L-m-0 L-l-0 L-l-0 L-l-0 L-l-0 
job-337,4,6,2,16746,21185,21328,4439,143,17133,false,L-m-0 C-s-1 
job-338,4,12,1,16793,21328,21367,4535,39,16995,false,L-s-0 
job-339,4,5,6,16842,21328,21397,4486,69,17102,false,C-s-1 L-m-0 L-m-0 L-l-0 L-l-0 L-l-0 
job-340,4,10,8,16897,21328,21825,4431,497,17528,false,C-l-0 C-l-2 C-l-0 C-l-2 C-m-0 C-l-2 C-l-0 C-m-0 
job-341,1,12,6,16959,21825,21927,4866,102,17221,false,L-m-0 L-l-0 L-l-0 L-m-0 L-l-0 L-l-0 
job-342,2,9,4,17001,21927,21946,4926,19,17143,false,L-l-0 L-l-0 L-l-0 L-l-0 
job-343,4,4,8,17063,21927,22105,4864,178,17496,false,C-s-1 C-l-1 L-m-0 C-l-1 C-l-1 L-s-0 L-l-0 L-m-0 
job-344,6,9,5,17123,22105,22116,4982,11,17339,false,L-m-0 C-l-0 L-l-0 L-l-0 C-l-0 
job-345,3,5,5,17166,22105,22163,4939,58,17305,false,L-s-0 C-l-1 C-l-1 C-l-1 C-l-1 
job-346,2,8,8,17215,22105,22233,4890,128,17553,false,L-m-0 C-m-1 C-m-0 C-m-1 C-m-0 C-m-0 C-m-1 C-m-0 
job-347,5,7,2,17263,22233,22252,4970,19,17551,false,L-l-0 L-l-0 
job-348,6,7,5,17327,22233,22269,4906,36,17593,false,C-l-0 C-l-1 C-l-1 L-m-0 C-l-0 
job-349,2,5,1,17373,22269,22448,4896,179,17729,false,L-s-0 
job-350,3,6,2,17425,22448,22488,5023,40,17634,false,L-m-0 L-m-0 
job-351,1,6,5,17471,22488,22499,5017,11,17758,false,L-m-0 L-m-0 L-m-0 L-m-0 L-m-0 
job-352,6,5,6,17511,22488,22582,4977,94,17803,false,C-l-0 L-l-0 C-l-1 C-l-1 C-l-0 L-l-0 
job-353,4,4,4,17578,22582,22619,5004,37,17797,false,L-l-0 L-l-0 L-s-0 L-l-0 
job-355,2,4,8,17684,22582,22654,4898,72,17984,false,L-m-0 C-l-0 C-l-0 C-l-0 C-l-0 C-l-0 L-m-0 L-m-0 
job-356,2,10,6,17735,22582,22748,4847,166,17955,false,C-s-1 C-l-1 C-l-1 C-l-0 C-l-1 C-l-1 
job-357,3,6,6,17778,22748,22802,4970,54,17896,false,L-m-0 L-l-0 L-l-0 L-m-0 L-l-0 L-l-0 
job-354,1,7,1,17622,22582,22809,4960,227,18148,false,L-m-0 
job-359,6,8,8,17868,22802,23169,4934,367,18434,false,L-l-0 L-l-0 C-l-1 C-l-1 C-l-2 L-m-0 C-l-2 C-m-0 
job-358,2,8,8,17825,22748,23191,4923,443,18383,false,C-l-0 C-l-0 C-l-0 L-s-0 C-l-0 C-l-0 L-s-0 C-l-0 
job-361,5,8,1,17968,23169,23194,5201,25,18104,false,L-m-0 
job-360,2,5,5,17916,23169,23201,5253,32,18084,false,L-l-0 L-l-0 L-l-0 L-l-0 L-l-0 
job-363,4,6,4,18078,23169,23220,5091,51,18358,false,C-s-1 C-l-2 C-l-2 C-l-2 
job-364,6,7,5,18116,23169,23232,5053,63,18351,false,C-m-0 C-l-1 C-m-2 C-m-1 C-l-1 
job-362,1,5,6,18036,23169,23281,5133,112,18195,false,L-m-0 L-l-0 L-m-0 L-m-0 C-s-0 L-l-0 
job-365,4,9,1,18170,23281,23317,5111,36,18422,false,L-s-0 
job-366,5,12,6,18219,23281,23371,5062,90,18507,false,L-m-0 C-l-0 C-l-0 C-m-0 L-l-0 L-l-0 
job-367,6,7,6,18273,23281,23594,5008,313,18759,false,C-m-2 C-l-1 C-l-2 C-m-1 C-l-1 C-l-2 
job-368,5,10,7,18314,23594,23606,5280,12,18582,false,C-l-1 L-l-0 C-l-0 C-l-1 C-l-0 L-l-0 L-m-0 
job-369,3,7,5,18367,23594,23758,5227,164,18819,false,C-l-2 C-l-2 L-m-0 C-l-2 C-l-2 
job-370,3,6,3,18413,23758,23789,5345,31,18569,false,L-l-0 L-l-0 L-l-0 
job-371,6,12,1,18463,23758,23812,5295,54,18531,false,L-m-0 
job-373,5,10,3,18557,23758,23884,5201,126,18849,false,C-m-1 C-l-0 C-l-0 
job-372,4,5,3,18515,23758,24078,5243,320,19113,false,L-s-0 C-m-0 C-m-0 
job-374,3,7,5,18593,24078,24145,5485,67,18929,false,L-l-0 L-s-0 L-l-0 L-l-0 L-l-0 
job-376,5,8,4,18683,24078,24161,5395,83,18851,false,L-m-0 C-l-1 C-l-1 C-m-0 
job-378,1,11,8,18793,24161,24177,5368,16,18955,false,C-m-0 L-l-0 C-m-0 L-l-0 L-l-0 L-m-0 L-s-0 L-m-0 
job-377,5,6,1,18741,24145,24193,5404,48,18858,false,L-l-0 
job-375,1,4,2,18642,24078,24195,5436,117,18917,false,L-s-0 L-m-0 
job-380,5,8,6,18886,24161,24333,5275,172,19130,false,C-m-0 C-l-0 C-l-1 C-m-1 C-l-0 C-l-1 
job-379,4,12,5,18839,24161,24375,5322,214,19305,false,C-m-2 C-l-2 C-l-2 C-m-2 C-l-2 
job-381,2,9,3,18931,24333,24484,5402,151,19309,false,L-m-0 L-m-0 L-m-0 
job-382,3,11,1,18980,24484,24498,5504,14,19102,false,L-s-0 
job-383,2,4,7,19032,24484,24563,5452,79,19249,false,L-l-0 L-l-0 L-l-0 L-l-0 L-l-0 L-l-0 L-m-0 
job-384,2,5,3,19088,24563,24618,5475,55,19387,false,L-m-0 L-m-0 L-m-0 
job-386,1,12,6,19198,24563,24631,5365,68,19299,false,C-s-1 L-l-0 L-l-0 L-m-0 L-l-0 L-l-0 
job-387,5,12,7,19254,24563,24654,5309,91,19579,false,C-m-0 C-l-2 C-l-1 C-l-2 C-l-0 C-l-1 C-l-0 
job-385,3,8,1,19136,24563,24954,5427,391,19773,false,L-s-0 
job-388,2,6,3,19310,24954,25018,5644,64,19435,false,L-m-0 L-m-0 L-m-0 
job-390,2,11,7,19433,25018,25051,5585,33,19758,false,L-m-0 C-l-0 C-l-0 C-s-1 C-l-0 C-l-0 L-m-0 
job-391,5,5,6,19493,25018,25075,5525,57,19738,false,C-m-1 C-l-2 C-l-1 C-m-0 C-l-1 C-l-2 
job-389,3,9,6,19366,24954,25077,5588,123,19574,false,L-l-0 L-l-0 L-s-0 C-s-2 L-l-0 L-l-0 
job-392,2,9,4,19544,25075,25157,5531,82,19822,false,C-s-0 L-m-0 L-m-0 L-m-0 
job-393,1,12,2,19593,25075,25169,5482,94,19901,false,C-m-0 C-m-0 
job-394,4,7,5,19637,25157,25191,5520,34,19758,false,L-s-0 L-l-0 L-l-0 C-m-0 L-l-0 
job-396,4,12,8,19752,25157,25232,5405,75,19852,false,C-l-1 C-l-1 C-l-2 C-l-2 C-l-1 L-m-0 C-s-1 C-l-2 
job-398,5,8,6,19858,25232,25256,5374,24,19994,false,C-l-1 C-l-0 L-l-0 C-l-1 C-l-0 L-l-0 
job-397,1,4,2,19818,25157,25279,5339,122,20201,false,C-s-2 C-s-2 
job-395,4,10,1,19698,25157,25319,5459,162,19878,false,L-m-0 
job-400,6,4,3,19970,25232,25378,5262,146,20309,false,C-m-1 C-l-2 C-l-2 
job-399,5,10,1,19908,25232,25420,5324,188,20378,false,C-m-0 
job-401,3,12,2,20036,25420,25445,5384,25,20236,false,L-m-0 L-m-0 
job-402,5,10,3,20101,25420,25513,5319,93,20269,false,L-l-0 L-l-0 C-m-0 
job-403,1,5,1,20139,25513,25556,5374,43,20461,false,L-s-0 
job-404,2,9,3,20194,25513,25900,5319,387,20729,false,L-s-0 L-m-0 L-m-0 
job-406,3,11,7,20306,25900,25938,5594,38,20493,false,L-m-0 C-l-0 C-l-0 L-m-0 C-l-0 C-l-0 L-s-0 
job-407,4,10,3,20347,25900,26015,5553,115,20581,false,C-l-1 C-l-1 C-l-1 
job-408,5,5,5,20401,26015,26034,5614,19,20608,false,L-m-0 C-l-1 C-l-0 C-l-1 C-l-0 
job-405,2,9,5,20260,25900,26035,5640,135,20530,false,L-l-0 L-l-0 L-l-0 L-l-0 L-l-0 
job-409,3,5,8,20442,26015,26207,5573,192,20801,false,L-s-0 C-l-2 C-l-2 C-l-2 C-l-2 C-m-0 C-m-0 L-m-0 
job-410,2,7,5,20487,26207,26220,5720,13,20661,false,L-l-0 L-l-0 L-l-0 L-l-0 L-l-0 
job-411,5,8,5,20544,26207,26385,5663,178,20730,false,C-l-1 C-l-1 C-l-0 L-m-0 C-l-0 
job-412,5,8,5,20592,26385,26396,5793,11,20667,false,L-l-0 L-l-0 C-l-0 L-m-0 C-l-0 
job-414,4,6,5,20692,26385,26496,5693,111,20821,false,C-m-2 C-s-1 C-m-2 C-s-0 C-s-2 
job-413,3,6,4,20648,26385,26501,5737,116,20815,false,L-s-0 L-m-0 C-m-0 C-m-0 
job-416,5,6,8,20775,26496,26562,5721,66,20934,false,C-m-1 C-l-1 C-l-0 L-l-0 L-l-0 C-l-0 C-l-1 L-m-0 
job-415,3,4,1,20731,26385,26575,5654,190,20983,false,C-m-1 
job-417,1,11,6,20835,26562,26658,5727,96,20959,false,L-l-0 L-l-0 C-m-1 L-l-0 C-m-1 L-l-0 
job-418,3,7,8,20890,26562,26666,5672,104,21164,false,L-s-0 C-l-0 C-l-0 C-l-0 C-l-0 L-m-0 C-s-1 L-m-0 
job-420,5,12,4,20982,26666,26686,5684,20,21028,false,L-m-0 L-l-0 L-l-0 C-m-0 
job-419,2,9,1,20942,26666,26816,5724,150,21107,false,L-s-0 
job-421,1,10,1,21018,26816,26827,5798,11,21086,false,L-s-0 
job-423,3,9,5,21123,26816,26957,5693,141,21413,false,L-l-0 L-l-0 L-l-0 C-s-2 L-l-0 
job-422,1,8,4,21069,26816,26965,5747,149,21361,false,L-m-0 L-m-0 L-m-0 L-m-0 
job-424,2,11,3,21178,26957,27007,5779,50,21366,false,L-l-0 L-l-0 L-l-0 
job-425,6,7,4,21227,26957,27061,5730,104,21595,false,C-m-0 C-l-1 C-l-1 L-l-0 
job-426,6,10,6,21286,26957,27087,5671,130,21709,false,C-m-2 C-l-2 C-l-0 C-m-1 C-l-2 C-l-0 
job-427,2,9,8,21340,27061,27127,5721,66,21676,false,L-s-0 L-l-0 L-l-0 C-m-2 L-l-0 C-m-1 L-l-0 L-l-0 
job-428,5,9,4,21391,27061,27238,5670,177,21756,false,L-m-0 C-l-1 C-l-1 C-m-0 
job-429,2,8,8,21434,27061,27316,5627,255,21877,false,C-s-0 C-s-0 C-s-2 C-s-1 C-l-1 C-m-0 C-s-1 L-m-0 
job-430,6,4,5,21484,27316,27343,5832,27,21676,false,L-m-0 C-l-0 L-l-0 L-l-0 C-l-0 
job-433,6,12,6,21629,27343,27373,5714,30,21899,false,L-m-0 L-l-0 C-l-0 C-m-0 C-l-0 L-l-0 
job-431,6,7,2,21527,27316,27386,5789,70,21795,false,C-l-1 C-l-1 
job-432,3,8,7,21576,27316,27399,5740,83,21908,false,C-m-1 C-l-2 C-l-2 C-m-1 C-l-2 C-l-2 L-s-0 
job-434,2,8,8,21673,27343,27490,5670,147,21839,false,C-s-2 C-s-1 C-s-0 C-s-1 C-s-0 L-m-0 C-m-1 C-m-0 
job-435,3,8,3,21727,27490,27514,5763,24,21773,false,L-m-0 L-m-0 L-s-0 
job-437,1,6,6,21849,27490,27606,5641,116,21979,false,C-m-0 L-m-0 L-m-0 C-m-0 C-m-0 L-s-0 
job-436,3,8,4,21789,27490,27956,5701,466,22508,false,L-l-0 L-l-0 L-l-0 L-l-0 
job-439,5,5,5,21935,27956,27986,6021,30,22063,false,L-l-0 C-l-0 C-l-0 C-m-0 L-l-0 
job-438,3,11,3,21889,27956,28044,6067,88,22164,false,L-m-0 L-m-0 L-s-0 
job-441,6,10,1,22039,27986,28320,5947,334,22429,false,C-m-1 
job-440,6,4,7,21989,27986,28320,5997,334,22333,false,L-l-0 L-l-0 C-l-0 C-l-0 C-l-2 C-l-2 C-m-0 
job-444,3,4,7,22186,28320,28371,6134,51,22323,false,C-l-0 C-l-0 C-l-1 C-l-0 C-l-1 C-l-0 C-l-1 
job-442,2,5,1,22089,28320,28413,6231,93,22381,false,L-s-0 
job-443,3,5,7,22133,28320,28447,6187,127,22444,false,L-m-0 L-m-0 L-l-0 C-s-1 L-l-0 L-l-0 L-l-0 
job-448,3,4,8,22386,28447,28503,6061,56,22642,false,C-l-0 C-l-0 C-l-2 C-l-2 C-l-2 C-l-2 C-l-0 L-m-0 
job-447,6,4,5,22332,28447,28507,6115,60,22593,false,L-l-0 L-l-0 C-l-1 C-m-0 C-l-1 
job-450,4,11,7,22486,28503,28518,6017,15,22574,false,C-l-0 C-l-2 C-l-0 C-m-1 C-l-2 C-l-0 C-l-2 
job-449,1,10,6,22441,28503,28522,6062,19,22564,false,C-m-1 C-m-1 L-m-0 C-m-0 C-m-0 L-m-0 
job-446,4,12,1,22279,28447,28546,6168,99,22524,false,L-m-0 
job-445,1,4,3,22251,28447,28550,6196,103,22387,false,L-s-0 L-s-0 L-s-0 
job-453,6,4,7,22641,28518,28560,5877,42,22726,false,L-l-0 C-m-1 C-l-0 C-l-1 C-l-1 C-m-0 C-l-0 
job-451,6,6,1,22539,28503,28618,5964,115,22852,false,C-m-2 
job-452,2,12,2,22591,28503,28639,5912,136,22921,false,C-m-2 C-s-1 
job-454,4,10,2,22679,28618,28644,5939,26,23002,false,L-s-0 C-m-2 
job-455,3,6,8,22737,28618,28707,5881,89,23101,false,C-m-0 L-l-0 L-l-0 L-l-0 L-l-0 L-m-0 C-m-0 L-m-0 
job-456,1,9,7,22786,28707,28731,5921,24,23069,false,L-m-0 L-l-0 L-l-0 L-l-0 L-m-0 L-l-0 L-m-0 
job-457,5,12,8,22831,28707,28739,5876,32,22915,false,C-m-0 C-l-0 C-l-1 C-l-1 C-l-0 C-l-2 C-l-2 L-l-0 
job-459,5,11,3,22955,28739,28755,5784,16,23260,false,C-l-0 L-l-0 C-l-0 
job-458,4,11,3,22891,28731,28756,5840,25,23002,false,L-m-0 L-l-0 L-m-0 
job-461,2,9,4,23051,28756,28808,5705,52,23385,false,L-l-0 L-l-0 L-l-0 L-l-0 
job-462,6,8,2,23116,28756,28848,5640,92,23437,false,C-m-0 L-m-0 
job-463,3,8,2,23178,28808,28862,5630,54,23312,false,L-l-0 L-l-0 
job-464,3,11,2,23229,28862,28899,5633,37,23310,false,L-m-0 L-m-0 
job-460,2,8,1,23001,28756,28926,5755,170,23452,false,L-s-0 
job-465,5,6,4,23282,28862,29040,5580,178,23596,false,L-l-0 C-l-0 C-l-0 L-l-0 
job-466,5,10,2,23355,29040,29051,5685,11,23503,false,L-l-0 L-l-0 
job-467,3,6,6,23392,29040,29216,5648,176,23833,false,L-m-0 C-l-0 C-l-0 L-m-0 C-l-0 C-l-0 
job-468,2,7,6,23446,29040,29220,5594,180,23834,false,L-l-0 L-m-0 L-s-0 C-s-2 L-s-0 C-s-2 
job-469,6,12,1,23496,29220,29232,5724,12,23692,false,L-m-0 
job-470,6,9,1,23550,29220,29382,5670,162,23813,false,L-l-0 
job-471,1,11,7,23591,29382,29415,5791,33,23624,false,L-m-0 L-l-0 L-l-0 L-s-0 L-l-0 L-l-0 L-m-0 
job-473,4,12,7,23693,29382,29458,5689,76,23849,false,C-s-0 C-l-2 C-l-0 C-l-2 C-l-0 C-l-0 C-l-2 
job-474,4,11,6,23747,29415,29537,5668,122,24143,false,L-m-0 L-l-0 L-l-0 L-s-0 L-l-0 C-s-1 
job-472,3,10,8,23640,29382,29539,5742,157,23891,false,C-s-2 C-l-1 C-l-1 C-l-1 C-l-1 L-m-0 C-m-1 C-m-1 
job-475,5,7,6,23791,29458,29594,5667,136,23960,false,C-m-0 C-l-2 C-l-0 C-m-2 C-l-0 C-l-2 
job-477,5,10,6,23891,29594,29667,5703,73,24143,false,C-l-2 C-l-0 C-l-0 C-l-2 C-l-1 C-l-1 
job-476,5,8,4,23833,29539,29840,5706,301,24261,false,C-m-1 L-l-0 L-l-0 L-m-0 
job-481,2,4,5,24096,29840,29929,5744,89,24416,false,C-l-0 C-l-0 C-l-0 C-l-0 C-l-0 
job-478,1,8,4,23947,29840,30003,5893,163,24403,false,L-m-0 L-m-0 L-m-0 L-m-0 
job-479,2,7,6,23989,29840,30047,5851,207,24339,false,L-l-0 L-l-0 L-l-0 L-l-0 L-l-0 L-l-0 
job-480,3,8,1,24049,29840,30638,5791,798,24988,false,L-s-0 
job-482,5,9,2,24143,30638,30678,6495,40,24293,false,L-l-0 L-l-0 
job-483,3,9,7,24204,30638,30789,6434,151,24554,false,L-s-0 C-l-0 C-l-0 L-m-0 C-l-0 C-l-0 L-m-0 
job-486,5,9,5,24354,30789,30834,6435,45,24653,false,C-l-0 C-l-1 C-l-1 C-m-0 C-l-0 
job-484,2,11,2,24247,30789,30844,6542,55,24574,false,L-m-0 L-m-0 
job-485,3,6,6,24295,30789,31113,6494,324,24723,false,L-s-0 L-m-0 L-l-0 L-l-0 L-l-0 L-l-0 
job-487,4,8,3,24407,31113,31131,6706,18,24677,false,L-l-0 L-l-0 L-l-0 
job-488,6,4,5,24449,31113,31192,6664,79,24530,false,L-m-0 C-l-0 C-l-0 C-l-1 C-l-1 
job-489,3,4,1,24504,31192,31219,6688,27,24794,false,L-s-0 
job-490,6,4,8,24563,31192,31223,6629,31,24631,false,L-l-0 L-l-0 C-l-1 C-l-2 C-l-1 L-m-0 C-l-2 C-m-0 
job-491,3,8,4,24618,31192,31241,6574,49,24745,false,C-l-0 C-l-0 C-l-0 C-l-0 
job-492,6,7,3,24666,31223,31289,6557,66,24770,false,L-l-0 L-m-0 L-l-0 
job-493,2,5,7,24715,31223,31315,6508,92,24830,false,C-m-0 L-s-0 L-m-0 C-m-0 C-m-0 L-s-0 C-m-0 
job-494,6,9,4,24772,31223,31372,6451,149,25100,false,C-l-2 C-l-2 C-l-1 C-l-1 
job-495,1,5,7,24820,31315,31388,6495,73,25018,false,L-l-0 L-l-0 L-l-0 L-l-0 L-l-0 L-l-0 L-l-0 
job-497,6,7,1,24929,31372,31402,6443,30,25017,false,C-m-0 
job-498,1,5,4,24974,31372,31429,6398,57,25141,false,C-m-0 C-s-1 C-s-1 C-m-0 
job-496,4,10,4,24877,31315,31447,6438,132,25234,false,L-s-0 L-m-0 L-l-0 L-m-0 
job-499,5,11,2,25026,31372,31540,6346,168,25355,false,C-l-0 C-l-0 
job-500,4,5,1,25077,31540,31572,6463,32,25303,false,L-s-0 
job-502,5,7,4,25183,31540,31675,6357,135,25486,false,L-m-0 C-l-0 C-l-0 C-m-1 
job-501,3,11,4,25133,31540,31676,6407,136,25421,false,L-l-0 L-l-0 L-l-0 L-l-0 
job-503,4,4,2,25226,31540,31742,6314,202,25441,false,C-m-0 C-m-0 
job-504,2,7,6,25278,31675,31760,6397,85,25407,false,L-m-0 L-m-0 L-s-0 L-m-0 L-m-0 L-s-0 
job-505,5,10,3,25327,31675,32309,6348,634,26110,false,C-l-1 C-m-1 C-l-1 
job-506,1,4,4,25377,32309,32340,6932,31,25697,false,L-s-0 L-s-0 L-s-0 L-s-0 
job-509,1,10,2,25557,32309,32363,6752,54,25761,false,L-m-0 C-s-2 
job-508,4,4,7,25503,32309,32365,6806,56,25757,false,L-l-0 C-l-1 L-l-0 C-l-1 C-l-1 L-l-0 C-s-1 
job-510,4,4,4,25611,32340,32374,6729,34,25891,false,L-s-0 C-l-0 C-l-0 C-l-0 
job-507,2,5,3,25436,32309,32472,6873,163,25817,false,L-m-0 L-m-0 L-m-0 
job-511,2,12,1,25656,32472,32508,6816,36,25907,false,L-s-0 
job-513,5,8,7,25757,32472,32604,6715,132,25926,false,C-m-0 C-l-1 C-l-0 C-l-2 C-l-1 C-l-2 C-l-0 
job-512,3,12,7,25701,32472,32617,6771,145,25848,false,L-m-0 L-l-0 L-l-0 L-m-0 L-l-0 L-l-0 C-s-1 
job-514,5,6,2,25797,32604,32634,6807,30,26066,false,C-l-0 C-l-0 
job-515,1,5,4,25840,32604,32706,6764,102,26201,false,L-s-0 C-l-0 C-l-0 L-m-0 
job-516,6,8,1,25881,32706,32766,6825,60,25942,false,L-m-0 
job-517,2,4,7,25927,32706,32782,6779,76,26206,false,L-l-0 L-l-0 L-m-0 L-l-0 L-l-0 L-l-0 L-l-0 
job-518,6,11,3,25977,32706,32797,6729,91,26076,false,C-l-1 C-m-0 C-l-1 
job-519,4,5,8,26027,32766,32800,6739,34,26305,false,L-m-0 C-l-0 C-l-0 C-l-0 C-l-2 C-l-2 C-l-2 L-s-0 
job-520,4,10,6,26070,32766,32936,6696,170,26384,false,C-s-1 C-m-2 C-m-1 C-m-1 C-m-2 C-s-2 
job-521,1,5,7,26123,32936,32973,6813,37,26428,false,L-l-0 L-l-0 L-l-0 L-l-0 L-l-0 L-l-0 L-l-0 
job-522,3,6,3,26170,32936,32974,6766,38,26455,false,L-m-0 L-m-0 L-l-0 
job-524,2,12,4,26253,32936,33003,6683,67,26500,false,L-s-0 C-l-0 C-s-1 L-m-0 
job-523,5,4,2,26215,32936,33028,6721,92,26360,false,C-l-0 C-l-0 
job-525,1,4,3,26310,33003,33096,6693,93,26473,false,L-s-0 C-l-0 C-l-0 
job-526,2,7,5,26352,33096,33171,6744,75,26526,false,L-l-0 L-l-0 L-l-0 L-l-0 L-l-0 
job-527,6,4,8,26404,33096,33238,6692,142,26706,false,C-l-0 C-l-2 C-l-0 C-l-1 C-l-1 C-l-2 C-m-0 L-m-0 
job-528,2,12,8,26452,33096,33340,6644,244,26900,false,C-s-1 L-l-0 C-m-1 C-s-2 L-m-0 C-m-0 L-s-0 C-m-1 
job-529,3,7,2,26500,33340,33445,6840,105,26608,false,L-m-0 L-m-0 
job-530,3,6,4,26546,33340,33588,6794,248,27027,false,L-l-0 L-l-0 L-l-0 L-l-0 
job-531,1,10,2,26596,33588,33607,6992,19,26907,false,L-m-0 L-m-0 
job-532,6,11,8,26644,33588,33615,6944,27,26757,false,L-m-0 L-l-0 C-l-0 C-l-2 C-l-0 C-l-2 L-l-0 C-m-0 
job-533,5,12,6,26698,33615,33836,6917,221,27065,false,C-m-0 L-l-0 C-l-0 L-m-0 C-l-0 L-l-0 
job-535,4,6,7,26788,33836,33866,7048,30,26825,false,L-l-0 L-m-0 C-l-0 L-m-0 C-l-0 L-s-0 C-l-0 
job-536,4,7,4,26841,33836,33919,6995,83,27085,false,C-s-1 C-l-2 C-l-2 C-l-2 
job-534,2,9,4,26753,33836,33949,7083,113,27012,false,L-l-0 L-l-0 L-l-0 L-l-0 
job-537,6,6,3,26893,33836,33961,6943,125,27300,false,C-l-1 C-l-1 C-m-0 
job-538,2,9,6,26942,33836,33962,6894,126,27218,false,C-s-2 C-m-0 C-m-1 C-m-1 C-m-1 C-s-0 
job-539,3,4,1,26994,33836,33980,6842,144,27434,false,C-m-2 
job-540,2,10,6,27041,33919,33996,6878,77,27330,false,L-m-0 L-l-0 C-m-2 C-m-2 L-m-0 L-m-0 
job-541,6,12,7,27104,33961,34196,6857,235,27460,false,C-l-0 L-l-0 C-l-0 C-m-0 C-l-1 C-l-1 C-l-2 
job-542,6,4,2,27158,34196,34273,7038,77,27417,false,L-l-0 L-l-0 
job-544,4,5,1,27264,34273,34302,7009,29,27517,false,L-s-0 
job-543,5,6,1,27210,34273,34304,7063,31,27463,false,L-m-0 
job-545,6,11,8,27315,34273,34398,6958,125,27661,false,L-l-0 C-l-2 C-l-0 C-l-2 C-l-1 L-l-0 C-l-0 C-l-1 
job-546,3,11,4,27362,34273,34526,6911,253,27676,false,C-s-1 L-m-0 C-m-2 C-m-2 
job-547,3,12,8,27414,34526,34536,7112,10,27717,false,L-m-0 L-l-0 C-s-1 L-l-0 L-l-0 L-l-0 L-m-0 L-s-0 
job-548,2,5,6,27466,34526,34681,7060,155,27642,false,C-l-0 C-l-0 L-m-0 C-l-0 C-l-0 C-l-0 
job-549,3,8,4,27518,34526,34826,7008,300,28015,false,C-l-1 C-l-1 C-l-1 C-l-1 
job-550,4,8,5,27572,34826,34868,7254,42,27740,false,L-m-0 L-l-0 L-l-0 L-l-0 L-m-0 
job-551,6,12,7,27625,34826,34919,7201,93,27972,false,C-l-0 C-l-0 C-l-1 C-m-0 C-l-1 C-l-2 C-l-2 
job-552,6,8,2,27669,34826,34964,7157,138,27815,false,C-m-2 C-m-1 
job-553,2,12,5,27708,34826,35017,7118,191,27918,false,C-s-1 C-m-1 L-s-0 C-m-0 C-m-2 
job-554,6,10,7,27749,35017,35032,7268,15,27815,false,L-m-0 C-l-0 C-l-1 L-l-0 C-l-0 C-l-1 L-l-0 
job-556,3,6,8,27838,35017,35086,7179,69,27992,false,C-l-2 C-l-2 C-l-2 C-m-1 C-m-0 C-m-1 C-l-2 C-m-0 
job-557,4,6,8,27878,35086,35103,7208,17,27966,false,L-m-0 L-l-0 C-l-0 C-l-0 C-l-0 L-l-0 L-l-0 L-m-0 
job-555,3,8,1,27795,35017,35118,7222,101,28119,false,L-s-0 
job-558,1,5,3,27931,35086,35130,7155,44,28185,false,C-s-1 C-s-1 L-s-0 
job-560,2,12,6,28030,35086,35217,7056,131,28283,false,C-m-2 C-l-1 C-l-1 C-m-2 C-l-1 C-l-1 
job-559,1,8,7,27982,35086,35365,7104,279,28507,false,C-l-2 C-l-2 C-l-2 C-s-2 C-l-2 C-l-2 C-l-2 
job-561,3,10,6,28074,35365,35413,7291,48,28384,false,L-m-0 L-l-0 L-l-0 L-l-0 L-m-0 L-l-0 
job-562,5,11,8,28132,35365,35759,7233,394,28765,false,C-m-1 C-l-1 C-l-0 C-l-2 C-l-1 C-l-2 C-l-0 C-m-0 
job-563,4,12,5,28165,35759,35834,7594,75,28398,false,L-m-0 L-l-0 L-l-0 L-l-0 L-m-0 
job-564,3,6,3,28218,35834,35855,7616,21,28408,false,L-l-0 L-l-0 L-l-0 
job-565,3,12,3,28253,35834,35865,7581,31,28447,false,L-m-0 L-m-0 L-l-0 
job-566,1,12,6,28306,35834,36265,7528,431,28936,false,L-s-0 C-l-0 C-l-0 C-s-1 C-l-0 C-l-0 
job-567,4,5,5,28351,36265,36312,7914,47,28631,false,L-m-0 L-l-0 L-l-0 L-l-0 L-m-0 
job-568,4,4,7,28399,36265,36396,7866,131,28727,false,C-l-0 C-l-1 C-l-0 C-l-1 C-l-1 C-l-0 L-s-0 
job-570,4,4,3,28487,36396,36442,7909,46,28534,false,L-l-0 L-l-0 L-l-0 
job-569,1,4,2,28450,36396,36459,7946,63,28666,false,L-s-0 L-s-0 
job-572,6,6,5,28576,36442,36515,7866,73,28793,false,C-m-1 C-l-2 L-l-0 L-l-0 C-l-2 
job-573,4,7,2,28625,36442,36559,7817,117,28859,false,C-m-2 C-m-2 
job-571,5,9,6,28534,36396,36559,7862,163,28979,false,L-m-0 C-l-0 C-l-1 C-m-0 C-l-0 C-l-1 
job-574,6,12,4,28681,36515,36580,7834,65,28998,false,C-l-2 L-l-0 L-l-0 C-l-2 
job-575,2,12,8,28725,36515,36634,7790,119,29095,false,C-s-1 C-l-0 C-l-1 L-s-0 C-m-1 C-m-1 C-m-0 L-m-0 
job-577,4,12,4,28827,36634,36650,7807,16,29090,false,L-s-0 C-s-2 L-m-0 L-m-0 
job-576,2,10,4,28767,36634,36663,7867,29,28889,false,L-l-0 L-l-0 L-l-0 L-l-0 
job-579,3,4,4,28919,36663,36685,7744,22,29135,false,L-m-0 L-l-0 L-l-0 L-m-0 
job-578,4,8,3,28866,36634,36686,7768,52,29124,false,C-m-0 C-m-0 L-l-0 
job-580,3,8,2,28966,36663,36797,7697,134,29139,false,L-s-0 C-s-1 
job-581,1,8,7,29017,36663,36882,7646,219,29369,false,L-s-0 L-l-0 L-l-0 C-s-1 C-s-2 L-m-0 L-m-0 
job-582,4,5,7,29072,36882,36916,7810,34,29116,false,L-l-0 L-m-0 L-s-0 L-l-0 L-m-0 L-l-0 C-s-1 
job-583,6,4,6,29118,36882,36990,7764,108,29381,false,C-l-0 C-l-1 C-l-2 C-l-2 C-l-1 C-l-0 
job-584,6,12,2,29170,36990,37009,7820,19,29272,false,L-l-0 L-l-0 
job-586,2,11,7,29264,36990,37035,7726,45,29370,false,L-s-0 C-l-0 C-l-0 L-m-0 C-l-0 C-l-0 L-m-0 
job-585,1,4,1,29211,36990,37261,7779,271,29780,false,L-s-0 
job-587,2,7,7,29308,36990,37307,7682,317,29865,false,C-l-1 C-l-1 C-l-1 C-l-1 C-l-1 C-l-1 L-m-0 
job-588,6,5,7,29360,37261,37315,7901,54,29523,false,C-l-0 C-l-2 L-m-0 C-l-2 C-l-0 L-l-0 L-l-0 
job-589,4,8,8,29418,37307,37318,7889,11,29724,false,L-s-0 C-l-1 C-l-1 C-l-1 C-m-0 C-m-1 C-m-1 C-m-0 
job-591,4,12,8,29513,37318,37363,7805,45,29725,false,C-m-1 C-l-1 C-m-1 C-l-1 C-l-1 C-m-0 L-s-0 C-m-0 
job-590,5,4,7,29465,37315,37403,7850,88,29841,false,L-l-0 C-l-2 C-l-0 L-m-0 C-l-0 C-l-2 L-l-0 
job-592,5,11,8,29559,37403,37423,7844,20,29689,false,C-m-0 C-l-0 C-l-0 C-l-1 C-l-1 L-l-0 L-m-0 L-l-0 
job-593,5,7,7,29607,37423,37510,7816,87,29906,false,C-l-1 L-l-0 C-l-0 C-l-1 C-l-0 L-l-0 L-m-0 
job-595,2,6,8,29701,37510,37575,7809,65,29848,false,C-s-0 C-s-2 L-m-0 C-s-0 L-m-0 L-m-0 C-s-2 L-m-0 
job-594,2,6,8,29663,37510,37583,7847,73,29951,false,L-l-0 L-s-0 L-l-0 L-l-0 L-l-0 L-s-0 L-l-0 L-l-0 
job-597,4,9,4,29799,37510,37669,7711,159,30173,false,C-s-1 C-l-2 C-l-2 C-l-2 
job-596,3,8,6,29752,37510,37779,7758,269,30183,false,C-m-0 C-l-1 C-l-1 C-m-0 C-l-1 C-l-1 
job-599,3,6,3,29908,37779,37804,7871,25,30098,false,L-l-0 L-l-0 L-m-0 
job-598,5,4,1,29854,37669,37841,7815,172,30084,false,L-m-0 
job-600,1,7,8,29966,37779,37895,7813,116,30317,false,L-s-0 L-l-0 L-l-0 L-s-0 L-l-0 L-l-0 C-s-1 L-l-0 
job-602,6,4,3,30070,37895,37908,7825,13,30262,false,L-l-0 L-l-0 C-m-0 
job-601,2,7,4,30015,37895,37924,7880,29,30226,false,L-m-0 L-m-0 L-m-0 L-m-0 
job-604,4,8,4,30162,37895,37954,7733,59,30276,false,C-s-2 C-l-0 C-l-0 C-l-0 
job-603,2,9,3,30119,37895,37971,7776,76,30312,false,L-s-0 C-s-1 C-m-0 
job-605,2,8,8,30220,37954,37987,7734,33,30265,false,L-l-0 L-l-0 L-l-0 L-l-0 L-l-0 L-l-0 C-m-0 C-m-0 
job-606,5,12,3,30261,37954,38005,7693,51,30513,false,L-m-0 C-l-0 C-l-0 
job-607,6,11,2,30318,37954,38044,7636,90,30562,false,C-l-1 C-l-1 
job-608,6,7,3,30383,37954,38223,7571,269,30805,false,C-m-1 C-l-2 C-l-2 
job-610,6,11,8,30490,38223,38257,7733,34,30666,false,L-l-0 C-l-0 C-l-0 C-l-2 C-l-1 C-l-1 C-l-2 L-l-0 
job-611,1,10,5,30536,38257,38277,7721,20,30714,false,L-s-0 L-l-0 L-l-0 L-l-0 L-l-0 
job-612,3,7,5,30587,38257,38283,7670,26,30624,false,C-l-0 C-l-0 L-l-0 C-l-0 C-l-0 
job-609,1,4,7,30447,38223,38294,7776,71,30714,false,L-m-0 L-m-0 L-m-0 L-m-0 L-m-0 L-m-0 L-m-0 
job-613,6,5,1,30635,38257,38324,7622,67,30746,false,C-m-0 
job-614,5,11,3,30696,38257,38351,7561,94,30854,false,C-m-1 C-l-1 C-l-1 
job-616,6,12,6,30799,38351,38394,7552,43,31042,false,C-l-0 C-l-1 C-l-1 L-l-0 C-l-0 L-l-0 
job-615,1,9,3,30748,38351,38483,7603,132,30970,false,L-m-0 L-m-0 L-m-0 
job-617,1,6,5,30857,38351,38488,7494,137,31148,false,C-m-0 C-m-0 C-m-0 C-m-0 C-m-0 
job-619,6,4,2,30955,38394,38527,7439,133,31387,false,C-m-2 C-m-1 
job-618,5,10,8,30911,38394,38553,7483,159,31185,false,C-l-2 C-l-1 C-l-0 C-l-0 C-l-1 L-l-0 C-l-2 L-l-0 
job-620,2,4,5,31000,38527,38609,7527,82,31333,false,L-s-0 C-l-1 C-l-0 C-l-2 L-l-0 
job-621,2,7,3,31053,38527,38665,7474,138,31424,false,L-m-0 L-m-0 L-s-0 
job-622,5,11,6,31104,38609,38785,7505,176,31408,false,C-l-1 L-l-0 C-l-0 C-l-1 C-l-0 L-l-0 
job-623,4,9,1,31149,38785,38810,7636,25,31295,false,L-s-0 
job-626,2,9,4,31312,38785,38926,7473,141,31635,false,C-l-2 C-l-2 C-l-2 C-l-2 
job-624,4,5,8,31208,38785,38942,7577,157,31390,false,L-m-0 L-l-0 L-l-0 C-l-0 C-l-0 L-m-0 C-l-0 L-l-0 
job-625,4,6,3,31265,38785,38950,7520,165,31542,false,C-l-1 C-l-1 C-l-1 
job-627,3,4,5,31356,38785,39160,7429,375,31876,false,C-m-0 C-m-1 C-l-2 C-m-0 C-m-1 
job-628,2,11,2,31414,39160,39263,7746,103,31647,false,L-m-0 L-m-0 
job-629,6,12,8,31471,39160,39284,7689,124,31808,false,C-l-0 L-l-0 C-l-0 C-l-2 C-l-1 L-l-0 C-l-2 C-l-1 
job-630,6,8,6,31516,39284,39301,7768,17,31633,false,C-m-0 C-l-0 L-l-0 L-m-0 C-l-0 L-l-0 
job-631,6,7,1,31563,39284,39504,7721,220,31974,false,C-m-1 
job-632,5,11,6,31610,39301,39598,7691,297,32111,false,L-m-0 L-l-0 C-l-0 C-m-0 C-l-0 L-l-0 
job-633,4,6,6,31655,39504,39619,7849,115,31856,false,L-s-0 C-l-1 C-l-1 C-m-1 C-l-1 C-m-1 
job-634,1,12,2,31700,39598,39627,7898,29,31825,false,L-m-0 L-m-0 
job-635,4,9,4,31748,39598,39717,7850,119,32159,false,L-l-0 L-l-0 L-l-0 C-s-1 
job-636,3,6,4,31796,39717,39733,7921,16,31828,false,L-l-0 L-l-0 L-l-0 L-l-0 
job-637,4,8,8,31851,39717,39749,7866,32,31913,false,L-s-0 L-m-0 C-l-1 C-l-1 C-m-0 C-l-1 L-m-0 C-m-0 
job-638,6,5,6,31912,39717,39804,7805,87,32023,false,C-m-1 C-l-0 C-l-2 C-m-2 C-l-2 C-l-0 
job-639,2,5,6,31962,39749,39813,7787,64,32134,false,L-m-0 L-m-0 L-m-0 C-m-2 C-m-1 L-m-0 
job-640,5,6,1,32020,39749,39831,7729,82,32373,false,L-l-0 
job-643,4,12,8,32195,39831,39856,7636,25,32472,false,C-s-0 L-l-0 C-l-2 C-l-2 C-l-2 L-l-0 C-s-2 L-l-0 
job-644,1,12,7,32236,39856,39868,7620,12,32254,false,L-l-0 C-l-0 C-l-0 C-l-0 C-l-0 L-l-0 L-l-0 
job-642,1,11,2,32135,39831,39879,7696,48,32283,false,L-m-0 L-m-0 
job-641,2,7,1,32078,39831,39888,7753,57,32431,false,L-s-0 
job-645,6,6,4,32283,39856,40416,7573,560,32984,false,L-m-0 L-l-0 C-l-1 C-l-1 
job-646,3,7,6,32338,40416,40468,8078,52,32419,false,L-m-0 L-l-0 L-l-0 L-l-0 L-m-0 L-l-0 
job-648,3,6,1,32442,40416,40649,7974,233,32819,false,C-s-2 
job-647,2,4,5,32388,40416,40658,8028,242,32754,false,C-s-1 L-s-0 L-m-0 C-s-1 L-s-0 
job-650,6,8,3,32538,40658,40670,8120,12,32660,false,L-l-0 L-l-0 C-m-0 
job-651,4,9,8,32580,40658,40671,8078,13,32717,false,L-s-0 C-l-1 C-l-0 C-l-0 C-l-1 C-l-0 C-s-1 C-l-1 
job-649,3,9,2,32484,40658,40737,8174,79,32620,false,L-m-0 L-m-0 
job-653,1,7,7,32696,40658,40747,7962,89,32979,false,C-s-2 C-m-2 C-m-2 C-m-2 C-l-2 C-m-2 C-s-2 
job-652,2,12,5,32645,40658,40765,8013,107,32784,false,C-l-2 C-l-2 L-m-0 C-l-2 C-m-0 
job-654,1,4,5,32754,40658,40876,7904,218,33150,false,C-s-0 C-m-2 C-s-0 C-s-0 C-l-2 
job-655,1,5,7,32809,40876,40901,8067,25,33065,false,L-l-0 L-l-0 L-l-0 L-l-0 L-l-0 L-l-0 L-l-0 
job-656,3,6,7,32855,40876,40981,8021,105,33119,false,L-m-0 C-l-0 C-l-0 C-l-0 C-l-0 L-l-0 L-m-0 
job-657,3,4,3,32911,40876,41215,7965,339,33353,false,L-s-0 C-m-0 C-m-0 
job-658,2,10,5,32968,41215,41274,8247,59,33178,false,L-s-0 L-l-0 L-l-0 L-l-0 L-l-0 
job-661,5,11,3,33140,41274,41331,8134,57,33478,false,C-l-0 L-l-0 C-l-0 
job-659,4,8,4,33027,41215,41341,8188,126,33191,false,L-m-0 C-s-1 L-l-0 L-m-0 
job-660,1,10,7,33081,41215,41346,8134,131,33332,false,C-m-0 C-l-1 C-l-1 C-m-0 C-l-1 C-l-1 C-m-0 
job-662,4,4,5,33191,41274,41928,8083,654,34061,false,L-s-0 C-l-1 C-m-1 C-m-1 C-l-1 
job-664,3,10,6,33308,41928,41941,8620,13,33528,false,L-s-0 L-l-0 L-l-0 C-s-1 L-l-0 L-l-0 
job-663,4,10,2,33250,41928,41981,8678,53,33571,false,L-m-0 L-m-0 
job-665,3,7,4,33350,41928,42013,8578,85,33459,false,C-l-0 C-l-0 C-l-0 C-l-0 
job-667,2,7,5,33447,41928,42152,8481,224,33943,false,C-m-1 C-m-2 C-m-0 C-m-2 C-m-2 
job-666,6,11,6,33407,41928,42163,8521,235,33741,false,C-m-0 C-l-1 C-l-2 C-m-1 C-l-2 C-l-1 
job-668,1,4,3,33509,42163,42177,8654,14,33747,false,L-s-0 L-s-0 L-s-0 
job-669,5,4,2,33559,42163,42492,8604,329,34062,false,L-l-0 L-l-0 
job-670,6,10,2,33607,42163,42558,8556,395,34108,false,L-m-0 C-m-0 
job-672,2,9,8,33700,42558,42585,8858,27,33999,false,C-m-0 L-l-0 C-m-0 C-m-0 L-m-0 L-m-0 L-s-0 L-m-0 
job-671,5,11,2,33653,42558,42594,8905,36,33886,false,L-l-0 L-l-0 
job-673,1,10,6,33755,42558,42767,8803,209,33998,false,C-m-1 C-m-2 C-m-2 C-m-2 C-m-1 C-m-1 
job-674,4,5,2,33817,42767,42792,8950,25,33986,false,L-m-0 L-m-0 
job-675,3,10,7,33864,42767,42923,8903,156,34060,false,L-s-0 L-l-0 L-l-0 C-s-0 L-l-0 L-l-0 C-s-1 
job-676,6,10,1,33910,42923,42976,9013,53,34031,false,L-m-0 
job-677,6,7,8,33964,42923,42992,8959,69,34198,false,L-l-0 C-l-0 C-l-0 C-l-2 C-l-1 C-l-1 C-l-2 L-l-0 
job-678,5,11,1,34014,42923,43160,8909,237,34439,false,C-m-0 
job-679,2,9,3,34079,43160,43218,9081,58,34313,false,L-m-0 L-m-0 L-m-0 
job-680,1,12,7,34130,43160,43227,9030,67,34232,false,L-s-0 L-l-0 L-l-0 C-m-0 L-l-0 L-l-0 C-m-0 
job-681,4,6,4,34188,43160,43279,8972,119,34346,false,C-m-0 C-l-0 C-l-0 C-l-0 
job-682,1,11,7,34237,43160,43300,8923,140,34646,false,C-l-1 C-l-2 C-l-2 C-l-2 C-l-1 C-l-2 C-l-1 
job-683,6,10,2,34287,43160,43448,8873,288,34599,false,C-m-1 C-l-1 
job-684,5,4,6,34341,43448,43464,9107,16,34564,false,L-m-0 C-l-0 C-l-0 C-m-0 L-l-0 L-l-0 
job-685,6,8,2,34392,43448,43554,9056,106,34600,false,C-l-1 C-l-1 
job-686,4,5,7,34434,43448,43602,9014,154,34635,false,L-s-0 C-l-2 C-l-2 C-m-1 C-l-2 C-s-1 C-m-1 
job-687,6,6,3,34482,43554,43612,9072,58,34711,false,L-m-0 L-l-0 L-l-0 
job-688,4,5,1,34539,43602,43624,9063,22,34776,false,L-s-0 
job-689,1,6,8,34588,43602,43752,9014,150,34786,false,C-l-0 L-m-0 C-l-0 L-m-0 C-l-0 C-l-0 C-l-0 C-l-0 
job-691,6,11,6,34674,43752,43778,9078,26,34758,false,L-m-0 C-l-0 C-l-1 C-m-0 C-l-0 C-l-1 
job-692,4,4,8,34728,43752,43810,9024,58,35051,false,L-s-0 C-l-2 C-l-2 C-l-2 C-m-1 C-m-2 C-m-2 C-m-1 
job-690,3,6,3,34630,43752,43824,9122,72,34757,false,L-l-0 L-l-0 L-l-0 
job-693,6,8,3,34783,43778,43831,8995,53,35072,false,C-l-0 C-l-0 L-m-0 
job-695,4,8,8,34884,43824,43834,8940,10,34906,false,L-s-0 C-l-2 C-l-2 C-l-2 C-l-1 C-l-1 C-l-1 L-l-0 
job-694,2,4,5,34840,43824,43835,8984,11,35026,false,L-l-0 L-l-0 L-m-0 L-l-0 L-l-0 
job-697,6,10,5,34976,43831,43885,8855,54,35267,false,L-m-0 C-l-0 C-m-1 C-m-0 C-l-0 
job-696,1,6,2,34931,43824,44080,8893,256,35315,false,C-s-1 C-s-1 
job-698,4,12,3,35018,44080,44090,9062,10,35228,false,L-m-0 L-m-0 L-s-0 
job-699,1,4,7,35067,44080,44532,9013,452,35671,false,L-l-0 L-l-0 L-l-0 L-l-0 L-l-0 L-l-0 L-l-0 
job-700,3,9,8,35122,44532,44554,9410,22,35171,false,L-s-0 L-l-0 L-l-0 L-l-0 L-l-0 L-m-0 C-s-0 L-m-0 
job-701,1,11,8,35175,44532,44714,9357,182,35402,false,C-l-0 C-l-0 C-l-1 C-l-1 C-l-1 C-l-1 C-l-0 L-m-0 
job-702,6,12,4,35225,44532,44857,9307,325,35628,false,C-m-0 C-l-2 C-l-0 C-l-2 
job-703,6,9,6,35270,44857,44869,9587,12,35498,false,C-m-0 C-l-0 L-l-0 L-m-0 C-l-0 L-l-0 
job-704,5,10,5,35331,44857,44988,9526,131,35653,false,C-m-1 C-l-1 C-l-1 C-l-2 C-l-2 
job-705,4,12,1,35380,44988,45038,9608,50,35716,false,L-s-0 
job-706,3,5,1,35426,44988,45047,9562,59,35532,false,L-m-0 
job-707,1,4,2,35472,45047,45066,9575,19,35638,false,L-s-0 L-s-0 
job-708,3,6,4,35519,45047,45217,9528,170,35689,false,L-l-0 L-l-0 L-l-0 L-l-0 
job-709,3,4,3,35558,45217,45228,9659,11,35592,false,L-l-0 L-l-0 L-l-0 
job-710,3,5,5,35611,45217,45487,9606,270,36071,false,L-s-0 L-m-0 C-s-1 L-m-0 L-l-0 
job-712,2,11,2,35707,45487,45528,9780,41,36031,false,L-m-0 L-m-0 
job-711,1,6,7,35657,45487,45539,9830,52,35888,false,L-l-0 L-l-0 L-l-0 L-l-0 L-l-0 L-l-0 L-l-0 
job-713,5,9,2,35750,45487,45600,9737,113,35950,false,C-l-0 C-l-0 
job-714,1,5,3,35799,45539,45731,9740,192,36096,false,L-s-0 C-l-0 C-l-0 
job-715,1,11,7,35858,45600,45731,9742,131,36072,false,L-l-0 L-l-0 C-l-0 L-s-0 L-l-0 C-l-0 C-l-0 
job-716,4,4,2,35922,45731,45802,9809,71,36185,false,L-m-0 L-m-0 
job-717,2,5,7,35955,45731,45820,9776,89,36324,false,L-s-0 L-s-0 L-l-0 L-l-0 L-l-0 L-l-0 L-l-0 
job-718,4,8,4,36008,45731,46008,9723,277,36568,false,C-l-1 C-l-1 C-l-1 C-s-1 
job-719,1,12,3,36063,46008,46102,9945,94,36386,false,L-l-0 L-l-0 L-l-0 
job-720,2,8,8,36114,46008,46496,9894,488,36675,false,C-s-1 L-m-0 L-l-0 C-s-1 L-m-0 L-m-0 L-s-0 L-m-0 
job-721,3,10,1,36171,46496,46529,10325,33,36288,false,L-s-0 
job-722,2,6,8,36217,46496,46537,10279,41,36375,false,L-m-0 L-m-0 L-l-0 L-l-0 L-l-0 L-l-0 L-l-0 L-l-0 
job-723,2,10,3,36268,46496,46635,10228,139,36703,false,L-m-0 L-m-0 C-s-0 
job-726,5,12,6,36427,46496,46662,10069,166,36845,false,C-l-1 C-l-2 C-l-0 C-l-1 C-l-0 C-l-2 
job-724,3,12,1,36313,46496,46682,10183,186,36763,false,C-s-1 
job-725,1,10,3,36370,46496,46903,10126,407,36819,false,C-m-0 C-m-0 C-m-0 
job-728,6,6,6,36523,46903,46971,10380,68,36607,false,C-m-0 C-l-1 C-l-1 L-m-0 C-l-0 C-l-0 
job-727,4,4,3,36476,46903,46986,10427,83,36849,false,L-l-0 L-l-0 L-l-0 
job-729,5,4,5,36574,46971,47000,10397,29,36852,false,L-m-0 C-l-1 C-l-1 C-l-2 C-l-2 
job-730,4,7,3,36616,46971,47053,10355,82,36990,false,L-s-0 C-m-0 C-m-0 
job-731,6,5,1,36663,47053,47090,10390,37,36850,false,L-m-0 
job-734,1,4,7,36809,47053,47102,10244,49,36951,false,C-m-0 C-m-0 L-s-0 C-m-0 C-m-0 C-s-1 C-m-0 
job-733,1,9,2,36759,47053,47139,10294,86,37055,false,L-s-0 C-s-1 
job-732,1,12,6,36709,47053,47153,10344,100,36996,false,L-l-0 L-m-0 L-m-0 L-l-0 L-l-0 L-l-0 
job-737,6,4,8,36960,47153,47184,10193,31,37268,false,C-l-1 L-m-0 C-l-0 C-l-1 C-l-0 C-l-2 C-l-2 C-m-0 
job-736,1,9,7,36907,47153,47419,10246,266,37430,false,L-m-0 L-l-0 L-l-0 L-l-0 L-l-0 L-l-0 L-m-0 
job-735,2,8,1,36857,47153,47576,10296,423,37542,false,L-s-0 
job-738,2,11,1,37013,47419,47579,10406,160,37370,false,L-m-0 
job-739,1,4,5,37059,47579,47611,10520,32,37327,false,L-m-0 L-m-0 L-m-0 L-m-0 L-m-0 
job-740,4,12,3,37117,47579,47691,10462,112,37255,false,L-l-0 L-l-0 L-l-0 
job-741,6,12,4,37152,47579,47782,10427,203,37499,false,C-l-0 C-l-1 C-l-0 C-l-1 
job-742,4,9,1,37192,47691,47824,10499,133,37356,false,L-s-0 
job-743,5,8,1,37244,47824,47835,10580,11,37267,false,L-m-0 
job-746,6,11,3,37409,47824,47898,10415,74,37539,false,C-l-1 C-m-2 C-l-1 
job-744,5,9,4,37294,47824,47903,10530,79,37604,false,L-l-0 C-l-0 C-l-0 L-l-0 
job-745,4,7,2,37351,47824,47950,10473,126,37675,false,L-s-0 C-s-1 
job-747,5,7,6,37458,47898,48053,10440,155,37761,false,C-m-0 C-l-2 C-l-1 L-m-0 C-l-2 C-l-1 
job-748,4,10,2,37511,48053,48094,10542,41,37580,false,L-m-0 L-m-0 
job-749,4,11,4,37556,48053,48132,10497,79,37847,false,L-l-0 L-l-0 L-s-0 L-l-0 
job-751,3,4,6,37654,48053,48181,10399,128,37968,false,C-l-1 C-l-1 C-l-0 C-l-0 C-l-1 C-l-1 
job-750,2,12,3,37604,48053,48243,10449,190,37879,false,C-l-0 C-l-0 C-l-0 
job-752,2,12,4,37710,48243,48259,10533,16,37940,false,L-l-0 L-l-0 L-l-0 L-l-0 
job-753,6,12,2,37765,48243,48276,10478,33,38052,false,C-m-0 L-m-0 
job-755,6,11,6,37862,48243,48311,10381,68,38218,false,C-l-1 C-l-0 C-l-0 C-l-2 C-l-2 C-l-1 
job-756,1,12,6,37920,48243,48337,10323,94,38060,false,L-m-0 C-m-0 L-s-0 C-m-1 C-m-2 C-m-2 
job-754,5,11,1,37819,48243,48397,10424,154,38039,false,C-m-1 
job-757,4,11,2,37976,48243,48420,10267,177,38251,false,C-s-2 C-s-1 
job-758,4,12,7,38031,48311,48597,10280,286,38564,false,L-m-0 L-l-0 C-l-0 C-m-0 L-l-0 L-l-0 C-l-0 
job-761,1,7,7,38174,48597,48678,10423,81,38465,false,C-s-0 L-m-0 L-s-0 C-s-0 L-m-0 C-s-1 C-s-1 
job-760,3,4,6,38130,48597,48695,10467,98,38331,false,L-l-0 L-m-0 L-l-0 L-m-0 L-l-0 L-l-0 
job-762,5,6,5,38230,48597,48834,10367,237,38685,false,C-m-0 C-l-1 C-l-0 C-l-0 C-l-1 
job-759,2,6,1,38094,48597,48841,10503,244,38508,false,L-s-0 
job-765,5,4,4,38387,48834,48857,10447,23,38684,false,C-m-1 C-l-2 C-l-2 C-m-0 
job-763,4,4,3,38288,48834,48862,10546,28,38566,false,L-l-0 L-l-0 L-l-0 
job-764,6,6,5,38336,48834,48879,10498,45,38588,false,C-l-1 C-l-1 C-l-0 L-m-0 C-l-0 
job-766,4,8,2,38435,48834,49027,10399,193,38922,false,C-m-2 C-m-2 
job-767,4,10,2,38497,49027,49113,10530,86,38713,false,L-m-0 L-m-0 
job-768,2,8,5,38535,49113,49147,10578,34,38578,false,L-l-0 L-l-0 L-l-0 L-l-0 L-l-0 
job-769,5,4,5,38584,49113,49155,10529,42,38893,false,C-l-0 C-l-1 C-l-0 L-m-0 C-l-1 
job-770,4,6,1,38630,49113,49232,10483,119,38878,false,L-s-0 
job-772,4,5,8,38736,49147,49257,10411,110,38861,false,C-s-2 L-l-0 L-l-0 C-m-2 L-l-0 C-m-2 C-s-1 C-s-0 
job-773,3,8,4,38789,49155,49259,10366,104,39156,false,C-l-0 C-l-0 C-l-0 C-l-0 
job-771,6,6,4,38690,49113,49262,10423,149,39103,false,C-m-1 C-l-2 C-l-2 C-m-0 
job-774,5,7,4,38833,49257,49425,10424,168,39259,false,L-m-0 L-l-0 L-l-0 C-m-2 
job-776,5,4,8,38927,49425,49462,10498,37,39060,false,C-m-1 C-l-1 C-l-0 C-l-2 C-l-1 C-l-2 C-l-0 C-m-0 
job-775,3,5,7,38878,49425,49472,10547,47,39081,false,L-s-0 L-l-0 L-l-0 L-m-0 L-l-0 L-l-0 L-m-0 
job-777,3,5,2,38989,49462,49807,10473,345,39345,false,C-m-0 C-m-0 
job-778,3,11,5,39033,49807,49865,10774,58,39181,false,L-l-0 L-s-0 L-l-0 L-l-0 L-l-0 
job-780,5,11,6,39139,49807,49903,10668,96,39346,false,C-l-2 C-l-0 C-l-1 C-l-2 C-l-1 C-l-0 
job-779,1,5,5,39093,49807,49922,10714,115,39247,false,L-m-0 L-s-0 L-m-0 L-m-0 L-m-0 
job-781,5,9,2,39195,49903,49926,10708,23,39393,false,L-l-0 L-l-0 
job-782,3,6,4,39246,49903,50450,10657,547,40026,false,L-s-0 C-m-0 L-m-0 C-m-0 
job-783,2,5,5,39286,50450,50478,11164,28,39487,false,L-l-0 L-l-0 L-l-0 L-l-0 L-l-0 
job-784,3,4,7,39333,50450,50802,11117,352,39922,false,L-s-0 C-l-0 C-l-0 L-m-0 C-l-0 C-l-0 L-m-0 
job-785,1,9,1,39370,50802,50942,11432,140,39577,false,L-s-0 
job-786,1,4,4,39411,50942,50979,11531,37,39658,false,L-s-0 L-s-0 L-s-0 L-s-0 
job-789,6,4,2,39545,50942,51018,11397,76,39662,false,L-l-0 C-m-0 
job-790,2,8,8,39591,50942,51095,11351,153,39849,false,C-l-0 C-l-0 C-l-0 C-l-0 L-l-0 C-l-0 C-l-0 C-m-0 
job-788,1,12,4,39496,50942,51115,11446,173,39767,false,L-m-0 L-l-0 L-l-0 L-l-0 
job-787,1,5,4,39446,50942,51166,11496,224,39937,false,L-m-0 L-m-0 L-m-0 L-m-0 
job-792,3,8,8,39698,51166,51188,11468,22,39932,false,L-m-0 L-l-0 L-l-0 C-m-0 L-l-0 L-l-0 C-m-0 L-m-0 
job-791,1,11,1,39644,51166,51222,11522,56,39765,false,L-s-0 
job-793,1,7,2,39756,51188,51349,11432,161,40156,false,L-m-0 L-m-0 
job-794,6,9,1,39814,51349,51383,11535,34,40139,false,L-m-0 
job-797,2,12,3,39968,51349,51462,11381,113,40185,false,L-s-0 C-m-0 C-m-0 
job-796,2,9,5,39910,51349,51463,11439,114,40073,false,C-l-0 C-l-0 C-l-0 C-l-0 C-l-0 
job-795,2,7,7,39856,51349,51540,11493,191,40300,false,L-l-0 L-l-0 L-m-0 L-l-0 L-l-0 L-l-0 L-l-0 
job-799,3,9,7,40088,51540,51582,11452,42,40190,false,L-l-0 L-l-0 L-l-0 L-l-0 L-s-0 C-m-0 C-m-0 
job-798,2,5,5,40029,51349,51588,11320,239,40506,false,C-m-1 C-m-1 C-m-1 C-m-0 C-m-1 
job-802,6,4,3,40224,51540,51637,11316,97,40565,false,C-l-1 C-l-1 C-m-2 
job-800,3,5,5,40143,51540,51651,11397,111,40270,false,L-m-0 C-l-0 C-l-0 C-l-0 C-l-0 
job-801,1,9,5,40182,51540,51683,11358,143,40572,false,L-m-0 L-m-0 L-m-0 C-m-2 C-m-2 
job-806,5,8,6,40424,51683,51698,11259,15,40486,false,C-l-1 C-l-2 C-l-0 C-l-2 C-l-0 C-l-1 
job-804,5,10,2,40319,51683,51708,11364,25,40495,false,L-l-0 L-l-0 
job-805,2,5,4,40369,51683,51721,11314,38,40484,false,L-m-0 L-m-0 L-l-0 L-m-0 
job-803,4,9,1,40276,51683,51737,11407,54,40509,false,L-s-0 
job-808,3,4,8,40524,51698,51833,11174,135,40928,false,C-m-0 C-l-0 C-l-0 C-l-0 C-l-0 C-m-2 C-s-1 C-m-1 
job-807,5,5,3,40475,51683,51839,11208,156,40913,false,C-m-2 C-m-0 C-m-1 
job-811,5,12,3,40675,51839,51887,11164,48,40808,false,L-l-0 C-l-0 C-l-0 
job-809,3,8,3,40562,51839,51909,11277,70,40746,false,L-m-0 L-m-0 L-s-0 
job-810,6,4,1,40622,51839,51926,11217,87,40891,false,L-l-0 
job-812,1,7,4,40727,51926,51948,11199,22,40945,false,L-m-0 L-m-0 L-m-0 L-m-0 
job-813,2,11,1,40793,51926,52129,11133,203,41292,false,L-s-0 
job-814,2,7,8,40857,52129,52139,11272,10,40871,false,L-l-0 L-l-0 L-l-0 L-l-0 L-l-0 L-s-0 L-l-0 L-s-0 
job-816,4,8,7,40968,52129,52204,11161,75,41230,false,C-l-0 C-l-1 L-m-0 C-l-0 C-l-1 C-l-1 C-l-0 
job-817,5,5,7,41021,52139,52222,11118,83,41294,false,C-m-1 L-l-0 L-l-0 C-m-0 C-l-2 C-l-2 C-m-2 
job-818,4,12,6,41069,52204,52358,11135,154,41230,false,C-s-2 C-l-0 L-s-0 C-l-0 C-l-0 C-s-1 
job-820,6,9,7,41180,52358,52372,11178,14,41275,false,C-l-0 C-l-1 C-l-2 C-m-1 C-l-2 C-l-1 C-l-0 
job-819,5,11,4,41124,52358,52390,11234,32,41445,false,L-l-0 L-m-0 L-l-0 C-m-0 
job-815,1,7,3,40916,52129,52408,11213,279,41310,false,L-m-0 L-m-0 L-m-0 
job-821,2,8,5,41235,52358,52595,11123,237,41558,false,C-m-1 L-s-0 L-l-0 C-m-0 L-s-0 
job-822,6,12,8,41290,52595,52639,11305,44,41516,false,L-l-0 C-l-0 C-l-0 C-l-1 C-l-1 L-l-0 C-m-0 L-m-0 
job-823,3,6,4,41356,52595,52760,11239,165,41804,false,C-l-2 C-l-2 C-l-2 C-l-2 
job-824,6,6,4,41411,52760,52776,11349,16,41518,false,L-m-0 L-l-0 L-l-0 C-m-0 
job-826,3,8,8,41488,52760,52815,11272,55,41810,false,C-l-1 C-l-2 C-l-2 C-l-1 C-l-2 C-l-1 C-l-2 C-l-1 
job-825,4,5,5,41450,52760,52820,11310,60,41636,false,L-s-0 C-l-0 C-l-0 C-s-1 C-l-0 
job-827,5,5,6,41528,52776,52999,11248,223,41865,false,C-m-0 L-l-0 L-m-0 C-m-1 C-m-2 L-l-0 
job-828,4,11,1,41603,52815,53001,11212,186,41938,false,C-s-2 
job-829,4,11,1,41646,52999,53105,11353,106,42041,false,L-s-0 
job-831,4,10,7,41743,53105,53127,11362,22,41798,false,L-s-0 C-l-2 C-l-1 C-l-1 C-l-2 C-l-1 C-l-2 
job-832,2,9,2,41793,53105,53136,11312,31,41969,false,C-m-2 C-m-2 
job-830,4,11,8,41691,52999,53144,11308,145,41896,false,L-l-0 C-l-0 L-m-0 C-l-0 C-l-0 L-l-0 L-m-0 L-l-0 
job-833,3,6,1,41836,53136,53183,11300,47,42072,false,L-s-0 
job-835,3,11,7,41927,53136,53214,11209,78,42160,false,C-s-0 C-m-2 C-s-2 C-m-0 C-m-0 C-m-2 C-s-1 
job-834,5,4,4,41879,53136,53225,11257,89,42045,false,C-l-1 C-l-1 C-l-2 C-l-2 
job-836,6,9,3,41978,53214,53234,11236,20,42143,false,L-l-0 L-m-0 L-l-0 
job-837,6,6,2,42020,53214,53299,11194,85,42339,false,C-l-0 C-l-0 
job-838,5,11,1,42063,53214,53300,11151,86,42332,false,C-m-0 
job-840,4,12,8,42156,53299,53310,11143,11,42330,false,L-s-0 L-l-0 C-s-2 C-s-0 L-l-0 C-m-1 L-l-0 C-m-1 
job-841,2,8,2,42199,53300,53323,11101,23,42402,false,L-m-0 C-s-1 
job-839,5,9,1,42110,53299,53335,11189,36,42197,false,L-m-0 
job-842,2,5,8,42244,53300,53396,11056,96,42481,false,C-m-0 C-m-2 C-s-1 C-m-0 C-m-0 C-m-2 C-m-2 C-m-0 
job-843,6,5,7,42305,53310,53512,11005,202,42729,false,L-l-0 C-m-1 C-l-1 C-l-1 C-l-0 C-l-0 L-l-0 
job-844,1,7,5,42355,53512,53620,11157,108,42651,false,L-l-0 L-l-0 L-l-0 L-l-0 L-l-0 
job-845,2,8,7,42408,53620,53644,11212,24,42664,false,L-l-0 L-l-0 L-s-0 L-l-0 L-l-0 L-s-0 L-l-0 
job-846,1,9,3,42445,53644,53659,11199,15,42598,false,L-m-0 L-m-0 L-m-0 
job-848,6,11,7,42533,53644,53659,11111,15,42560,false,C-l-0 C-l-2 C-l-1 C-l-1 C-l-0 C-l-2 C-m-0 
job-849,3,9,4,42591,53644,53671,11053,27,42750,false,C-m-1 C-m-2 C-m-2 C-m-1 
job-847,3,12,5,42491,53644,53694,11153,50,42660,false,L-l-0 L-l-0 L-l-0 L-s-0 L-l-0 
job-851,5,8,2,42684,53659,53718,10975,59,42792,false,C-l-1 C-l-1 
job-850,3,8,8,42636,53659,53748,11023,89,42761,false,C-m-0 C-l-0 C-l-0 C-l-0 C-l-0 L-m-0 C-m-0 L-m-0 
job-852,1,4,4,42735,53748,53758,11013,10,43039,false,L-s-0 L-s-0 L-s-0 L-s-0 
job-854,4,8,3,42838,53748,53828,10910,80,43087,false,C-l-0 C-l-0 C-l-0 
job-853,5,11,3,42785,53748,53877,10963,129,42939,false,L-l-0 L-m-0 L-l-0 
job-856,5,9,7,42952,53877,53955,10925,78,43063,false,L-l-0 C-l-1 C-l-0 L-m-0 C-l-0 C-l-1 L-l-0 
job-855,2,10,1,42888,53877,53999,10989,122,43269,false,L-s-0 
job-857,4,10,7,43006,53877,54005,10871,128,43401,false,C-m-1 C-l-2 C-l-2 C-m-0 C-l-2 C-m-1 C-m-0 
job-858,2,6,1,43053,53999,54075,10946,76,43146,false,L-s-0 
job-859,4,7,8,43097,53999,54079,10902,80,43423,false,L-m-0 L-l-0 C-l-0 C-l-0 C-l-0 L-l-0 L-l-0 L-m-0 
job-861,6,11,5,43209,54075,54086,10866,11,43244,false,C-m-0 C-l-2 C-m-2 C-m-1 C-l-2 
job-860,2,11,5,43153,54075,54103,10922,28,43233,false,L-s-0 C-l-1 C-l-1 C-l-1 C-l-1 
job-862,5,6,3,43273,54079,54103,10806,24,43402,false,L-l-0 L-l-0 L-m-0 
job-863,4,9,3,43312,54079,54159,10767,80,43553,false,C-l-0 C-l-0 C-l-0 
job-864,4,10,3,43363,54159,54171,10796,12,43611,false,L-m-0 L-m-0 L-s-0 
job-865,1,4,3,43409,54159,54233,10750,74,43569,false,L-l-0 L-l-0 L-l-0 
job-866,6,4,8,43478,54159,54470,10681,311,44053,false,C-l-0 L-l-0 C-l-0 C-l-1 C-l-1 C-m-0 C-l-2 C-l-2 
job-867,6,12,2,43513,54470,54482,10957,12,43824,false,L-l-0 L-l-0 
job-869,1,7,7,43612,54470,54630,10858,160,43848,false,L-m-0 C-m-0 L-m-0 C-m-0 C-m-0 L-m-0 C-m-0 
job-871,2,7,4,43726,54630,54663,10904,33,43913,false,L-m-0 L-l-0 L-m-0 L-l-0 
job-870,4,11,1,43663,54630,54681,10967,51,43975,false,L-m-0 
job-868,2,5,2,43568,54470,54719,10902,249,44090,false,L-s-0 L-s-0 
job-872,1,9,1,43769,54681,55160,10912,479,44293,false,L-m-0 
job-873,2,5,3,43821,55160,55229,11339,69,43911,false,L-m-0 L-m-0 L-m-0 
job-874,2,4,4,43870,55160,55432,11290,272,44304,false,L-l-0 L-m-0 L-l-0 L-l-0 
job-875,2,10,7,43924,55432,55467,11508,35,43992,false,L-m-0 L-l-0 L-l-0 L-m-0 L-l-0 L-l-0 L-m-0 
job-876,6,9,2,43971,55432,55774,11461,342,44355,false,C-l-0 C-l-0 
job-877,6,11,7,44019,55774,55797,11755,23,44225,false,L-m-0 C-l-0 C-l-1 L-l-0 C-l-0 C-l-1 L-l-0 
job-878,3,4,7,44065,55774,55800,11709,26,44209,false,L-s-0 C-l-2 C-l-2 C-m-0 C-l-2 C-l-2 C-m-0 
job-879,3,6,7,44118,55774,55920,11656,146,44494,false,C-s-1 C-m-2 C-s-0 C-m-1 C-m-2 C-s-2 C-m-1 
job-880,6,9,4,44181,55920,55973,11739,53,44481,false,L-m-0 L-l-0 L-l-0 C-m-0 
job-881,2,7,5,44241,55920,56008,11679,88,44485,false,C-m-0 C-s-2 L-s-0 L-m-0 C-s-2 
job-882,5,9,8,44305,55920,56106,11615,186,44553,false,C-l-0 C-l-2 C-l-1 C-l-0 C-l-1 C-m-1 C-m-2 C-l-2 
job-884,3,12,3,44414,56106,56236,11692,130,44702,false,L-l-0 L-l-0 L-l-0 
job-883,2,8,2,44367,56106,56355,11739,249,44780,false,L-s-0 L-s-0 
job-885,3,7,3,44477,56355,56374,11878,19,44715,false,L-m-0 L-m-0 L-s-0 
job-886,6,8,8,44527,56355,56407,11828,52,44594,false,C-l-0 C-l-2 C-l-1 C-l-2 C-l-0 L-l-0 C-l-1 L-l-0 
job-887,5,6,6,44582,56407,56498,11825,91,44690,false,L-m-0 C-l-2 C-l-2 C-m-0 L-l-0 L-l-0 
job-889,6,9,8,44679,56498,56524,11819,26,44776,false,L-l-0 C-l-1 C-l-2 C-l-2 C-l-1 L-l-0 C-m-0 L-m-0 
job-890,2,8,2,44731,56524,56553,11793,29,44949,false,L-m-0 L-m-0 
job-888,2,9,1,44634,56498,56567,11864,69,44985,false,L-s-0 
job-891,6,5,4,44777,56524,56891,11747,367,45252,false,C-l-0 C-l-0 L-l-0 L-l-0 
job-893,6,9,2,44876,56891,56976,12015,85,45126,false,L-l-0 L-l-0 
job-892,3,9,2,44820,56891,56996,12071,105,45090,false,L-m-0 L-m-0 
job-894,6,11,2,44932,56976,56996,12044,20,44984,false,L-l-0 L-l-0 
job-895,4,9,4,44982,56976,57660,11994,684,45753,false,L-s-0 C-l-0 C-l-0 C-l-0 
job-897,2,11,4,45073,57660,57684,12587,24,45099,false,L-s-0 L-m-0 C-m-0 C-m-0 
job-896,3,5,6,45024,57660,57719,12636,59,45153,false,L-m-0 L-l-0 L-l-0 L-m-0 L-l-0 L-l-0 
job-898,4,8,2,45129,57719,57732,12590,13,45264,false,L-m-0 L-m-0 
job-899,5,4,3,45182,57719,57788,12537,69,45540,false,L-l-0 L-l-0 C-m-0 
job-900,4,4,2,45231,57719,57856,12488,137,45396,false,L-s-0 C-s-1 
job-903,4,11,8,45401,57856,57887,12455,31,45648,false,C-s-0 C-s-1 L-s-0 C-m-2 C-m-0 C-m-2 C-s-2 C-m-0 
job-901,5,4,1,45294,57856,57890,12562,34,45622,false,L-m-0 
job-902,2,6,6,45348,57856,57892,12508,36,45502,false,L-l-0 L-l-0 L-m-0 L-l-0 L-l-0 L-l-0 
job-904,1,12,3,45443,57887,57905,12444,18,45566,false,L-s-0 L-m-0 L-l-0 
job-905,2,5,5,45490,57887,58026,12397,139,45805,false,C-l-2 C-l-2 C-l-2 C-l-2 C-l-2 
job-906,1,12,1,45540,58026,58283,12486,257,45915,false,L-s-0 
job-907,2,12,6,45586,58283,58302,12697,19,45607,false,L-m-0 L-l-0 L-l-0 L-l-0 L-m-0 L-l-0 
job-908,1,7,4,45634,58283,58385,12649,102,45886,false,L-s-0 C-s-1 C-s-1 L-m-0 
job-909,5,5,6,45684,58283,58505,12599,222,45926,false,C-l-2 C-l-1 C-l-0 C-l-0 C-l-1 C-l-2 
job-911,3,9,8,45798,58505,58518,12707,13,45874,false,C-l-0 C-l-1 C-l-0 C-l-1 C-l-1 C-l-0 C-l-0 C-l-1 
job-910,6,9,3,45740,58505,58592,12765,87,46055,false,L-l-0 L-l-0 L-m-0 
job-912,1,7,3,45839,58592,58639,12753,47,46058,false,L-m-0 L-m-0 L-m-0 
job-914,5,8,5,45936,58592,58641,12656,49,46253,false,C-m-0 C-l-1 L-l-0 L-l-0 C-l-1 
job-913,4,10,2,45878,58592,58667,12714,75,46116,false,L-s-0 L-m-0 
job-915,3,6,7,45994,58592,58689,12598,97,46160,false,C-m-1 C-l-2 C-l-2 C-m-0 C-l-2 C-l-2 C-m-1 
job-916,6,10,2,46054,58667,58689,12613,22,46200,false,L-l-0 L-l-0 
job-917,6,8,4,46108,58667,58758,12559,91,46491,false,L-m-0 C-l-0 C-l-0 C-m-2 
job-918,3,4,1,46146,58758,58796,12612,38,46375,false,L-s-0 
job-919,1,4,2,46186,58758,58881,12572,123,46311,false,L-s-0 L-m-0 
job-920,6,10,7,46238,58758,58906,12520,148,46459,false,L-l-0 C-l-0 L-m-0 C-l-1 C-l-0 C-l-1 L-l-0 
job-921,4,9,1,46296,58906,58926,12610,20,46361,false,L-s-0 
job-924,3,8,2,46434,58906,58962,12472,56,46627,false,C-s-0 C-s-2 
job-923,4,4,8,46388,58906,58973,12518,67,46608,false,L-l-0 C-l-1 C-l-1 L-l-0 C-l-1 C-m-0 L-l-0 C-m-0 
job-922,6,12,1,46344,58906,59068,12562,162,46646,false,L-m-0 
job-925,1,8,3,46476,59068,59102,12592,34,46728,false,L-m-0 L-m-0 L-m-0 
job-926,3,4,3,46530,59068,59192,12538,124,46900,false,L-l-0 L-m-0 L-l-0 
job-927,3,9,4,46575,59192,59215,12617,23,46877,false,L-l-0 L-l-0 L-l-0 L-l-0 
job-929,4,8,6,46658,59192,59259,12534,67,46785,false,L-s-0 C-l-1 C-l-1 C-m-1 C-l-1 C-m-1 
job-930,2,7,3,46713,59192,59297,12479,105,47029,false,L-m-0 C-m-0 C-s-2 
job-928,6,5,2,46618,59192,59321,12574,129,46786,false,C-m-0 L-m-0 
job-931,6,5,2,46749,59192,59477,12443,285,47055,false,C-l-0 C-l-0 
job-932,1,5,7,46794,59477,59526,12683,49,46845,false,L-l-0 L-l-0 L-l-0 L-l-0 L-l-0 L-l-0 L-l-0 
job-933,1,12,3,46852,59526,59548,12674,22,46987,false,L-l-0 L-l-0 L-l-0 
job-936,5,11,6,47010,59526,59560,12516,34,47163,false,C-m-1 C-l-2 C-l-2 C-m-2 C-l-0 C-l-0 
job-935,5,9,3,46954,59526,59584,12572,58,47044,false,C-l-1 C-m-0 C-l-1 
job-934,4,4,6,46904,59526,59625,12622,99,47060,false,L-m-0 L-s-0 L-l-0 L-m-0 L-l-0 C-s-1 
job-937,1,7,3,47050,59625,59656,12575,31,47339,false,L-m-0 L-m-0 L-m-0 
job-938,3,7,1,47100,59656,59861,12556,205,47469,false,L-s-0 
job-939,4,8,1,47155,59861,59886,12706,25,47234,false,L-s-0 
job-940,1,8,4,47199,59861,59923,12662,62,47462,false,L-m-0 L-m-0 L-m-0 L-m-0 
job-941,6,9,3,47256,59861,60370,12605,509,47808,false,L-l-0 L-l-0 C-m-0 
job-942,3,11,1,47307,60370,60403,13063,33,47425,false,L-s-0 
job-944,6,12,7,47412,60370,60410,12958,40,47748,false,C-m-0 C-l-0 C-l-0 C-l-1 C-l-1 C-l-2 C-l-2 
job-943,4,8,5,47361,60370,60451,13009,81,47553,false,L-l-0 L-l-0 L-m-0 L-m-0 L-l-0 
job-946,3,7,4,47514,60410,60471,12896,61,47835,false,L-s-0 C-l-0 C-l-0 C-l-0 
job-947,4,12,3,47553,60410,60507,12857,97,47771,false,C-l-1 C-l-1 C-l-1 
job-948,3,8,5,47603,60507,60525,12904,18,47726,false,L-l-0 L-s-0 L-l-0 L-l-0 L-l-0 
job-949,3,5,2,47663,60507,60551,12844,44,47842,false,L-m-0 L-m-0 
job-945,1,4,1,47465,60410,60573,12945,163,47668,false,L-s-0 
job-950,5,10,3,47698,60507,60601,12809,94,47810,false,C-l-1 C-m-0 C-l-1 
job-951,3,8,2,47741,60507,60762,12766,255,48029,false,C-s-1 C-m-0 
job-952,1,11,6,47818,60762,60809,12944,47,47999,false,L-m-0 L-l-0 L-l-0 L-m-0 L-l-0 L-l-0 
job-953,5,7,1,47876,60809,60875,12933,66,47992,false,L-m-0 
job-955,1,7,7,47969,60875,60907,12906,32,48181,false,L-l-0 L-l-0 L-l-0 L-l-0 L-l-0 L-l-0 L-m-0 
job-956,1,6,8,48014,60875,60980,12861,105,48246,false,L-s-0 L-m-0 L-m-0 C-s-1 L-l-0 L-m-0 C-s-1 L-m-0 
job-954,3,10,1,47917,60875,61030,12958,155,48270,false,L-s-0 
job-957,1,10,2,48050,60875,61068,12825,193,48479,false,C-m-0 C-m-0 
job-958,4,8,5,48092,61068,61093,12976,25,48335,false,L-m-0 L-l-0 L-l-0 L-l-0 L-m-0 
job-960,2,6,5,48188,61068,61191,12880,123,48577,false,C-s-2 C-m-0 C-m-0 C-s-2 C-m-0 
job-961,4,7,5,48235,61068,61205,12833,137,48620,false,C-m-1 C-l-0 C-l-0 C-m-1 C-l-0 
job-962,3,12,5,48289,61205,61231,12916,26,48517,false,L-m-0 L-l-0 L-l-0 L-m-0 L-l-0 
job-959,4,7,5,48137,61068,61233,12931,165,48481,false,C-s-1 C-l-1 C-l-1 L-s-0 C-l-1 
job-963,6,4,5,48347,61205,61233,12858,28,48531,false,C-l-0 C-l-2 C-l-2 C-m-0 C-l-0 
job-964,2,6,8,48399,61205,61447,12806,242,48891,false,L-m-0 C-m-0 L-l-0 C-m-2 C-m-2 C-m-2 C-s-2 C-m-2 
job-965,6,6,8,48450,61447,61488,12997,41,48587,false,L-l-0 C-l-0 C-l-0 C-l-1 C-l-1 L-l-0 C-m-0 L-m-0 
job-968,5,8,8,48588,61488,61502,12900,14,48630,false,C-l-0 C-l-0 C-l-2 C-l-1 C-l-1 L-m-0 C-l-2 C-m-0 
job-969,6,7,2,48631,61488,61513,12857,25,48662,false,C-m-2 C-m-1 
job-967,6,5,2,48538,61488,61599,12950,111,48716,false,L-l-0 L-l-0 
job-966,2,11,1,48500,61488,61637,12988,149,48804,false,L-s-0 
job-972,3,6,6,48804,61599,61640,12795,41,48852,false,L-l-0 C-l-0 C-l-0 C-l-0 C-l-0 L-l-0 
job-971,5,11,1,48744,61599,61646,12855,47,48996,false,L-l-0 
job-970,3,11,2,48684,61599,61649,12915,50,48751,false,L-m-0 L-m-0 
job-973,2,11,4,48860,61599,61676,12739,77,49058,false,C-l-1 C-l-1 C-l-1 C-l-1 
job-974,4,5,7,48906,61599,61756,12693,157,49220,false,C-m-1 C-l-2 C-l-2 C-m-0 C-l-2 C-m-1 C-m-0 
job-975,2,12,2,48962,61756,61814,12794,58,49106,false,L-m-0 L-m-0 
job-976,6,5,4,49001,61756,61826,12755,70,49085,false,L-l-0 C-l-0 L-l-0 C-l-0 
job-977,2,9,5,49056,61814,61826,12758,12,49176,false,L-s-0 L-m-0 C-s-1 L-m-0 L-m-0 
job-978,2,12,4,49098,61814,61940,12716,126,49270,false,C-l-1 C-l-1 C-l-1 C-l-1 
job-980,2,10,3,49193,61940,61966,12747,26,49299,false,L-s-0 C-s-1 L-m-0 
job-979,6,6,3,49150,61940,61972,12790,32,49265,false,L-l-0 L-l-0 L-m-0 
job-981,6,12,7,49243,61940,62043,12697,103,49386,false,C-l-2 C-l-2 C-l-1 C-m-0 C-l-1 C-l-0 C-l-0 
job-982,6,11,7,49279,62043,62060,12764,17,49523,false,L-m-0 C-l-0 C-l-1 L-l-0 C-l-0 C-l-1 L-l-0 
job-986,2,4,8,49489,62060,62115,12571,55,49674,false,C-l-0 C-l-0 C-l-0 L-l-0 C-l-0 C-l-0 C-s-1 C-l-0 
job-983,4,11,6,49327,62043,62125,12716,82,49656,false,L-s-0 C-l-2 C-m-2 C-m-2 C-l-2 C-l-2 
job-985,3,5,5,49440,62060,62169,12620,109,49630,false,L-l-0 L-l-0 L-l-0 L-m-0 L-m-0 
job-984,1,10,1,49383,62060,62181,12677,121,49678,false,L-m-0 
job-987,4,6,6,49537,62060,62195,12523,135,49886,false,C-m-0 C-l-1 C-l-1 C-m-0 C-l-1 C-s-2 
job-988,3,12,1,49586,62181,62218,12595,37,49851,false,L-s-0 
job-989,3,8,2,49641,62181,62323,12540,142,50000,false,L-m-0 L-m-0 
job-990,2,7,2,49690,62323,62354,12633,31,49770,false,L-s-0 L-s-0 
job-991,6,11,8,49744,62323,62375,12579,52,49884,false,C-l-0 L-l-0 C-l-2 C-l-2 C-l-0 L-m-0 L-l-0 C-m-0 
job-992,2,10,6,49797,62354,62376,12557,22,49847,false,C-m-0 C-m-1 L-s-0 C-m-1 C-m-1 L-m-0 
job-994,1,11,5,49897,62354,62547,12457,193,50202,false,C-l-1 C-l-1 C-l-1 C-m-2 C-l-1 
job-993,5,12,1,49840,62354,62696,12514,342,50289,false,C-m-2 
job-995,4,12,7,49947,62696,62762,12749,66,50174,false,L-l-0 L-m-0 L-s-0 L-l-0 L-m-0 L-l-0 C-s-1 
job-996,3,7,2,49997,62696,62917,12699,221,50282,false,C-m-0 C-m-0 
job-998,3,9,8,50096,62917,62955,12821,38,50178,false,C-s-0 L-l-0 C-s-1 L-l-0 L-l-0 L-l-0 L-s-0 L-m-0 
job-997,5,5,1,50043,62917,62971,12874,54,50326,false,L-m-0 
job-999,1,7,5,50146,62917,62981,12771,64,50358,false,C-s-0 C-s-1 C-s-2 L-s-0 C-s-2 
job-1000,5,8,3,50203,62917,63087,12714,170,50380,false,C-m-0 C-l-1 C-l-1 
job-1001,4,6,5,50256,63087,63133,12831,46,50571,false,L-m-0 L-l-0 L-l-0 L-l-0 L-m-0 
job-1002,5,5,4,50300,63087,63216,12787,129,50497,false,C-l-0 C-l-1 C-l-1 C-l-0 
job-1003,4,7,4,50352,63216,63249,12864,33,50531,false,L-l-0 L-l-0 L-s-0 L-l-0 
job-1004,2,10,7,50407,63216,63335,12809,119,50741,false,L-m-0 C-l-0 C-l-0 L-m-0 C-l-0 C-l-0 L-m-0 
job-1005,2,11,3,50464,63335,63379,12871,44,50550,false,L-m-0 L-m-0 L-s-0 
job-1007,6,6,5,50567,63335,63458,12768,123,50848,false,C-l-2 C-l-1 C-l-2 C-m-2 C-l-1 
job-1006,4,8,7,50514,63335,63460,12821,125,50910,false,L-m-0 C-l-0 L-l-0 L-l-0 C-l-0 L-l-0 C-l-0 
job-1008,6,12,3,50613,63458,63504,12845,46,50794,false,C-l-1 C-l-1 C-m-0 
job-1009,1,12,1,50665,63504,63528,12839,24,50699,false,L-s-0 
job-1011,5,5,6,50769,63504,63592,12735,88,50885,false,C-l-2 C-l-1 C-l-0 C-l-2 C-l-1 C-l-0 
job-1012,4,4,6,50820,63592,63610,12772,18,51020,false,C-s-1 C-l-1 L-m-0 C-l-1 C-l-1 L-s-0 
job-1014,3,5,4,50924,63592,63643,12668,51,51165,false,C-l-2 C-l-2 C-l-2 C-l-2 
job-1010,4,11,4,50714,63504,63649,12790,145,50966,false,L-m-0 L-l-0 L-l-0 L-l-0 
job-1013,1,11,4,50872,63592,63657,12720,65,51141,false,C-l-0 C-l-0 C-l-0 C-l-0 
job-1015,3,5,2,50978,63592,63781,12614,189,51259,false,C-m-0 C-m-0 
job-1016,3,7,3,51023,63592,63906,12569,314,51426,false,C-s-2 C-m-2 C-m-2 
job-1018,2,8,7,51119,63906,63922,12787,16,51407,false,C-m-0 L-m-0 L-m-0 C-m-0 C-m-0 L-m-0 C-m-0 
job-1017,4,5,4,51073,63906,63925,12833,19,51323,false,L-l-0 L-l-0 L-s-0 L-l-0 
job-1020,4,5,4,51218,63906,63993,12688,87,51437,false,C-l-1 C-l-1 C-l-1 C-s-1 
job-1019,4,5,2,51168,63906,64006,12738,100,51286,false,C-m-1 C-m-1 
job-1022,4,11,5,51316,63922,64055,12606,133,51543,false,C-s-2 L-m-0 L-m-0 C-m-0 C-m-0 
job-1021,5,9,4,51263,63906,64069,12643,163,51523,false,C-l-2 C-l-2 C-l-0 C-l-0 
job-1023,2,11,3,51361,64055,64082,12694,27,51612,false,L-s-0 C-l-0 C-l-2 
job-1024,2,5,2,51420,64055,64145,12635,90,51630,false,L-s-0 L-m-0 
job-1026,6,4,6,51530,64145,64167,12615,22,51704,false,C-m-0 C-l-1 C-l-1 L-m-0 C-l-0 C-l-0 
job-1025,2,11,5,51475,64145,64171,12670,26,51626,false,L-s-0 L-l-0 L-l-0 L-l-0 L-l-0 
job-1027,5,9,2,51575,64145,64174,12570,29,51613,false,C-l-2 C-l-2 
job-1028,5,6,6,51619,64167,64234,12548,67,51779,false,L-m-0 C-l-1 C-l-0 C-m-0 C-l-1 C-l-0 
job-1029,4,9,1,51678,64167,64338,12489,171,52077,false,C-s-1 
job-1030,2,8,4,51733,64338,64356,12605,18,52026,false,L-m-0 L-m-0 L-m-0 L-m-0 
job-1032,2,4,8,51823,64338,64447,12515,109,52161,false,L-s-0 C-l-0 C-l-0 C-l-0 C-l-0 C-l-0 C-l-0 L-s-0 
job-1033,4,11,4,51876,64338,64474,12462,136,52222,false,C-m-1 C-m-1 C-m-0 C-m-0 
job-1031,6,5,2,51779,64338,64535,12559,197,52096,false,L-l-0 L-l-0 
job-1034,6,5,2,51924,64535,64547,12611,12,51998,false,L-l-0 L-l-0 
job-1035,6,7,5,51976,64535,64553,12559,18,52048,false,L-m-0 C-l-0 C-l-0 C-l-1 C-l-1 
job-1036,5,12,6,52022,64547,64649,12525,102,52366,false,C-m-1 L-l-0 C-l-2 C-m-0 C-l-2 L-l-0 
job-1037,5,6,8,52067,64649,64940,12582,291,52406,false,L-l-0 C-l-0 C-l-1 C-l-1 C-l-0 L-l-0 C-m-0 L-m-0 
job-1038,1,12,3,52116,64940,64997,12824,57,52276,false,L-l-0 L-l-0 L-l-0 
job-1039,2,9,1,52160,64997,65471,12837,474,52748,false,L-s-0 
job-1040,1,11,4,52217,65471,65505,13254,34,52254,false,L-l-0 L-l-0 L-l-0 L-l-0 
job-1041,6,5,4,52247,65471,65592,13224,121,52439,false,L-m-0 C-l-0 C-l-0 C-m-0 
job-1042,2,6,1,52287,65592,65642,13305,50,52603,false,L-s-0 
job-1044,2,9,7,52390,65592,65652,13202,60,52604,false,L-m-0 L-s-0 L-m-0 C-m-0 C-m-0 L-m-0 C-m-0 
job-1043,4,5,3,52333,65592,65709,13259,117,52629,false,L-l-0 L-l-0 L-l-0 
job-1045,1,10,5,52425,65592,66157,13167,565,53209,false,C-s-1 C-l-0 C-l-0 C-l-0 C-l-0 
job-1046,3,5,2,52472,66157,66317,13685,160,52764,false,L-m-0 L-m-0 
job-1047,3,12,2,52513,66157,66332,13644,175,52711,false,L-l-0 L-l-0 
job-1048,5,9,2,52554,66157,66361,13603,204,52844,false,C-m-0 L-l-0 
job-1049,5,10,2,52597,66317,66374,13720,57,52678,false,C-m-1 L-m-0 
job-1050,1,6,8,52646,66361,66479,13715,118,53009,false,L-m-0 L-s-0 L-s-0 C-m-1 C-m-1 L-m-0 L-m-0 C-m-1 
job-1051,4,7,6,52695,66479,66503,13784,24,52796,false,L-m-0 L-s-0 L-l-0 L-l-0 L-m-0 L-l-0 
job-1052,6,11,8,52738,66479,66542,13741,63,53098,false,C-l-0 C-l-1 C-l-1 C-l-2 C-l-0 C-m-1 C-l-2 C-m-0 
job-1053,4,12,8,52781,66503,66698,13722,195,53015,false,L-s-0 L-l-0 C-s-1 L-l-0 L-l-0 L-m-0 C-s-2 L-m-0 
job-1054,5,7,8,52829,66542,66831,13713,289,53152,false,C-m-1 C-l-1 C-l-0 C-l-2 C-l-1 C-l-2 C-l-0 C-m-0 
job-1057,5,10,8,52971,66831,66850,13860,19,53227,false,C-m-1 C-l-2 C-l-1 C-l-2 C-l-1 C-l-0 C-l-0 C-m-0 
job-1056,1,7,5,52925,66831,66889,13906,58,53266,false,L-s-0 C-s-1 L-m-0 L-m-0 C-s-1 
job-1055,3,7,6,52883,66831,66926,13948,95,52989,false,L-m-0 L-l-0 L-l-0 L-l-0 L-m-0 L-l-0 
job-1058,1,10,1,53017,66850,67242,13833,392,53531,false,C-s-2 
job-1059,2,8,4,53065,67242,67338,14177,96,53337,false,L-m-0 L-m-0 L-m-0 L-m-0 
job-1060,6,4,2,53103,67242,67886,14139,644,53759,false,L-l-0 L-l-0 
job-1061,5,12,4,53154,67886,67899,14732,13,53241,false,L-m-0 L-l-0 L-l-0 C-m-0 
job-1062,4,11,2,53194,67886,67909,14692,23,53509,false,L-s-0 C-s-2 
job-1063,2,10,8,53251,67886,67934,14635,48,53325,false,C-s-1 C-l-0 C-l-0 C-l-0 C-l-0 L-l-0 L-m-0 C-m-0 
job-1064,6,10,4,53288,67934,67946,14646,12,53593,false,L-m-0 L-l-0 L-l-0 C-m-0 
job-1065,5,4,6,53336,67934,67946,14598,12,53397,false,C-l-0 C-l-1 C-l-1 C-l-2 C-l-0 C-l-2 
job-1066,2,10,6,53398,67934,67978,14536,44,53652,false,L-m-0 L-s-0 C-l-0 C-m-0 C-l-2 C-l-1 
job-1067,5,11,7,53435,67978,68079,14543,101,53708,false,C-l-1 L-l-0 C-l-0 C-l-1 C-l-0 L-l-0 L-m-0 
job-1068,1,11,2,53471,68079,68107,14608,28,53526,false,L-m-0 L-m-0 
job-1069,2,5,2,53510,68107,68623,14597,516,54268,false,L-s-0 L-s-0 
job-1070,4,7,5,53563,68623,68634,15060,11,53804,false,L-m-0 L-l-0 L-l-0 L-l-0 L-m-0 
job-1071,3,6,5,53612,68623,68710,15011,87,53935,false,L-s-0 C-l-0 C-l-0 C-l-0 C-l-0 
job-1072,6,8,4,53672,68710,68720,15038,10,53939,false,L-m-0 L-l-0 L-l-0 C-m-0 
job-1074,1,4,8,53800,68720,68792,14920,72,54080,false,L-m-0 L-l-0 L-l-0 L-l-0 L-l-0 L-l-0 L-m-0 L-m-0 
job-1073,2,10,2,53743,68720,68811,14977,91,54008,false,L-m-0 L-m-0 
job-1075,2,4,1,53839,68811,68960,14972,149,54144,false,L-s-0 
job-1076,5,11,1,53900,68960,68973,15060,13,54146,false,L-m-0 
job-1078,5,6,3,54005,68960,69025,14955,65,54279,false,C-l-0 L-l-0 C-l-0 
job-1077,5,6,1,53950,68960,69047,15010,87,54257,false,L-l-0 
job-1081,2,10,4,54176,69047,69062,14871,15,54198,false,L-m-0 L-m-0 C-s-1 L-m-0 
job-1079,1,6,7,54064,69047,69074,14983,27,54187,false,L-l-0 L-l-0 L-l-0 L-l-0 L-l-0 L-l-0 L-l-0 
job-1080,1,4,3,54115,69047,69077,14932,30,54251,false,L-s-0 L-l-0 L-s-0 
job-1083,3,6,6,54272,69077,69139,14805,62,54532,false,L-m-0 L-s-0 L-m-0 L-l-0 L-l-0 L-l-0 
job-1082,1,7,1,54238,69077,69247,14839,170,54424,false,L-s-0 
job-1085,6,9,7,54365,69247,69283,14882,36,54445,false,L-l-0 C-l-1 C-l-2 L-l-0 C-l-1 C-l-2 L-m-0 
job-1084,6,10,2,54316,69077,69358,14761,281,54679,false,C-l-0 C-l-0 
job-1086,6,4,6,54412,69283,69703,14871,420,55028,false,C-m-0 L-l-0 C-l-1 L-m-0 C-l-1 L-l-0 
job-1087,2,12,4,54465,69703,69856,15238,153,54838,false,L-l-0 L-l-0 L-l-0 L-l-0 
job-1088,1,11,8,54509,69856,69872,15347,16,54697,false,L-s-0 L-l-0 L-l-0 L-l-0 L-l-0 L-m-0 C-s-1 L-m-0 
job-1089,5,9,8,54571,69856,70055,15285,199,54989,false,C-l-0 C-l-2 C-l-1 C-l-0 C-l-1 C-l-2 C-m-0 L-m-0 
job-1090,2,7,5,54620,70055,70210,15435,155,54886,false,L-l-0 L-l-0 L-l-0 L-l-0 L-l-0 
job-1092,5,9,4,54707,70055,70315,15348,260,55157,false,C-l-2 C-l-0 C-l-0 C-l-2 
job-1091,4,4,7,54661,70055,70324,15394,269,55007,false,L-m-0 C-l-1 C-l-1 L-s-0 C-l-1 C-s-1 L-m-0 
job-1093,3,4,6,54758,70315,70368,15557,53,54925,false,C-m-0 L-l-0 L-l-0 C-m-0 L-l-0 L-l-0 
job-1094,5,11,6,54814,70315,70413,15501,98,54916,false,C-m-2 C-l-2 C-l-0 C-m-1 C-l-0 C-l-2 
job-1096,1,10,8,54923,70413,70496,15490,83,55246,false,C-m-0 C-m-1 L-m-0 C-m-1 C-m-0 C-m-1 C-m-0 L-m-0 
job-1095,6,10,7,54867,70413,70498,15546,85,55062,false,L-m-0 C-l-0 C-l-1 L-l-0 C-l-0 C-l-1 L-l-0 
job-1098,6,7,5,55024,70496,70570,15472,74,55111,false,C-m-0 C-l-2 C-l-2 C-m-1 C-m-2 
job-1097,2,8,3,54976,70496,70570,15520,74,55305,false,L-s-0 L-s-0 L-m-0 
job-1099,2,7,3,55066,70570,70603,15504,33,55167,false,L-m-0 L-m-0 L-m-0 
job-1100,1,7,5,55123,70570,70625,15447,55,55244,false,L-l-0 L-l-0 L-m-0 L-l-0 L-l-0 
job-1101,6,9,5,55185,70570,70673,15385,103,55514,false,L-l-0 C-l-0 C-l-1 C-l-1 C-l-0 
job-1103,1,9,4,55286,70570,70689,15284,119,55565,false,C-m-0 C-m-0 L-l-0 C-m-0 
job-1104,4,4,6,55339,70570,70706,15231,136,55744,false,L-s-0 C-m-1 C-m-0 C-m-1 C-m-2 C-m-2 
job-1105,6,12,7,55389,70689,70714,15300,25,55634,false,L-l-0 C-l-1 C-l-0 L-m-0 C-l-0 C-l-1 L-l-0 
job-1102,3,8,4,55235,70570,70733,15335,163,55666,false,C-l-2 C-l-2 C-l-2 C-l-2 
job-1106,6,8,4,55429,70714,71014,15285,300,55877,false,L-m-0 L-l-0 L-l-0 C-m-0 
job-1107,2,4,3,55491,71014,71050,15523,36,55599,false,L-m-0 L-m-0 L-m-0 
job-1108,6,9,5,55546,71014,71138,15468,124,55676,false,L-l-0 L-l-0 C-l-0 C-m-0 C-l-0 
job-1109,4,7,7,55595,71138,71165,15543,27,55702,false,L-l-0 L-m-0 L-s-0 L-l-0 L-m-0 L-l-0 C-s-1 
job-1111,3,11,4,55709,71138,71215,15429,77,55858,false,C-l-0 C-l-0 C-l-0 C-l-0 
job-1112,6,10,7,55758,71138,71257,15380,119,56173,false,C-m-2 C-l-1 C-l-2 C-m-1 C-l-2 C-l-1 C-m-0 
job-1110,1,4,6,55653,71138,71271,15485,133,55806,false,C-s-2 C-s-0 C-s-0 C-s-2 C-s-0 C-s-2 
job-1113,1,8,5,55806,71257,71347,15451,90,56004,false,L-l-0 L-l-0 L-l-0 L-l-0 L-l-0 
job-1115,6,12,4,55891,71257,71418,15366,161,56206,false,C-l-0 C-l-2 C-l-0 C-l-2 
job-1114,3,8,7,55852,71257,71539,15405,282,56224,false,L-m-0 C-l-1 C-l-1 C-l-1 C-l-1 L-l-0 L-m-0 
job-1116,6,9,1,55930,71539,71598,15609,59,56042,false,L-m-0 
job-1117,4,9,3,55970,71539,71620,15569,81,56130,false,L-l-0 L-l-0 L-l-0 
job-1118,4,10,3,56021,71539,71630,15518,91,56177,false,L-s-0 C-m-0 C-m-0 
job-1119,4,11,1,56059,71620,71640,15561,20,56102,false,L-m-0 
job-1120,1,10,4,56099,71620,71753,15521,133,56304,false,L-m-0 L-l-0 L-l-0 L-m-0 
job-1121,6,9,3,56150,71620,71852,15470,232,56514,false,C-l-0 L-l-0 C-l-0 
job-1122,3,6,8,56201,71852,71877,15651,25,56505,false,C-s-1 L-l-0 L-s-0 L-l-0 L-l-0 L-l-0 L-m-0 L-m-0 
job-1123,1,7,8,56256,71852,71882,15596,30,56558,false,C-s-1 L-m-0 C-m-0 L-m-0 C-m-0 C-m-0 L-s-0 C-m-0 
job-1125,4,4,3,56355,71852,71946,15497,94,56510,false,C-m-1 C-m-0 C-m-1 
job-1124,5,4,4,56300,71852,71967,15552,115,56582,false,C-l-0 C-l-1 C-l-1 C-l-0 
job-1129,6,5,1,56529,71946,71992,15417,46,56775,false,C-m-0 
job-1128,4,5,2,56488,71946,72004,15458,58,56671,false,C-m-1 C-m-1 
job-1126,6,5,2,56403,71946,72008,15543,62,56711,false,L-l-0 L-l-0 
job-1131,5,8,5,56640,71967,72011,15327,44,56807,false,C-l-0 C-l-1 C-l-0 C-m-2 C-l-1 
job-1127,3,4,3,56447,71946,72018,15499,72,56685,false,L-s-0 L-m-0 L-m-0 
job-1130,2,7,3,56573,71967,72038,15394,71,56878,false,C-s-1 L-m-0 C-m-0 
job-1132,6,4,6,56677,72008,72061,15331,53,56859,false,C-m-1 C-l-2 L-l-0 C-m-0 C-l-2 L-l-0 
job-1133,6,6,5,56732,72011,72074,15279,63,56843,false,C-l-0 C-l-1 C-l-0 C-m-2 C-l-1 
job-1135,5,4,1,56820,72061,72124,15241,63,57102,false,L-l-0 
job-1134,5,8,1,56775,72038,72127,15263,89,57088,false,L-m-0 
job-1137,5,6,8,56937,72074,72208,15137,134,57091,false,C-m-2 C-l-1 C-l-0 C-l-2 C-l-1 C-l-2 C-l-0 C-m-1 
job-1136,5,4,2,56871,72061,72387,15190,326,57345,false,C-m-0 L-l-0 
job-1139,6,11,7,57048,72387,72478,15339,91,57422,false,C-l-1 C-l-1 C-l-0 L-m-0 C-l-0 L-l-0 C-m-0 
job-1140,4,8,7,57100,72387,72494,15287,107,57349,false,C-m-1 C-l-2 C-l-2 C-m-1 C-l-2 C-s-1 L-s-0 
job-1138,1,6,6,56995,72387,72495,15392,108,57110,false,L-l-0 L-l-0 L-l-0 L-l-0 L-l-0 L-l-0 
job-1141,2,11,8,57143,72478,72513,15335,35,57380,false,C-s-2 L-l-0 C-l-0 C-l-0 C-l-0 L-m-0 L-m-0 C-l-0 
job-1142,3,7,1,57191,72513,72529,15322,16,57493,false,L-s-0 
job-1144,4,10,4,57274,72513,72687,15239,174,57672,false,L-l-0 L-l-0 L-l-0 L-m-0 
job-1143,3,6,1,57232,72513,72808,15281,295,57726,false,L-m-0 
job-1145,1,4,7,57321,72808,72859,15487,51,57648,false,L-m-0 L-m-0 L-m-0 L-m-0 L-m-0 L-m-0 L-m-0 
job-1148,3,12,3,57468,72808,73046,15340,238,57812,false,C-m-0 C-m-0 C-s-1 
job-1147,2,12,1,57426,72808,73086,15382,278,57984,false,L-s-0 
job-1146,6,11,8,57376,72808,73091,15432,283,57714,false,L-l-0 C-l-0 C-l-0 C-l-2 C-l-1 C-l-1 C-l-2 L-l-0 
job-1149,6,6,7,57509,73091,73114,15582,23,57665,false,L-m-0 C-l-0 C-l-1 L-l-0 C-l-0 C-l-1 L-l-0 
job-1150,2,12,1,57546,73114,73154,15568,40,57854,false,L-s-0 
job-1151,3,11,3,57606,73114,73203,15508,89,57729,false,L-l-0 L-l-0 L-l-0 
job-1152,1,7,3,57650,73203,73214,15553,11,57883,false,L-m-0 L-m-0 L-m-0 
job-1153,3,8,2,57700,73203,73405,15503,202,57973,false,L-s-0 L-m-0 
job-1154,1,9,2,57742,73405,73428,15663,23,57834,false,L-m-0 L-m-0 
job-1156,5,12,6,57845,73428,73470,15583,42,57905,false,C-l-1 L-l-0 C-l-0 C-l-1 C-l-0 L-l-0 
job-1155,3,6,2,57798,73428,73634,15630,206,58006,false,L-m-0 L-m-0 
job-1157,6,6,6,57882,73470,73675,15588,205,58161,false,C-l-0 C-l-1 C-l-1 L-l-0 C-l-0 L-l-0 
job-1158,3,7,3,57922,73675,73689,15753,14,57947,false,L-m-0 L-m-0 L-s-0 
job-1159,3,9,7,57971,73675,73745,15704,70,58264,false,L-l-0 L-l-0 L-l-0 C-l-0 C-l-0 C-l-0 C-l-0 
job-1160,2,8,4,58015,73675,73869,15660,194,58342,false,L-m-0 L-l-0 C-s-1 C-s-1 
job-1161,6,6,2,58076,73869,73882,15793,13,58180,false,L-l-0 L-l-0 
job-1163,3,11,8,58175,73869,73893,15694,24,58424,false,L-s-0 C-l-2 C-l-2 C-s-0 C-l-2 C-l-2 C-s-1 L-m-0 
job-1162,5,4,5,58122,73869,73905,15747,36,58171,false,C-l-0 C-l-1 C-l-0 L-m-0 C-l-1 
job-1164,5,6,5,58237,73882,73935,15645,53,58463,false,C-m-1 L-l-0 C-m-2 C-m-0 L-l-0 
job-1165,1,5,8,58279,73935,74005,15656,70,58550,false,L-s-0 L-m-0 L-s-0 L-s-0 L-m-0 L-m-0 L-m-0 L-m-0 
job-1166,4,12,2,58344,74005,74038,15661,33,58555,false,L-m-0 L-m-0 
job-1167,1,10,5,58403,74005,74095,15602,90,58773,false,L-l-0 L-l-0 L-l-0 L-s-0 L-l-0 
job-1168,1,12,3,58459,74095,74115,15636,20,58596,false,L-l-0 L-l-0 L-l-0 
job-1169,6,7,6,58511,74095,74170,15584,75,58721,false,C-l-0 C-l-1 C-l-1 L-m-0 C-l-0 L-l-0 
job-1170,1,9,3,58562,74170,74225,15608,55,58789,false,L-m-0 L-m-0 L-m-0 
job-1171,1,9,5,58615,74170,74277,15555,107,58990,false,L-l-0 L-l-0 L-l-0 L-l-0 L-l-0 
job-1173,3,7,6,58723,74170,74299,15447,129,59122,false,C-s-2 C-l-1 C-l-1 C-s-0 C-l-1 C-l-1 
job-1174,6,8,4,58779,74225,74303,15446,78,58919,false,C-m-1 C-l-2 C-l-2 C-m-0 
job-1175,2,5,5,58840,74303,74337,15463,34,58938,false,L-m-0 L-l-0 L-l-0 L-m-0 L-l-0 
job-1172,3,5,6,58667,74170,74340,15503,170,58989,false,L-s-0 L-m-0 C-l-0 C-l-0 C-l-0 C-l-0 
job-1176,5,5,4,58900,74303,74437,15403,134,59185,false,C-l-1 L-l-0 C-l-1 C-m-0 
job-1177,2,9,8,58948,74437,74515,15489,78,59296,false,L-l-0 L-l-0 L-l-0 L-l-0 L-l-0 L-m-0 L-m-0 L-m-0 
job-1178,5,8,4,58996,74437,74540,15441,103,59121,false,C-l-0 C-l-0 C-l-1 C-l-1 
job-1179,2,4,2,59044,74540,74552,15496,12,59073,false,L-s-0 L-s-0 
job-1181,1,4,4,59148,74540,74728,15392,188,59549,false,L-m-0 L-l-0 L-m-0 L-m-0 
job-1180,1,10,2,59094,74540,74747,15446,207,59543,false,L-m-0 L-m-0 
job-1182,1,12,8,59199,74728,74756,15529,28,59361,false,L-l-0 L-m-0 L-s-0 L-l-0 L-l-0 C-m-0 L-l-0 C-m-0 
job-1183,5,6,8,59241,74728,74969,15487,241,59736,false,C-m-0 C-l-0 C-l-0 C-l-1 C-l-1 C-l-2 C-l-2 C-m-1 
job-1184,6,10,3,59286,74969,74981,15683,12,59536,false,L-l-0 L-l-0 L-m-0 
job-1185,2,10,3,59340,74969,75037,15629,68,59461,false,L-s-0 C-s-1 L-m-0 
job-1186,5,10,4,59390,74969,75054,15579,85,59764,false,C-l-2 C-l-0 C-l-0 C-l-2 
job-1188,3,4,4,59489,75054,75202,15565,148,59660,false,L-m-0 L-l-0 L-l-0 L-l-0 
job-1187,1,7,3,59445,75054,75315,15609,261,59996,false,L-m-0 L-m-0 L-m-0 
job-1189,4,10,3,59547,75315,75342,15768,27,59644,false,L-m-0 L-m-0 L-s-0 
job-1190,5,8,3,59593,75315,75422,15722,107,59962,false,L-l-0 L-l-0 C-m-0 
job-1191,3,8,7,59635,75315,75632,15680,317,60208,false,C-l-1 C-l-1 C-m-0 C-m-1 C-l-1 C-l-1 C-m-1 
job-1192,6,11,7,59674,75632,75667,15958,35,59716,false,L-m-0 C-l-0 C-l-1 L-l-0 C-l-0 C-l-1 L-l-0 
job-1193,5,6,6,59705,75667,75753,15962,86,60020,false,L-m-0 C-l-0 C-l-0 C-m-0 L-l-0 L-l-0 
job-1194,1,9,7,59756,75753,75924,15997,171,59971,false,L-m-0 L-l-0 L-l-0 L-l-0 L-m-0 L-l-0 L-m-0 
job-1195,4,10,2,59800,75753,75929,15953,176,59993,false,L-s-0 L-l-0 
job-1196,1,11,2,59847,75929,75985,16082,56,60027,false,L-m-0 L-m-0 
job-1197,4,5,5,59913,75929,76143,16016,214,60340,false,L-m-0 L-l-0 L-l-0 L-s-0 L-l-0 
job-1198,3,5,2,59960,76143,76155,16183,12,60027,false,L-m-0 L-m-0 
job-1199,2,6,2,60006,76143,76157,16137,14,60172,false,L-s-0 L-m-0 
job-1201,2,10,8,60096,76157,76230,16061,73,60397,false,C-s-1 L-l-0 L-l-0 L-l-0 L-m-0 L-l-0 L-m-0 L-m-0 
job-1203,5,12,3,60196,76157,76235,15961,78,60366,false,C-m-1 C-l-0 C-l-0 
job-1204,5,10,4,60242,76157,76277,15915,120,60431,false,C-l-2 C-l-1 C-l-2 C-l-1 
job-1200,1,4,2,60045,76157,76287,16112,130,60412,false,L-s-0 L-s-0 
job-1202,6,5,1,60152,76157,76322,16005,165,60597,false,C-m-0 
job-1205,4,8,2,60292,76322,76346,16030,24,60361,false,L-m-0 L-m-0 
job-1207,6,12,5,60390,76322,76357,15932,35,60468,false,C-l-0 C-l-0 L-l-0 C-m-2 L-l-0 
job-1206,2,6,2,60341,76322,76359,15981,37,60439,false,L-s-0 L-s-0 
job-1208,6,10,5,60446,76322,76602,15876,280,60731,false,C-m-0 C-l-1 C-l-2 C-l-2 C-l-1 
job-1209,1,7,7,60489,76602,76628,16113,26,60726,false,L-s-0 L-l-0 L-l-0 L-l-0 L-l-0 L-l-0 L-l-0 
job-1210,1,9,3,60541,76602,76692,16061,90,60862,false,L-m-0 L-m-0 L-s-0 
job-1211,5,5,5,60595,76602,76752,16007,150,60857,false,L-m-0 L-l-0 C-l-1 C-m-0 C-l-1 
job-1215,5,6,6,60820,76752,76813,15932,61,60898,false,C-l-1 C-l-1 C-l-0 C-l-2 C-l-0 C-l-2 
job-1212,1,8,4,60644,76752,76856,16108,104,60836,false,L-m-0 L-m-0 L-m-0 L-m-0 
job-1216,6,7,1,60869,76813,76860,15944,47,61094,false,C-m-0 
job-1213,1,5,5,60706,76752,76882,16046,130,61016,false,L-l-0 L-l-0 L-l-0 L-l-0 L-l-0 
job-1214,2,9,3,60759,76752,76951,15993,199,60976,false,L-s-0 L-l-0 L-l-0 
job-1217,1,9,3,60918,76951,76976,16033,25,61113,false,L-m-0 L-m-0 L-m-0 
job-1218,2,8,8,60947,76951,77006,16004,55,61071,false,L-l-0 L-l-0 L-s-0 L-l-0 L-l-0 L-s-0 L-l-0 L-l-0 
job-1219,3,9,8,60993,76951,77045,15958,94,61328,false,C-l-0 C-l-0 C-l-0 C-l-0 C-l-2 C-l-2 C-l-2 C-l-2 
job-1220,3,8,2,61041,76951,77119,15910,168,61308,false,C-m-0 C-m-0 
job-1221,5,6,1,61094,77119,77152,16025,33,61135,false,L-m-0 
job-1222,3,10,2,61142,77119,77363,15977,244,61494,false,L-s-0 L-m-0 
job-1223,5,12,1,61179,77119,77430,15940,311,61600,false,L-l-0 
job-1224,1,5,7,61225,77430,77532,16205,102,61443,false,L-l-0 L-l-0 L-l-0 L-l-0 L-l-0 L-l-0 L-l-0 
job-1227,1,12,7,61358,77430,77648,16072,218,61819,false,C-l-0 C-l-1 C-l-1 C-l-1 C-l-1 C-l-0 C-l-0 
job-1226,4,7,5,61309,77430,77665,16121,235,61732,false,C-s-2 C-m-1 C-m-2 C-m-2 C-m-1 
job-1225,4,7,6,61263,77430,77668,16167,238,61542,false,C-m-0 L-m-0 L-s-0 C-m-0 L-m-0 L-l-0 
job-1228,3,12,4,61407,77648,77679,16241,31,61472,false,C-s-0 L-l-0 L-l-0 C-s-1 
job-1229,4,11,4,61455,77648,77697,16193,49,61546,false,C-l-0 C-l-0 C-l-0 C-l-1 
job-1230,6,8,4,61498,77665,77768,16167,103,61884,false,C-l-2 C-l-2 C-l-1 C-m-1 
job-1231,6,7,7,61551,77697,77806,16146,109,61830,false,L-m-0 L-l-0 C-l-0 C-m-0 L-l-0 C-l-0 C-l-1 
job-1234,3,10,8,61679,77806,77948,16127,142,61851,false,C-l-0 C-l-1 C-l-1 C-l-1 C-l-0 C-l-1 C-l-0 C-l-0 
job-1233,4,6,7,61636,77806,77981,16170,175,61963,false,L-m-0 L-l-0 L-l-0 C-m-0 L-m-0 L-l-0 C-m-0 
job-1235,3,12,8,61728,77948,77999,16220,51,61869,false,C-l-0 C-l-0 C-l-0 C-l-0 C-l-1 C-l-1 C-l-1 C-l-1 
job-1232,2,7,2,61588,77806,78037,16218,231,62087,false,L-s-0 L-s-0 
job-1236,5,12,6,61781,77981,78108,16200,127,62072,false,C-m-0 L-l-0 C-l-2 L-m-0 C-l-2 L-l-0 
job-1237,1,8,5,61820,78108,78148,16288,40,62059,false,L-l-0 L-l-0 L-l-0 L-l-0 L-l-0 
job-1238,5,9,4,61880,78108,78164,16228,56,62062,false,L-m-0 C-l-0 C-m-0 C-l-0 
job-1239,5,11,3,61924,78108,78165,16184,57,62070,false,C-m-1 C-l-1 C-l-1 
job-1240,5,7,8,61967,78164,78187,16197,23,62187,false,C-m-0 L-l-0 C-l-2 C-l-0 C-l-0 L-l-0 C-l-2 L-m-0 
job-1242,5,6,4,62073,78165,78210,16092,45,62353,false,C-m-1 C-l-1 C-l-1 C-m-2 
job-1241,4,8,2,62016,78164,78251,16148,87,62381,false,L-s-0 C-s-1 
job-1243,2,5,1,62124,78210,78293,16086,83,62313,false,L-m-0 
job-1244,5,9,8,62180,78210,78321,16030,111,62452,false,C-m-0 L-l-0 C-l-1 C-l-0 C-l-1 L-l-0 C-l-0 L-m-0 
job-1246,4,5,5,62274,78293,78338,16019,45,62392,false,L-s-0 C-l-2 C-l-2 C-s-1 C-l-2 
job-1245,3,9,2,62233,78210,78344,15977,134,62620,false,C-s-2 C-m-0 
job-1248,2,7,6,62390,78321,78354,15931,33,62534,false,C-m-1 C-m-1 C-m-0 C-m-1 C-m-1 L-m-0 
job-1247,6,6,5,62336,78321,78368,15985,47,62518,false,L-m-0 C-l-0 L-l-0 L-l-0 C-l-0 
job-1249,5,11,2,62446,78321,78844,15875,523,62998,false,C-l-1 C-l-1 
job-1250,1,4,5,62502,78844,78858,16342,14,62806,false,L-m-0 L-m-0 L-m-0 L-m-0 L-m-0 
job-1252,4,9,4,62614,78844,79013,16230,169,63033,false,L-s-0 C-l-2 C-l-2 C-l-2 
job-1251,5,9,6,62563,78844,79082,16281,238,63076,false,C-l-1 L-l-0 C-l-0 C-l-1 C-l-0 L-l-0 
job-1254,6,5,2,62710,79013,79101,16303,88,62815,false,C-l-2 C-l-2 
job-1253,6,8,1,62668,79013,79139,16345,126,62935,false,L-m-0 
job-1255,6,11,8,62772,79082,79205,16310,123,63110,false,C-l-0 L-l-0 C-l-0 C-l-1 C-l-1 L-l-0 C-m-1 C-m-0 
job-1257,1,11,5,62864,79139,79218,16275,79,63034,false,C-m-0 C-m-2 L-s-0 C-m-1 C-m-2 
job-1256,6,9,1,62812,79082,79220,16270,138,63065,false,C-m-2 
job-1258,1,5,7,62914,79139,79224,16225,85,63298,false,C-m-0 L-s-0 L-m-0 C-m-1 L-m-0 L-m-0 L-m-0 
job-1260,2,6,5,63027,79139,79419,16112,280,63421,false,C-s-2 C-s-0 C-s-1 C-s-0 C-s-2 
job-1259,2,7,2,62972,79139,79427,16167,288,63504,false,C-s-1 L-m-0 
job-1261,2,6,5,63078,79419,79527,16341,108,63465,false,L-m-0 L-m-0 L-m-0 C-s-1 L-s-0 
job-1262,4,4,7,63122,79419,79609,16297,190,63441,false,L-l-0 C-l-1 C-l-1 L-l-0 C-l-1 L-l-0 C-s-2 
job-1264,5,7,2,63227,79609,79623,16382,14,63242,false,C-m-0 L-m-0 
job-1263,2,5,5,63179,79609,79678,16430,69,63443,false,L-l-0 L-l-0 L-l-0 L-l-0 L-l-0 
job-1265,5,10,6,63287,79609,79712,16322,103,63596,false,C-l-2 C-l-0 C-l-1 C-l-2 C-l-1 C-l-0 
job-1266,5,10,4,63349,79623,79785,16274,162,63762,false,L-m-0 C-m-1 C-m-2 C-m-0 
job-1267,6,8,3,63405,79785,79795,16380,10,63686,false,L-l-0 L-l-0 L-m-0 
job-1268,3,10,1,63450,79785,79838,16335,53,63716,false,L-s-0 
job-1269,6,4,1,63509,79785,80060,16276,275,63855,false,C-m-0 
job-1270,6,7,4,63563,80060,80076,16497,16,63628,false,L-m-0 L-l-0 L-l-0 C-m-0 
job-1271,4,9,6,63614,80060,80191,16446,131,64023,false,L-s-0 C-m-1 C-l-1 C-m-1 C-l-1 C-l-1 
job-1272,4,9,6,63660,80191,80227,16531,36,63735,false,L-m-0 L-s-0 L-l-0 L-l-0 L-m-0 L-l-0 
job-1273,2,11,4,63700,80191,80280,16491,89,63889,false,C-l-0 C-l-0 C-l-0 C-l-0 
job-1274,4,6,4,63754,80191,80283,16437,92,64056,false,C-s-1 C-l-2 C-l-2 C-l-2 
job-1275,2,12,5,63796,80191,80299,16395,108,64034,false,C-s-2 C-l-1 C-l-1 C-l-1 C-l-1 
job-1276,2,12,3,63856,80191,80575,16335,384,64428,false,C-s-0 C-m-0 C-m-0 
job-1277,1,12,2,63910,80575,80606,16665,31,64094,false,L-m-0 L-m-0 
job-1278,4,9,2,63962,80575,80668,16613,93,64321,false,L-l-0 L-l-0 
job-1279,3,9,4,64018,80668,80683,16650,15,64076,false,L-l-0 L-l-0 L-l-0 L-l-0 
job-1280,1,8,3,64060,80668,80745,16608,77,64284,false,L-m-0 L-m-0 L-m-0 
job-1282,1,9,5,64147,80745,80758,16598,13,64214,false,L-l-0 L-l-0 L-l-0 L-l-0 L-l-0 
job-1283,2,7,8,64193,80745,80761,16552,16,64287,false,C-s-0 C-s-1 L-s-0 C-s-2 L-s-0 C-s-1 C-s-0 C-s-2 
job-1281,4,8,2,64098,80745,80765,16647,20,64268,false,L-m-0 L-m-0 
job-1284,6,9,7,64236,80745,80968,16509,223,64666,false,C-l-0 C-l-2 C-l-0 C-l-2 C-l-1 C-l-1 C-m-0 
job-1285,5,10,1,64284,80968,81065,16684,97,64441,false,L-m-0 
job-1286,1,6,7,64338,81065,81081,16727,16,64650,false,L-l-0 L-l-0 L-l-0 L-l-0 L-l-0 L-l-0 L-l-0 
job-1287,3,11,2,64395,81065,81134,16670,69,64739,false,L-m-0 L-m-0 
job-1288,6,11,2,64442,81065,81161,16623,96,64771,false,C-l-0 C-l-0 
job-1289,4,4,8,64509,81065,81200,16556,135,64757,false,L-s-0 C-l-1 C-l-2 C-l-2 C-l-1 L-l-0 C-l-2 C-l-1 
job-1291,6,9,8,64609,81200,81214,16591,14,64719,false,L-l-0 C-l-0 C-l-0 C-l-2 C-l-1 C-l-1 C-l-2 L-l-0 
job-1292,3,10,3,64660,81200,81233,16540,33,64838,false,L-s-0 C-m-0 C-m-0 
job-1290,6,6,1,64562,81200,81269,16638,69,64776,false,L-m-0 
job-1294,5,4,6,64768,81214,81298,16446,84,64857,false,C-m-2 L-l-0 L-l-0 C-m-1 C-l-2 C-l-2 
job-1293,1,12,5,64713,81200,81360,16487,160,65107,false,C-m-0 L-m-0 L-m-0 C-m-1 C-m-1 
job-1297,6,7,3,64917,81360,81377,16443,17,65005,false,C-l-0 C-l-0 C-m-0 
job-1295,2,6,6,64822,81360,81384,16538,24,65108,false,L-l-0 L-l-0 L-l-0 L-l-0 L-l-0 L-l-0 
job-1298,5,7,7,64964,81377,81405,16413,28,65223,false,C-m-0 C-l-2 C-l-1 C-l-2 C-l-0 C-l-1 C-l-0 
job-1296,2,9,5,64867,81360,81410,16493,50,64981,false,C-s-1 L-m-0 L-s-0 L-m-0 L-m-0 
job-1299,5,8,1,65003,81377,81434,16374,57,65062,false,C-m-1 
job-1300,1,4,7,65060,81405,81587,16345,182,65320,false,C-m-1 C-m-1 L-l-0 C-s-1 C-m-1 L-m-0 L-s-0 
job-1302,4,9,5,65153,81587,81630,16434,43,65387,false,L-s-0 L-m-0 L-m-0 C-m-0 C-m-0 
job-1301,2,5,5,65117,81587,81766,16470,179,65509,false,L-l-0 L-l-0 L-l-0 L-l-0 L-l-0 
job-1303,4,10,2,65217,81766,81783,16549,17,65390,false,L-m-0 L-m-0 
job-1304,4,8,8,65263,81766,81786,16503,20,65407,false,C-s-1 L-l-0 C-l-1 C-l-1 C-l-1 L-l-0 L-l-0 L-s-0 
job-1305,6,8,4,65316,81766,81848,16450,82,65599,false,C-l-2 C-l-2 C-l-0 C-l-0 
job-1307,2,12,3,65426,81766,81849,16340,83,65622,false,C-m-0 C-s-0 C-m-0 
job-1306,1,11,3,65379,81766,81878,16387,112,65565,false,C-m-1 C-m-1 C-s-2 
job-1308,4,5,3,65475,81766,81910,16291,144,65805,false,C-m-1 C-m-2 C-m-0 
job-1309,2,10,3,65518,81910,81963,16392,53,65714,false,L-m-0 L-m-0 L-m-0 
job-1310,1,9,5,65564,81963,81984,16399,21,65687,false,L-l-0 L-l-0 L-l-0 L-l-0 L-l-0 
job-1311,5,8,7,65614,81963,82028,16349,65,65828,false,C-l-0 C-l-0 C-l-1 C-l-2 C-l-1 C-l-2 L-m-0 
job-1312,4,11,8,65670,82028,82046,16358,18,65838,false,L-l-0 L-m-0 L-l-0 L-m-0 C-m-1 L-s-0 L-l-0 C-m-1 
job-1313,2,7,5,65721,82028,82179,16307,151,65934,false,C-l-0 C-l-0 C-l-0 C-l-0 C-l-0 
job-1314,5,12,7,65782,82046,82282,16264,236,66067,false,L-m-0 L-l-0 C-l-1 C-l-2 C-l-1 L-l-0 C-l-2 
job-1316,5,8,4,65889,82282,82390,16393,108,66231,false,L-m-0 L-l-0 L-l-0 C-m-0 
job-1317,2,4,8,65942,82282,82510,16340,228,66252,false,L-s-0 L-l-0 C-m-1 C-m-1 C-m-1 C-m-1 C-m-0 L-m-0 
job-1315,1,6,2,65838,82282,82555,16444,273,66116,false,L-s-0 L-s-0 
job-1318,3,12,4,65995,82282,82578,16287,296,66544,false,C-l-0 C-l-0 C-l-0 C-l-0 
job-1319,3,10,3,66042,82510,82617,16468,107,66202,false,L-l-0 L-l-0 L-l-0 
job-1320,2,5,7,66095,82510,82739,16415,229,66453,false,L-m-0 C-s-1 L-m-0 C-s-1 L-m-0 L-l-0 L-m-0 
job-1321,2,11,5,66150,82739,82749,16589,10,66416,false,L-s-0 L-l-0 L-l-0 L-l-0 L-l-0 
job-1322,3,6,8,66203,82739,82830,16536,91,66467,false,C-m-0 C-l-0 C-l-0 C-l-0 C-l-0 L-m-0 C-m-0 L-m-0 
job-1323,5,11,3,66253,82739,82957,16486,218,66637,false,C-m-1 C-l-1 C-l-1 
job-1324,1,8,5,66308,82830,82958,16522,128,66490,false,C-m-1 C-l-1 L-s-0 C-m-1 C-l-1 
job-1325,2,6,5,66363,82830,82963,16467,133,66735,false,L-s-0 L-m-0 L-m-0 L-m-0 L-m-0 
job-1326,2,7,2,66408,82958,82994,16550,36,66444,false,L-s-0 L-l-0 
job-1327,2,12,7,66461,82958,83048,16497,90,66823,false,C-l-0 L-l-0 L-l-0 C-l-0 C-l-0 C-l-0 L-l-0 
job-1328,1,8,6,66489,83048,83082,16559,34,66729,false,L-l-0 L-l-0 L-l-0 L-l-0 L-l-0 L-l-0 
job-1329,6,7,7,66546,83048,83189,16502,141,66693,false,C-l-0 C-l-0 C-l-1 L-m-0 C-l-1 C-l-2 C-l-2 
job-1330,5,8,6,66606,83189,83231,16583,42,66876,false,L-m-0 C-l-0 C-l-0 C-m-0 L-l-0 L-l-0 
job-1331,6,4,6,66645,83189,83247,16544,58,66918,false,C-m-2 C-l-1 C-l-2 C-m-1 C-l-1 C-l-2 
job-1334,6,6,8,66777,83247,83258,16470,11,66892,false,L-l-0 C-l-2 C-l-0 C-l-0 C-l-2 L-l-0 C-l-1 C-l-1 
job-1336,1,5,5,66876,83247,83317,16371,70,67086,false,C-m-0 C-m-0 C-m-0 C-m-0 C-m-0 
job-1335,4,6,1,66820,83247,83360,16427,113,66971,false,C-s-2 
job-1333,2,6,5,66736,83247,83363,16511,116,67130,false,L-m-0 L-m-0 L-m-0 L-m-0 L-s-0 
job-1337,3,7,3,66930,83247,83365,16317,118,67143,false,C-m-0 C-m-1 C-m-1 
job-1332,2,4,1,66690,83247,83390,16557,143,66945,false,L-s-0 
job-1338,1,10,8,66990,83360,83392,16370,32,67096,false,C-m-0 L-l-0 L-l-0 L-l-0 L-l-0 C-m-1 C-s-1 C-m-0 
job-1340,6,11,6,67089,83360,83484,16271,124,67288,false,C-l-0 C-l-2 C-l-1 C-l-2 C-l-1 C-l-0 
job-1339,1,6,8,67043,83360,83504,16317,144,67345,false,C-s-1 L-l-0 C-m-2 C-m-2 C-m-2 C-m-2 C-m-1 C-m-2 
job-1341,2,12,8,67138,83392,83521,16254,129,67346,false,L-s-0 L-l-0 L-l-0 C-m-1 L-l-0 L-m-0 C-m-1 L-m-0 
job-1342,6,5,3,67197,83484,83581,16287,97,67486,false,C-m-0 C-l-0 C-l-0 
job-1344,5,7,8,67282,83581,83592,16299,11,67496,false,C-l-0 C-l-0 C-l-2 C-l-1 C-l-1 L-m-0 C-l-2 C-m-0 
job-1345,4,5,3,67333,83581,83607,16248,26,67552,false,C-s-1 C-m-1 C-m-1 
job-1346,6,12,2,67379,83592,83608,16213,16,67565,false,L-m-0 C-m-0 
job-1347,3,11,5,67427,83592,83624,16165,32,67721,false,C-l-0 C-l-0 C-l-0 C-s-2 C-l-0 
job-1343,3,5,5,67247,83581,83624,16334,43,67509,false,L-s-0 L-l-0 L-l-0 L-l-0 L-l-0 
job-1348,6,7,7,67483,83608,83630,16125,22,67765,false,C-m-1 C-l-1 C-l-2 C-m-0 C-l-1 C-l-2 L-m-0 
job-1349,2,9,1,67538,83630,83784,16092,154,67802,false,L-s-0 
job-1352,5,8,6,67690,83784,83841,16094,57,68019,false,C-l-1 C-l-0 C-l-2 C-l-1 C-l-0 C-l-2 
job-1350,2,12,3,67598,83630,83873,16032,243,68014,false,L-l-0 L-l-0 L-l-0 
job-1351,4,8,4,67652,83630,83957,15978,327,68213,false,L-m-0 C-s-1 L-l-0 L-m-0 
job-1353,3,8,3,67738,83784,84219,16046,435,68263,false,L-s-0 C-m-0 C-m-0 
job-1354,1,12,8,67777,84219,84286,16442,67,68072,false,L-m-0 L-l-0 L-s-0 L-l-0 L-l-0 L-l-0 C-s-1 L-m-0 
job-1356,1,7,7,67891,84219,84340,16328,121,68145,false,C-l-0 C-l-0 C-l-0 L-m-0 C-l-0 C-l-0 C-l-0 
job-1355,4,9,1,67844,84219,84606,16375,387,68381,false,C-s-2 
job-1357,4,6,3,67931,84606,84645,16675,39,68105,false,L-l-0 L-l-0 L-l-0 
job-1358,1,11,7,67974,84606,84736,16632,130,68146,false,L-s-0 C-l-0 C-l-0 L-m-0 C-l-0 C-l-0 L-m-0 
job-1359,5,12,7,68046,84606,84756,16560,150,68381,false,C-m-1 C-l-2 C-l-1 C-m-0 C-l-2 C-l-1 C-m-2 
job-1360,1,4,3,68099,84756,84835,16657,79,68340,false,L-s-0 L-s-0 L-s-0 
job-1361,5,6,8,68146,84756,84844,16610,88,68434,false,L-l-0 C-l-1 C-l-0 C-l-0 C-l-1 L-l-0 C-m-0 L-m-0 
job-1363,3,5,6,68219,84835,84871,16616,36,68299,false,C-s-1 C-l-2 C-l-2 C-s-2 C-l-2 C-l-2 
job-1362,2,9,6,68185,84835,84876,16650,41,68523,false,L-m-0 C-l-1 L-s-0 C-m-0 C-l-0 L-l-0 
job-1364,1,8,8,68265,84876,84906,16611,30,68337,false,L-s-0 L-l-0 L-l-0 L-l-0 L-l-0 L-s-0 L-l-0 L-l-0 
job-1365,5,4,1,68312,84876,84913,16564,37,68371,false,L-m-0 
job-1367,3,5,5,68394,84876,85017,16482,141,68633,false,C-l-2 C-l-2 L-m-0 C-l-2 C-l-2 
job-1368,6,11,5,68448,84906,85041,16458,135,68817,false,C-m-1 L-l-0 C-m-2 C-m-0 L-l-0 
job-1366,5,10,4,68358,84876,85082,16518,206,68707,false,C-l-0 C-l-0 C-l-1 C-l-1 
job-1369,3,7,1,68492,85017,85087,16525,70,68851,false,L-s-0 
job-1371,6,9,6,68582,85082,85164,16500,82,68766,false,L-m-0 L-l-0 C-l-1 C-m-0 C-l-1 L-l-0 
job-1370,1,4,2,68539,85082,85275,16543,193,68812,false,L-s-0 L-m-0 
job-1372,4,6,1,68643,85275,85294,16632,19,68907,false,L-s-0 
job-1375,4,6,6,68786,85275,85361,16489,86,68906,false,C-m-1 C-l-0 C-l-0 C-m-1 C-l-0 L-l-0 
job-1374,2,5,5,68741,85275,85362,16534,87,68901,false,L-l-0 L-m-0 L-l-0 L-l-0 L-l-0 
job-1376,3,10,5,68843,85361,85406,16518,45,68983,false,C-l-0 C-l-0 C-l-0 C-l-0 L-l-0 
job-1377,4,5,2,68891,85361,85421,16470,60,69177,false,L-s-0 C-s-1 
job-1379,1,11,7,68972,85361,85441,16389,80,69209,false,L-l-0 C-l-2 C-l-2 C-m-0 C-l-2 C-l-2 C-m-0 
job-1373,6,9,1,68692,85275,85458,16583,183,69134,false,L-m-0 
job-1378,3,11,1,68928,85361,85532,16433,171,69200,false,C-s-2 
job-1380,6,6,1,69016,85532,85546,16516,14,69319,false,L-m-0 
job-1381,5,10,7,69068,85532,85598,16464,66,69295,false,C-m-0 L-l-0 C-l-1 C-l-0 C-l-1 L-l-0 C-l-0 
job-1383,3,8,5,69188,85598,85626,16410,28,69473,false,C-s-0 C-l-0 C-l-0 C-l-0 C-l-0 
job-1382,3,5,8,69140,85598,85627,16458,29,69200,false,L-m-0 L-l-0 L-s-0 L-l-0 L-l-0 L-l-0 C-s-1 L-m-0 
job-1384,6,6,4,69233,85598,85707,16365,109,69591,false,C-l-1 C-l-2 C-l-2 C-l-1 
job-1385,5,6,3,69279,85598,85930,16319,332,69750,false,C-m-2 C-m-1 C-m-0 
job-1386,6,4,3,69323,85930,85944,16607,14,69374,false,L-l-0 L-l-0 L-m-0 
job-1388,6,9,6,69427,85930,85952,16503,22,69504,false,C-l-0 C-l-0 C-l-1 C-l-2 C-l-2 C-l-1 
job-1389,2,11,7,69480,85930,85983,16450,53,69611,false,C-m-0 C-m-2 C-m-0 C-m-1 C-m-2 C-s-1 C-m-1 
job-1392,5,8,6,69626,85983,86019,16357,36,69679,false,C-l-0 C-l-1 C-l-0 C-l-2 C-l-2 C-l-1 
job-1387,1,10,3,69376,85930,86023,16554,93,69742,false,L-s-0 L-m-0 L-m-0 
job-1393,5,10,4,69679,86019,86068,16340,49,69936,false,C-l-1 C-l-0 C-l-0 C-l-1 
job-1391,1,6,2,69570,85983,86072,16413,89,69678,false,L-s-0 C-s-1 
job-1390,1,12,5,69524,85944,86148,16420,204,69998,false,L-l-0 L-l-0 L-l-0 L-l-0 L-m-0 
job-1394,4,11,4,69717,86019,86149,16302,130,70107,false,C-s-2 C-l-2 C-l-2 C-l-2 
job-1395,1,6,7,69778,86148,86166,16370,18,70070,false,L-l-0 L-l-0 L-l-0 L-l-0 L-l-0 L-l-0 L-l-0 
job-1397,3,9,8,69878,86148,86296,16270,148,70218,false,C-s-0 C-m-1 C-s-1 L-s-0 C-m-2 C-m-2 C-m-0 L-m-0 
job-1396,5,11,7,69838,86148,86352,16310,204,70323,false,L-m-0 C-l-0 C-l-1 C-m-1 C-l-0 C-l-1 C-m-0 
job-1398,2,8,1,69932,86352,86376,16420,24,70009,false,L-s-0 
job-1399,4,12,5,69980,86352,86698,16372,346,70390,false,L-l-0 L-l-0 L-m-0 L-m-0 L-l-0 
job-1400,3,4,4,70032,86698,86713,16666,15,70141,false,L-l-0 L-l-0 L-l-0 L-l-0 
job-1401,3,12,5,70091,86698,86872,16607,174,70334,false,L-s-0 L-m-0 L-m-0 C-m-0 C-m-0 
job-1404,5,12,6,70227,86872,86891,16645,19,70433,false,C-l-0 C-l-1 C-l-0 C-l-2 C-l-1 C-l-2 
job-1402,2,12,5,70127,86872,86916,16745,44,70251,false,L-l-0 L-s-0 L-l-0 L-l-0 L-l-0 
job-1405,6,4,3,70276,86872,87014,16596,142,70466,false,C-m-1 C-m-0 C-m-2 
job-1403,5,7,1,70178,86872,87029,16694,157,70539,false,L-m-0 
job-1407,5,11,5,70362,87014,87049,16652,35,70621,false,L-l-0 L-l-0 C-l-0 C-m-0 C-l-0 
job-1406,4,9,3,70326,86872,87112,16546,240,70850,false,C-s-0 C-s-1 C-s-2 
job-1408,6,10,5,70421,87112,87138,16691,26,70516,false,L-m-0 C-l-0 L-l-0 L-l-0 C-l-0 
job-1409,3,4,1,70472,87112,87158,16640,46,70599,false,L-s-0 
job-1410,3,11,8,70522,87112,87368,16590,256,70793,false,C-l-2 C-l-2 C-l-1 C-l-2 C-l-2 C-l-1 C-l-1 C-l-1 
job-1411,2,8,6,70561,87368,87420,16807,52,70616,false,L-l-0 L-l-0 L-l-0 L-l-0 L-l-0 L-l-0 
job-1412,4,12,7,70612,87368,87532,16756,164,71052,false,C-l-0 L-s-0 C-l-0 L-m-0 C-l-0 L-m-0 C-s-1 
job-1413,5,12,2,70654,87532,87567,16878,35,70867,false,L-l-0 L-l-0 
job-1414,6,6,3,70699,87532,87693,16833,161,70884,false,L-m-0 C-l-0 C-l-0 
job-1415,4,7,5,70746,87532,87867,16786,335,71344,false,L-s-0 C-l-1 C-l-1 C-s-1 C-l-1 
job-1416,5,5,2,70796,87867,87990,17071,123,70920,false,L-l-0 L-l-0 
job-1417,3,10,4,70856,87867,88155,17011,288,71330,false,L-m-0 L-m-0 C-s-1 L-s-0 
job-1418,1,8,8,70907,88155,88179,17248,24,71144,false,L-s-0 L-l-0 L-l-0 L-l-0 L-l-0 L-s-0 L-l-0 L-l-0 
job-1419,3,4,3,70959,88155,88315,17196,160,71350,false,L-m-0 C-s-1 L-m-0 
job-1420,1,9,7,71014,88315,88351,17301,36,71154,false,L-m-0 L-l-0 L-l-0 L-l-0 L-m-0 L-l-0 L-m-0 
job-1421,5,11,8,71062,88315,88499,17253,184,71317,false,C-m-0 C-l-2 C-l-0 C-l-0 C-l-1 L-l-0 C-l-2 C-l-1 
job-1422,6,9,8,71109,88499,88628,17390,129,71498,false,L-l-0 C-l-0 C-l-2 C-l-2 C-l-0 L-l-0 C-m-0 L-m-0 
job-1423,4,6,2,71159,88628,88641,17469,13,71173,false,L-m-0 L-m-0 
job-1424,2,6,5,71212,88628,88683,17416,55,71358,false,L-l-0 L-l-0 L-l-0 L-l-0 L-l-0 
job-1426,6,8,3,71313,88683,88701,17370,18,71548,false,L-l-0 L-m-0 L-l-0 
job-1425,3,4,5,71260,88628,88702,17368,74,71541,false,L-s-0 C-l-0 C-l-0 C-l-0 C-l-0 
job-1427,6,7,6,71373,88683,88712,17310,29,71689,false,C-m-0 C-l-1 C-l-2 C-m-1 C-l-1 C-l-2 
job-1428,5,5,1,71421,88683,88747,17262,64,71541,false,C-m-2 
job-1429,2,6,2,71467,88712,88782,17245,70,71718,false,L-s-0 C-m-2 
job-1430,3,6,3,71512,88712,88827,17200,115,71696,false,L-l-0 L-l-0 L-l-0 
job-1433,5,8,3,71675,88712,88835,17037,123,71993,false,C-m-0 C-l-1 C-l-1 
job-1431,1,6,6,71565,88712,88852,17147,140,71822,false,L-s-0 L-l-0 L-l-0 C-m-2 L-l-0 L-m-0 
job-1434,3,6,6,71720,88747,88859,17027,112,71967,false,C-m-0 C-l-2 C-l-0 C-m-2 C-l-2 C-l-2 
job-1432,3,4,5,71620,88712,88933,17092,221,71906,false,C-l-0 C-l-0 L-m-0 L-m-0 C-l-0 
job-1435,4,12,1,71768,88747,88971,16979,224,72033,false,C-s-1 
job-1436,6,7,7,71836,88859,89025,17023,166,72253,false,C-m-0 C-l-2 C-l-2 C-l-1 C-l-1 L-l-0 L-l-0 
job-1439,4,11,8,71992,89025,89092,17033,67,72336,false,C-l-2 C-l-1 C-l-2 C-l-1 C-l-1 C-m-0 C-l-2 C-m-0 
job-1437,1,12,2,71901,89025,89113,17124,88,72093,false,L-m-0 L-m-0 
job-1441,3,11,8,72093,89092,89163,16999,71,72235,false,C-l-1 C-l-1 C-l-0 C-s-0 C-l-1 C-l-1 C-m-0 C-m-0 
job-1438,1,12,6,71945,89025,89171,17080,146,72369,false,L-s-0 L-l-0 L-l-0 C-s-1 L-l-0 L-l-0 
job-1440,3,8,4,72042,89025,89211,16983,186,72446,false,C-l-0 L-m-0 C-l-0 C-l-0 
job-1443,5,4,5,72199,89171,89240,16972,69,72367,false,L-m-0 L-l-0 C-m-2 C-m-1 L-l-0 
job-1444,6,10,7,72249,89240,89262,16991,22,72316,false,C-l-0 C-l-0 L-l-0 C-m-1 L-l-0 C-m-2 L-m-0 
job-1442,6,9,5,72153,89163,89279,17010,116,72285,false,C-m-0 C-l-2 C-l-1 C-l-1 C-l-2 
job-1445,5,12,6,72294,89262,89333,16968,71,72427,false,L-m-0 L-l-0 C-l-0 C-m-1 C-l-0 L-l-0 
job-1446,4,10,2,72345,89262,89488,16917,226,72651,false,L-s-0 C-s-1 
job-1448,2,10,5,72442,89488,89560,17046,72,72745,false,L-m-0 L-l-0 L-l-0 L-l-0 L-l-0 
job-1447,4,4,1,72392,89488,89576,17096,88,72527,false,L-s-0 
job-1449,2,5,5,72484,89488,89607,17004,119,72715,false,L-m-0 C-s-1 L-m-0 L-m-0 L-l-0 
job-1450,6,5,6,72528,89488,89679,16960,191,72798,false,C-l-0 C-l-1 C-l-1 C-l-2 C-l-0 C-l-2 
job-1451,2,11,2,72567,89679,89721,17112,42,72740,false,L-m-0 L-m-0 
job-1452,5,11,4,72616,89679,89757,17063,78,72925,false,C-l-0 L-l-0 L-l-0 C-l-0 
job-1454,3,11,5,72702,89679,89762,16977,83,72926,false,L-s-0 C-l-2 C-l-2 C-l-2 C-l-2 
job-1455,1,4,4,72751,89757,89816,17006,59,73003,false,L-m-0 L-m-0 L-s-0 L-m-0 
job-1453,6,8,2,72653,89679,89823,17026,144,72971,false,C-l-1 C-l-1 
job-1456,5,7,3,72803,89816,89831,17013,15,73060,false,L-l-0 L-m-0 L-l-0 
job-1457,6,4,5,72862,89816,89843,16954,27,73021,false,C-m-0 C-l-2 C-l-2 C-l-0 C-l-0 
job-1458,4,11,2,72918,89816,89936,16898,120,73171,false,L-s-0 C-s-2 
job-1459,6,6,8,72971,89843,90067,16872,224,73402,false,L-l-0 C-l-1 L-l-0 C-l-2 C-l-1 L-m-0 C-l-2 C-m-0 
job-1460,4,4,6,73009,90067,90093,17058,26,73307,false,L-m-0 L-s-0 L-l-0 L-l-0 L-m-0 L-l-0 
job-1461,5,12,4,73054,90067,90173,17013,106,73272,false,C-l-2 C-l-0 C-l-0 C-l-2 
job-1462,6,6,3,73105,90067,90286,16962,219,73428,false,C-l-1 C-m-0 C-l-1 
job-1463,2,9,3,73152,90173,90543,17021,370,73759,false,L-m-0 L-m-0 C-m-0 
job-1464,5,8,3,73197,90543,90577,17346,34,73250,false,L-l-0 L-l-0 L-m-0 
job-1465,4,10,1,73238,90543,90577,17305,34,73276,false,L-s-0 
job-1468,2,6,3,73379,90543,90601,17164,58,73662,false,C-m-0 C-m-0 C-m-0 
job-1466,3,8,6,73294,90543,90605,17249,62,73361,false,C-s-1 C-l-1 C-l-1 L-m-0 C-l-1 C-l-1 
job-1469,1,9,8,73430,90577,90608,17147,31,73512,false,L-l-0 L-l-0 L-l-0 L-l-0 C-m-0 L-m-0 C-s-2 L-m-0 
job-1467,2,12,5,73338,90543,90613,17205,70,73620,false,C-l-0 C-l-0 C-l-0 L-l-0 C-l-0 
job-1470,6,12,4,73480,90577,90783,17097,206,73832,false,C-m-2 C-l-2 C-l-2 C-m-1 
job-1471,5,10,3,73533,90605,90901,17072,296,73949,false,C-m-0 C-l-1 L-m-0 
job-1472,6,11,6,73581,90901,90913,17320,12,73822,false,C-m-0 C-l-0 L-l-0 L-m-0 C-l-0 L-l-0 
job-1473,5,12,1,73633,90901,90922,17268,21,73746,false,C-m-1 
job-1474,6,12,6,73679,90913,90930,17234,17,73935,false,L-m-0 C-l-0 L-l-0 C-m-0 C-l-0 L-l-0 
job-1475,1,4,8,73735,90913,90946,17178,33,74006,false,C-m-1 C-m-1 L-s-0 C-m-0 L-m-0 C-m-0 C-m-1 L-m-0 
job-1477,6,10,3,73822,90913,90967,17091,54,73949,false,C-l-1 C-l-2 C-l-2 
job-1478,6,12,7,73868,90967,90981,17099,14,74163,false,L-l-0 C-l-0 C-l-1 C-l-0 C-l-1 L-l-0 L-m-0 
job-1476,1,10,4,73786,90913,91010,17127,97,73896,false,L-s-0 C-m-2 C-m-2 C-m-2 
job-1479,6,4,8,73915,90981,91142,17066,161,74222,false,C-l-2 C-l-1 C-l-2 C-l-1 L-l-0 L-l-0 C-m-0 L-m-0 
job-1480,4,4,3,73954,91142,91221,17188,79,74165,false,L-l-0 L-l-0 L-l-0 
job-1481,5,4,5,74002,91142,91522,17140,380,74626,false,C-l-0 C-l-1 C-l-0 L-m-0 C-l-1 
job-1483,2,8,6,74115,91522,91566,17407,44,74260,false,C-l-0 C-l-0 C-l-0 C-l-0 C-l-0 C-l-0 
job-1484,3,7,5,74157,91522,91612,17365,90,74388,false,C-s-1 C-l-2 C-l-2 C-l-2 C-l-2 
job-1482,4,12,6,74053,91522,91653,17469,131,74236,false,L-m-0 L-s-0 L-l-0 L-l-0 L-m-0 L-l-0 
job-1486,2,6,3,74256,91522,91657,17266,135,74600,false,C-m-0 C-s-2 C-s-2 
job-1487,6,10,7,74306,91653,91683,17347,30,74599,false,L-l-0 C-l-0 C-l-2 L-m-0 C-l-0 C-l-2 L-l-0 
job-1485,6,12,3,74206,91522,91684,17316,162,74404,false,C-m-0 C-l-1 C-l-1 
job-1488,5,10,1,74357,91653,91721,17296,68,74474,false,C-m-1 
job-1489,5,8,8,74416,91683,91729,17267,46,74638,false,C-m-2 L-l-0 C-l-2 C-l-0 C-l-0 L-l-0 C-l-2 L-m-0 
job-1491,6,11,3,74489,91729,91767,17240,38,74764,false,L-l-0 L-m-0 L-l-0 
job-1490,2,9,1,74460,91729,91865,17269,136,74739,false,L-s-0 
job-1494,4,7,4,74644,91865,91948,17221,83,74884,false,C-m-0 L-l-0 L-l-0 C-m-0 
job-1493,2,9,5,74588,91767,92033,17179,266,75147,false,L-m-0 L-l-0 L-m-0 L-m-0 L-l-0 
job-1492,2,5,2,74536,91767,92118,17231,351,74923,false,L-s-0 L-m-0 
job-1495,4,7,4,74691,92118,92129,17427,11,74893,false,L-l-0 L-l-0 L-s-0 L-l-0 
job-1497,6,5,6,74772,92118,92193,17346,75,74902,false,C-l-0 C-l-0 C-l-1 C-l-2 C-l-2 C-l-1 
job-1498,1,11,4,74816,92129,92195,17313,66,75003,false,L-l-0 L-l-0 L-m-0 C-m-0 
job-1496,6,11,2,74733,92118,92209,17385,91,74943,false,L-m-0 C-m-0 
job-1499,2,5,2,74872,92209,92357,17337,148,75238,false,L-s-0 L-s-0 
job-1500,5,11,5,74917,92209,92393,17292,184,75107,false,L-l-0 L-l-0 C-l-0 L-m-0 C-l-0 
job-1501,1,12,2,74984,92393,92426,17409,33,75193,false,L-m-0 L-m-0 
job-1502,6,7,4,75025,92393,92542,17368,149,75267,false,L-m-0 L-l-0 L-l-0 C-m-0 
job-1503,3,8,4,75089,92393,92744,17304,351,75561,false,C-l-0 C-l-0 C-l-0 C-l-0 
job-1504,2,8,7,75130,92744,92842,17614,98,75351,false,L-l-0 L-l-0 L-s-0 L-l-0 L-l-0 L-s-0 L-l-0 
job-1505,2,8,2,75179,92744,92843,17565,99,75397,false,L-m-0 L-l-0 
job-1506,4,5,4,75236,92842,92861,17606,19,75344,false,L-s-0 L-l-0 L-l-0 L-m-0 
job-1507,6,4,4,75286,92842,92902,17556,60,75390,false,C-l-0 C-l-0 C-l-1 C-l-1 
job-1508,5,5,2,75334,92902,92921,17568,19,75413,false,L-l-0 L-l-0 
job-1509,1,11,2,75383,92921,92996,17538,75,75635,false,L-m-0 L-m-0 
job-1510,5,8,2,75420,92996,93011,17576,15,75477,false,L-l-0 L-l-0 
job-1511,5,8,8,75467,92996,93146,17529,150,75900,false,C-m-0 C-l-0 C-l-0 C-l-1 C-l-1 C-l-2 C-l-2 L-m-0 
job-1512,1,11,1,75510,93146,93191,17636,45,75854,false,L-s-0 
job-1513,1,12,2,75563,93146,93417,17583,271,76084,false,L-m-0 L-m-0 
job-1514,1,6,2,75620,93417,93465,17797,48,75711,false,L-s-0 L-s-0 
job-1516,4,9,3,75725,93417,93579,17692,162,76136,false,C-l-1 C-l-1 C-l-1 
job-1518,2,6,7,75832,93465,93615,17633,150,76093,false,C-s-1 C-m-2 C-m-2 C-m-2 C-m-2 L-s-0 C-s-1 
job-1515,4,9,8,75678,93417,93625,17739,208,76060,false,L-m-0 L-l-0 C-l-0 C-l-0 C-l-0 L-l-0 L-l-0 L-m-0 
job-1517,4,6,5,75780,93417,93654,17637,237,76069,false,C-m-0 C-l-2 C-l-2 C-m-0 C-l-2 
job-1519,6,7,2,75880,93579,93702,17699,123,76115,false,C-l-1 C-l-1 
job-1521,4,8,1,75988,93702,93728,17714,26,76044,false,L-m-0 
job-1520,1,5,3,75934,93702,93745,17768,43,76155,false,L-s-0 L-s-0 L-s-0 
job-1522,5,12,1,76050,93702,93790,17652,88,76166,false,L-l-0 
job-1523,5,5,8,76093,93702,93879,17609,177,76292,false,C-l-0 C-l-2 C-l-0 C-l-1 C-l-1 L-l-0 C-l-2 C-m-0 
job-1524,6,7,1,76146,93702,93934,17556,232,76603,false,C-m-1 
job-1526,5,7,8,76242,93934,93947,17692,13,76551,false,C-l-0 C-l-0 C-l-2 C-l-1 C-l-1 C-m-0 C-l-2 L-m-0 
job-1525,5,10,2,76196,93934,93963,17738,29,76386,false,L-l-0 L-l-0 
job-1528,6,11,4,76349,93963,93980,17614,17,76568,false,L-m-0 L-l-0 L-l-0 C-m-0 
job-1527,1,6,2,76302,93963,94004,17661,41,76478,false,L-s-0 L-s-0 
job-1530,3,10,8,76457,93963,94138,17506,175,76727,false,C-l-1 C-l-0 C-l-1 C-l-0 C-l-1 C-l-0 C-l-1 C-m-1 
job-1529,5,9,1,76402,93963,94205,17561,242,76705,false,C-m-1 
job-1533,5,7,4,76606,94205,94237,17599,32,76922,false,C-l-1 C-m-2 C-l-1 C-m-1 
job-1532,6,11,7,76557,94205,94239,17648,34,76600,false,L-l-0 L-l-0 C-l-0 C-m-0 C-l-0 C-l-2 C-l-2 
job-1531,3,7,3,76509,94205,94245,17696,40,76715,false,L-m-0 L-m-0 L-s-0 
job-1534,6,11,3,76653,94237,94255,17584,18,76813,false,C-l-1 C-l-1 C-m-1 
job-1536,5,4,2,76755,94255,94272,17500,17,76939,false,L-l-0 L-l-0 
job-1535,3,10,4,76708,94237,94273,17529,36,76986,false,C-s-1 C-m-2 C-s-2 C-m-2 
job-1537,3,12,3,76806,94272,94283,17466,11,76869,false,L-l-0 L-l-0 L-l-0 
job-1538,2,4,5,76845,94272,94291,17427,19,77157,false,L-m-0 L-m-0 L-m-0 C-m-2 L-l-0 
job-1539,5,5,1,76903,94272,94317,17369,45,77068,false,C-m-0 
job-1540,3,9,7,76943,94272,94403,17329,131,77211,false,L-s-0 C-l-0 C-l-0 C-m-0 C-l-0 C-l-0 C-s-0 
job-1541,4,7,1,76994,94403,94484,17409,81,77364,false,L-s-0 
job-1543,5,4,4,77113,94403,94499,17290,96,77480,false,L-m-0 C-l-0 C-l-0 L-l-0 
job-1542,1,11,6,77059,94403,94518,17344,115,77343,false,L-m-0 L-l-0 L-l-0 L-m-0 L-l-0 L-l-0 
job-1544,1,12,4,77151,94403,94534,17252,131,77543,false,C-m-0 C-l-0 C-l-0 C-m-0 
job-1545,3,9,7,77210,94403,94557,17193,154,77599,false,C-s-1 C-l-1 C-l-1 C-m-1 C-l-1 C-l-1 C-m-1 
job-1547,4,6,5,77302,94534,94557,17232,23,77611,false,L-l-0 L-l-0 C-l-0 L-s-0 L-l-0 
job-1546,4,10,4,77266,94518,94559,17252,41,77400,false,L-m-0 C-l-0 C-l-0 L-m-0 
job-1548,5,6,8,77341,94557,94600,17216,43,77639,false,C-m-1 C-l-1 C-l-1 C-l-2 C-l-2 L-l-0 C-m-0 L-l-0 
job-1549,3,11,6,77379,94557,94689,17178,132,77758,false,L-s-0 C-l-0 C-m-1 C-m-0 C-s-1 C-s-0 
job-1550,3,5,2,77434,94689,94699,17255,10,77447,false,L-m-0 L-m-0 
job-1551,5,5,1,77491,94689,94737,17198,48,77710,false,L-l-0 
job-1553,1,12,8,77578,94689,94787,17111,98,77867,false,C-l-0 C-l-1 L-l-0 C-l-1 C-l-1 C-l-1 C-l-0 C-l-0 
job-1552,2,6,7,77535,94689,94952,17154,263,77899,false,L-s-0 L-l-0 C-s-2 L-m-0 L-l-0 L-l-0 C-s-2 
job-1554,1,5,2,77627,94952,94964,17325,12,77926,false,L-s-0 L-s-0 
job-1555,4,6,1,77669,94952,95107,17283,155,78049,false,L-m-0 
job-1556,4,9,3,77712,95107,95158,17395,51,77968,false,L-m-0 L-m-0 L-s-0 
job-1557,3,9,3,77788,95107,95222,17319,115,78023,false,L-l-0 L-l-0 L-l-0 
job-1558,3,7,7,77832,95107,95239,17275,132,78175,false,L-l-0 C-l-1 C-l-1 C-m-0 C-l-1 C-m-0 C-l-1 
job-1559,3,5,7,77889,95222,95255,17333,33,78132,false,L-s-0 L-l-0 L-m-0 L-m-0 L-l-0 L-l-0 C-s-1 
job-1560,2,5,3,77934,95222,95640,17288,418,78539,false,C-s-2 C-m-0 L-m-0 
job-1561,6,9,6,77976,95640,95710,17664,70,78195,false,C-m-0 C-l-0 L-l-0 L-m-0 C-l-0 L-l-0 
job-1562,1,12,7,78034,95710,95738,17676,28,78222,false,L-s-0 L-l-0 L-l-0 L-m-0 L-l-0 L-l-0 L-m-0 
job-1563,4,8,5,78081,95710,95817,17629,107,78361,false,L-m-0 C-l-1 C-l-1 C-s-1 C-l-1 
job-1564,1,10,8,78123,95817,95854,17694,37,78215,false,L-m-0 L-l-0 L-l-0 L-l-0 L-l-0 L-m-0 L-s-0 L-m-0 
job-1565,2,7,4,78176,95817,95861,17641,44,78410,false,C-m-2 L-l-0 C-m-2 C-m-2 
job-1568,2,4,7,78325,95861,95924,17536,63,78633,false,L-m-0 C-m-0 L-m-0 C-m-0 C-m-0 L-m-0 C-m-0 
job-1567,2,4,7,78270,95861,96030,17591,169,78551,false,L-l-0 L-l-0 L-l-0 L-s-0 L-l-0 L-l-0 L-l-0 
job-1569,2,9,2,78380,96030,96044,17650,14,78606,false,L-m-0 L-m-0 
job-1566,1,10,1,78219,95861,96063,17642,202,78499,false,L-s-0 
job-1570,4,7,8,78433,96030,96267,17597,237,78957,false,C-s-1 C-l-1 L-l-0 C-l-1 C-l-1 L-l-0 L-l-0 L-m-0 
job-1571,4,5,7,78485,96267,96304,17782,37,78616,false,L-l-0 L-m-0 L-s-0 L-l-0 L-m-0 L-l-0 C-s-1 
job-1572,2,5,1,78521,96267,96693,17746,426,79155,false,C-s-2 
job-1573,5,9,6,78571,96693,96717,18122,24,78713,false,L-m-0 C-l-0 C-l-0 C-m-0 L-l-0 L-l-0 
job-1574,2,11,7,78608,96693,96753,18085,60,78802,false,C-s-2 L-m-0 C-s-1 C-m-0 C-l-0 L-l-0 L-s-0 
job-1575,3,9,6,78648,96693,96828,18045,135,78936,false,C-m-1 C-l-1 C-l-1 C-m-1 C-l-1 C-l-1 
job-1576,3,9,4,78702,96693,96986,17991,293,79033,false,C-l-2 C-l-2 C-l-2 C-l-2 
job-1577,6,9,8,78759,96828,97135,18069,307,79101,false,C-l-0 L-l-0 C-l-1 C-l-0 C-l-1 L-l-0 C-m-0 L-m-0 
job-1579,6,10,7,78855,97135,97149,18280,14,78989,false,L-m-0 C-l-0 C-l-1 C-l-0 C-l-1 L-l-0 L-l-0 
job-1578,3,9,7,78803,96986,97160,18183,174,79106,false,L-s-0 C-l-2 C-l-2 C-m-1 C-l-2 C-l-2 C-m-1 
job-1580,3,8,4,78905,97135,97186,18230,51,78980,false,C-m-0 C-m-2 C-m-2 C-m-0 
job-1583,4,7,5,79042,97149,97205,18107,56,79355,false,C-l-0 C-l-1 C-l-1 C-l-1 C-l-0 
job-1581,4,8,6,78960,97149,97247,18189,98,79291,false,L-m-0 L-l-0 L-l-0 L-m-0 L-l-0 C-s-1 
job-1585,5,7,6,79144,97205,97249,18061,44,79230,false,C-l-1 C-l-0 C-l-0 C-l-2 C-l-1 C-l-2 
job-1582,4,6,2,78999,97149,97259,18150,110,79287,false,C-s-0 C-s-2 
job-1584,5,12,1,79087,97160,97297,18073,137,79295,false,C-m-1 
job-1586,6,11,8,79206,97249,97497,18043,248,79463,false,L-l-0 C-l-0 C-l-1 C-l-1 C-l-0 L-l-0 C-m-0 L-m-0 
job-1587,3,4,6,79267,97497,97540,18230,43,79597,false,L-m-0 L-l-0 L-l-0 L-m-0 L-l-0 L-l-0 
job-1588,3,5,3,79311,97497,97625,18186,128,79499,false,L-s-0 C-m-0 C-m-0 
job-1589,3,5,4,79353,97625,97672,18272,47,79493,false,L-l-0 L-l-0 L-l-0 L-l-0 
job-1590,5,5,8,79418,97625,97693,18207,68,79585,false,C-m-0 C-l-0 C-l-0 C-l-1 C-l-1 C-l-2 C-l-2 L-m-0 
job-1591,5,9,5,79475,97693,97976,18218,283,79842,false,L-l-0 L-l-0 C-l-0 L-m-0 C-l-0 
job-1592,2,11,1,79525,97976,98018,18451,42,79573,false,L-s-0 
job-1593,3,7,4,79582,97976,98080,18394,104,79690,false,L-l-0 L-l-0 L-l-0 L-l-0 
job-1594,2,11,2,79627,98080,98095,18453,15,79761,false,L-m-0 L-m-0 
job-1595,4,11,6,79686,98080,98127,18394,47,79823,false,L-s-0 L-l-0 C-m-2 C-m-2 L-l-0 L-l-0 
job-1596,1,7,6,79741,98080,98134,18339,54,80070,false,C-l-0 C-l-0 L-m-0 C-l-0 C-l-0 C-l-0 
job-1598,4,10,8,79831,98080,98211,18249,131,80210,false,C-s-0 C-l-1 C-l-1 C-s-1 C-m-1 C-l-1 C-s-2 C-m-1 
job-1599,5,8,4,79879,98127,98225,18248,98,79978,false,L-m-0 L-l-0 L-l-0 C-m-2 
job-1597,2,12,7,79781,98080,98228,18299,148,80188,false,C-m-0 C-l-2 C-l-2 C-m-0 C-l-0 C-l-2 C-l-2 
job-1600,4,4,8,79921,98211,98312,18290,101,80253,false,C-s-1 C-l-1 L-s-0 C-l-0 C-l-1 C-l-0 C-l-1 C-m-0 
job-1601,2,10,2,79970,98312,98359,18342,47,80104,false,L-m-0 L-m-0 
job-1602,3,6,4,80023,98312,98382,18289,70,80221,false,L-m-0 L-l-0 L-l-0 L-l-0 
job-1603,2,8,5,80074,98312,98421,18238,109,80250,false,L-s-0 L-l-0 C-s-1 L-s-0 C-s-1 
job-1604,3,4,2,80125,98421,98439,18296,18,80245,false,L-m-0 L-m-0 
job-1605,3,7,8,80166,98421,98441,18255,20,80449,false,L-l-0 C-l-0 C-l-0 C-l-0 C-l-0 L-l-0 L-l-0 L-l-0 
job-1607,1,6,3,80263,98439,98632,18176,193,80650,false,L-m-0 L-m-0 L-m-0 
job-1606,3,8,8,80221,98421,98639,18200,218,80489,false,C-l-1 C-l-2 C-l-1 C-l-2 C-l-2 C-l-1 C-l-2 C-l-1 
job-1610,3,4,3,80433,98632,98661,18199,29,80566,false,L-s-0 C-m-0 C-m-0 
job-1609,5,8,2,80369,98632,98699,18263,67,80697,false,L-l-0 L-l-0 
job-1608,4,5,2,80315,98632,98715,18317,83,80570,false,L-m-0 L-m-0 
job-1612,1,11,7,80538,98699,98754,18161,55,80681,false,L-l-0 L-l-0 C-l-0 C-l-0 C-l-0 L-l-0 C-l-0 
job-1613,6,6,5,80593,98754,98765,18161,11,80845,false,L-l-0 L-l-0 C-l-0 L-m-0 C-l-0 
job-1611,1,10,1,80494,98699,98796,18205,97,80691,false,L-s-0 
job-1614,1,11,4,80637,98754,98805,18117,51,80872,false,L-m-0 L-m-0 C-m-0 C-m-0 
job-1615,5,11,3,80691,98754,98889,18063,135,80983,false,C-l-1 C-l-1 C-m-1 
job-1616,1,9,6,80749,98805,98890,18056,85,80970,false,L-m-0 C-l-1 C-l-1 C-m-1 C-m-1 L-m-0 
job-1617,5,5,2,80804,98805,98918,18001,113,80925,false,L-l-0 L-m-0 
job-1618,3,4,3,80866,98918,98965,18052,47,80946,false,L-l-0 L-l-0 L-l-0 
job-1619,1,12,4,80910,98965,98975,18055,10,80935,false,L-l-0 L-l-0 L-l-0 L-l-0 
job-1621,6,12,2,81002,98965,98975,17963,10,81228,false,C-l-0 C-l-0 
job-1620,4,9,3,80956,98965,98980,18009,15,81168,false,L-s-0 L-m-0 L-m-0 
job-1622,4,10,3,81053,98965,99303,17912,338,81669,false,C-l-1 C-l-1 C-l-1 
job-1624,3,6,3,81153,99303,99356,18150,53,81274,false,L-l-0 L-l-0 L-l-0 
job-1623,2,11,1,81102,99303,99469,18201,166,81564,false,L-s-0 
job-1625,4,8,7,81202,99303,99484,18101,181,81437,false,L-m-0 C-l-1 C-l-1 C-m-0 C-l-1 C-m-0 L-m-0 
job-1626,1,9,3,81264,99469,99524,18205,55,81496,false,L-l-0 L-l-0 L-l-0 
job-1628,4,4,3,81368,99469,99550,18101,81,81487,false,L-l-0 C-m-1 C-m-1 
job-1629,4,10,6,81411,99550,99569,18139,19,81436,false,C-s-0 L-m-0 L-l-0 L-m-0 L-l-0 C-s-2 
job-1627,4,12,5,81326,99469,99574,18143,105,81497,false,L-l-0 C-l-2 C-l-2 L-s-0 C-l-2 
job-1630,2,6,5,81458,99550,99625,18092,75,81670,false,C-l-0 C-l-0 C-l-0 C-l-0 C-l-0 
job-1631,1,11,8,81513,99550,99752,18037,202,81760,false,C-s-1 C-l-0 C-l-1 C-l-1 C-l-1 C-l-1 C-m-0 C-m-0 
job-1632,2,9,8,81563,99752,99827,18189,75,81640,false,L-l-0 L-l-0 L-l-0 L-l-0 L-l-0 L-m-0 L-m-0 L-m-0 
job-1633,5,6,6,81619,99752,99866,18133,114,81853,false,C-l-0 C-l-1 C-l-0 C-l-2 C-l-1 C-l-2 
job-1634,2,9,7,81664,99827,99870,18163,43,81971,false,L-l-0 C-l-2 C-l-1 L-l-0 C-l-0 L-l-0 L-l-0 
job-1636,6,11,3,81771,99827,100015,18056,188,82101,false,C-m-2 C-m-1 C-m-0 
job-1635,2,11,3,81716,99827,100144,18111,317,82135,false,L-m-0 L-m-0 L-l-0 
job-1637,6,9,3,81827,100144,100162,18317,18,82103,false,L-l-0 L-l-0 L-m-0 
job-1638,2,11,7,81891,100144,100543,18253,399,82574,false,L-s-0 C-l-0 C-l-0 C-s-1 C-l-0 C-l-0 L-m-0 
job-1639,6,11,4,81938,100543,100619,18605,76,82095,false,L-m-0 L-l-0 L-l-0 C-m-0 
job-1640,1,11,1,81993,100619,100662,18626,43,82082,false,L-s-0 
job-1641,3,8,3,82036,100662,100672,18626,10,82196,false,L-m-0 L-m-0 L-s-0 
job-1642,3,11,2,82083,100662,100736,18579,74,82354,false,L-l-0 L-l-0 
job-1644,6,12,8,82193,100736,100805,18543,69,82544,false,L-l-0 C-l-1 C-l-2 C-l-2 C-l-1 L-l-0 C-m-0 L-m-0 
job-1645,6,5,2,82240,100736,100932,18496,196,82515,false,C-l-0 C-l-0 
job-1647,5,10,6,82338,100932,100972,18594,40,82558,false,C-m-2 C-l-2 C-l-1 C-m-1 C-l-1 C-l-2 
job-1646,5,6,6,82288,100932,100975,18644,43,82623,false,L-m-0 C-l-0 L-l-0 C-m-0 C-l-0 L-l-0 
job-1643,1,11,1,82141,100736,101024,18595,288,82528,false,L-s-0 
job-1648,1,6,2,82393,100975,101031,18582,56,82659,false,L-m-0 L-m-0 
job-1649,2,4,5,82449,100975,101089,18526,114,82707,false,L-s-0 L-m-0 L-m-0 L-m-0 L-l-0 
job-1651,6,12,5,82553,101089,101153,18536,64,82894,false,C-l-0 C-l-1 C-l-1 L-m-0 C-l-0 
job-1652,2,4,7,82590,101089,101260,18499,171,83046,false,C-m-0 L-m-0 L-s-0 C-m-0 C-m-0 L-l-0 C-m-0 
job-1650,2,11,4,82500,101089,101277,18589,188,82920,false,L-l-0 L-l-0 L-l-0 L-l-0 
job-1653,2,5,6,82644,101089,101401,18445,312,83142,false,C-l-2 L-s-0 C-l-2 C-l-2 C-l-2 C-l-2 
job-1654,5,10,1,82709,101401,101411,18692,10,82979,false,L-m-0 
job-1655,5,11,7,82758,101401,101530,18643,129,82993,false,C-m-0 L-l-0 C-l-0 C-l-1 C-l-1 L-l-0 C-l-0 
job-1656,6,4,6,82807,101530,101542,18723,12,82844,false,C-m-0 C-l-0 L-l-0 L-m-0 C-l-0 L-l-0 
job-1657,2,6,8,82855,101530,101569,18675,39,83020,false,C-m-1 L-s-0 L-s-0 C-m-0 L-m-0 C-m-1 C-m-1 C-m-1 
job-1658,1,9,7,82902,101569,101587,18667,18,83134,false,L-m-0 L-l-0 L-l-0 L-l-0 L-m-0 L-l-0 L-m-0 
job-1660,5,7,4,82999,101569,101722,18570,153,83324,false,C-l-2 C-l-1 C-l-1 C-l-2 
job-1659,1,11,5,82960,101569,101725,18609,156,83152,false,C-l-0 C-l-0 L-l-0 C-l-0 C-l-0 
job-1661,4,6,1,83041,101725,101744,18684,19,83248,false,L-s-0 
job-1662,4,7,8,83090,101725,101840,18635,115,83349,false,L-m-0 C-l-0 L-l-0 C-l-0 C-l-0 L-l-0 L-m-0 L-l-0 
job-1663,5,12,7,83136,101725,101842,18589,117,83448,false,C-m-2 C-l-2 C-l-1 C-m-0 C-l-1 C-l-2 C-m-1 
job-1664,2,11,2,83174,101842,101856,18668,14,83308,false,L-m-0 L-m-0 
job-1665,2,5,6,83219,101842,102170,18623,328,83614,false,L-l-0 L-m-0 L-m-0 L-l-0 L-l-0 L-l-0 
job-1666,4,5,3,83276,102170,102208,18894,38,83316,false,L-l-0 L-l-0 L-l-0 
job-1668,5,6,2,83365,102170,102230,18805,60,83538,false,C-l-2 C-l-2 
job-1667,3,12,3,83334,102170,102231,18836,61,83415,false,L-s-0 L-m-0 L-m-0 
job-1671,3,11,8,83539,102230,102278,18691,48,83806,false,C-m-0 C-l-2 C-l-2 C-s-1 C-l-2 C-l-2 C-s-2 C-m-0 
job-1670,5,10,6,83478,102230,102284,18752,54,83565,false,L-l-0 C-l-0 C-l-0 L-l-0 C-l-1 C-l-1 
job-1672,5,12,4,83591,102278,102295,18687,17,83849,false,L-m-0 C-l-2 C-m-0 C-l-2 
job-1669,2,12,1,83424,102230,102340,18806,110,83653,false,L-l-0 
job-1673,1,10,6,83646,102340,102364,18694,24,83775,false,L-m-0 L-l-0 L-l-0 L-m-0 L-l-0 L-l-0 
job-1674,4,12,4,83691,102340,102499,18649,159,83994,false,C-m-1 L-m-0 L-s-0 C-m-1 
job-1676,5,8,6,83804,102499,102533,18695,34,83945,false,L-m-0 C-l-0 L-l-0 C-m-0 C-l-0 L-l-0 
job-1677,3,4,8,83847,102499,102578,18652,79,83946,false,C-l-1 C-l-1 C-l-1 C-l-1 C-m-0 L-m-0 C-m-1 C-m-1 
job-1678,4,11,4,83898,102578,102603,18680,25,83941,false,L-m-0 L-l-0 L-l-0 L-l-0 
job-1675,3,5,1,83752,102499,102631,18747,132,83949,false,L-s-0 
job-1679,6,12,3,83954,102578,102711,18624,133,84184,false,C-l-1 C-l-1 C-m-0 
job-1680,4,7,2,84010,102711,102741,18701,30,84244,false,L-m-0 L-m-0 
job-1681,1,7,4,84051,102711,102843,18660,132,84217,false,L-l-0 L-l-0 L-l-0 L-l-0 
job-1682,1,9,3,84101,102711,102894,18610,183,84557,false,L-s-0 L-l-0 L-l-0 
job-1683,5,8,7,84148,102711,102946,18563,235,84386,false,C-m-0 C-l-2 C-l-1 C-l-2 C-l-0 C-l-1 C-l-0 
job-1684,2,12,4,84194,102946,103046,18752,100,84349,false,L-l-0 L-l-0 L-l-0 L-l-0 
job-1685,1,4,2,84244,103046,103106,18802,60,84399,false,L-s-0 L-s-0 
job-1686,5,7,3,84288,103046,103118,18758,72,84580,false,L-l-0 L-l-0 L-m-0 
job-1689,5,7,8,84449,103118,103256,18669,138,84819,false,C-m-0 L-l-0 C-l-1 C-l-2 C-l-2 L-l-0 C-l-1 L-m-0 
job-1687,3,12,2,84343,103046,103293,18703,247,84877,false,C-s-1 L-m-0 
job-1688,4,10,4,84398,103046,103524,18648,478,84932,false,C-s-2 C-l-0 C-l-0 C-l-0 
job-1691,5,6,6,84551,103524,103573,18973,49,84717,false,C-m-2 C-l-1 C-l-1 C-m-1 C-l-2 C-l-2 
job-1690,5,5,6,84491,103524,103614,19033,90,84870,false,L-m-0 C-l-0 C-l-0 C-m-0 L-l-0 L-l-0 
job-1692,4,6,6,84603,103573,103692,18970,119,84901,false,C-m-1 C-l-1 C-l-1 L-s-0 C-l-1 C-m-1 
job-1695,6,9,2,84754,103692,103724,18938,32,85005,false,C-l-0 C-l-0 
job-1693,3,7,5,84641,103692,103725,19051,33,84930,false,L-l-0 L-s-0 L-l-0 L-l-0 L-l-0 
job-1694,5,7,2,84706,103692,103755,18986,63,85019,false,L-m-0 C-m-0 
job-1697,5,10,4,84856,103692,103824,18836,132,85069,false,C-m-2 C-l-1 C-l-1 C-m-1 
job-1696,3,5,7,84813,103692,103855,18879,163,85269,false,L-m-0 C-l-2 C-l-2 C-m-0 C-l-2 C-l-2 C-s-1 
job-1698,4,7,4,84900,103724,103928,18824,204,85243,false,C-l-0 C-l-0 C-l-0 C-s-2 
job-1699,2,11,3,84942,103855,103939,18913,84,85231,false,L-l-0 L-l-0 L-l-0 
job-1700,5,11,3,84986,103855,104227,18869,372,85641,false,L-l-0 L-m-0 C-m-0 
job-1701,6,11,2,85042,104227,104284,19185,57,85182,false,L-l-0 L-l-0 
job-1704,5,7,1,85178,104227,104342,19049,115,85473,false,C-m-1 
job-1703,3,8,8,85130,104227,104370,19097,143,85448,false,C-m-0 C-l-1 C-l-1 C-l-1 C-l-1 L-m-0 C-m-0 L-m-0 
job-1705,2,9,7,85229,104227,104466,18998,239,85655,false,C-m-0 C-l-0 C-l-0 L-m-0 C-l-0 C-l-0 C-m-1 
job-1702,3,5,1,85087,104227,104513,19140,286,85466,false,L-s-0 
job-1706,6,5,4,85274,104284,104851,19010,567,86052,false,L-l-0 C-l-2 C-l-2 L-l-0 
job-1707,1,9,2,85344,104851,104869,19507,18,85539,false,L-m-0 L-m-0 
job-1709,2,6,7,85433,104869,104960,19436,91,85775,false,L-l-0 L-l-0 L-l-0 L-l-0 L-l-0 L-l-0 L-m-0 
job-1711,1,8,1,85548,104869,104962,19321,93,85934,false,C-s-1 
job-1710,1,9,5,85487,104869,104985,19382,116,85898,false,C-m-0 L-m-0 L-s-0 C-m-0 C-m-0 
job-1712,3,4,7,85602,104960,104994,19358,34,85816,false,L-l-0 L-l-0 L-s-0 C-m-0 L-l-0 C-s-1 L-l-0 
job-1713,3,4,3,85649,104960,105006,19311,46,85987,false,C-l-0 C-l-0 C-l-0 
job-1708,5,8,1,85398,104869,105020,19471,151,85599,false,L-m-0 
job-1714,5,5,8,85686,104994,105037,19308,43,86022,false,C-m-0 L-l-0 C-l-2 C-l-2 C-l-1 L-l-0 C-l-1 C-m-1 
job-1715,1,11,7,85732,105037,105215,19305,178,86080,false,L-m-0 L-l-0 L-l-0 L-s-0 L-l-0 L-l-0 L-m-0 
job-1716,5,6,1,85786,105215,105233,19429,18,85844,false,L-m-0 
job-1717,4,4,1,85839,105215,105480,19376,265,86298,false,L-s-0 
job-1719,1,9,4,85949,105480,105559,19531,79,86046,false,L-l-0 L-l-0 L-l-0 L-l-0 
job-1718,1,11,1,85884,105480,105560,19596,80,86175,false,L-s-0 
job-1721,4,5,4,86044,105559,105752,19515,193,86362,false,C-l-1 C-l-1 L-l-0 C-l-1 
job-1720,5,12,4,85992,105480,105876,19488,396,86509,false,C-l-0 L-l-0 C-l-0 L-m-0 
job-1723,6,12,1,86139,105876,105891,19737,15,86354,false,C-m-1 
job-1722,6,9,7,86088,105876,105895,19788,19,86193,false,L-m-0 C-l-0 C-l-1 L-l-0 C-l-0 C-l-1 L-l-0 
job-1724,2,10,6,86197,105876,105933,19679,57,86368,false,C-m-0 L-m-0 C-m-1 C-m-0 C-m-0 L-s-0 
job-1725,5,10,4,86244,105891,105940,19647,49,86336,false,C-m-1 C-l-2 C-l-2 C-m-2 
job-1726,4,7,2,86296,105891,106093,19595,202,86780,false,C-s-2 C-s-1 
job-1727,1,7,2,86344,106093,106129,19749,36,86671,false,L-s-0 L-s-0 
job-1729,6,9,6,86432,106093,106130,19661,37,86683,false,L-m-0 C-l-1 C-l-0 C-m-0 C-l-0 C-l-1 
job-1728,3,10,3,86388,106093,106167,19705,74,86706,false,L-l-0 L-l-0 L-l-0 
job-1731,4,8,8,86554,106167,106250,19613,83,86872,false,L-m-0 L-l-0 C-l-0 C-l-0 C-l-0 L-m-0 L-l-0 L-l-0 
job-1732,2,9,6,86608,106167,106268,19559,101,86932,false,C-m-0 C-m-1 C-m-0 C-m-1 C-m-0 C-m-1 
job-1730,3,8,1,86490,106167,106288,19677,121,86681,false,L-s-0 
job-1733,3,10,5,86644,106167,106301,19523,134,86795,false,C-s-2 C-l-1 C-l-1 C-l-1 C-l-1 
job-1734,5,8,1,86707,106288,106318,19581,30,87007,false,L-m-0 
job-1735,2,6,5,86745,106288,106325,19543,37,86952,false,L-l-0 L-l-0 L-l-0 L-m-0 L-l-0 
job-1736,6,4,4,86804,106288,106498,19484,210,87290,false,C-l-2 C-l-0 C-l-0 C-l-2 
job-1737,1,9,7,86855,106498,106568,19643,70,86996,false,L-m-0 L-l-0 L-l-0 L-l-0 L-m-0 L-l-0 L-m-0 
job-1738,4,9,1,86892,106568,106584,19676,16,87163,false,L-s-0 
job-1740,5,4,5,86987,106568,106604,19581,36,87182,false,C-m-0 C-l-1 C-l-1 C-l-0 C-l-0 
job-1739,2,4,7,86947,106568,106720,19621,152,87242,false,L-l-0 L-m-0 L-l-0 L-l-0 L-l-0 L-m-0 L-l-0 
job-1741,4,8,4,87035,106568,106734,19533,166,87414,false,L-m-0 C-l-2 C-l-2 C-l-2 
job-1742,6,9,3,87083,106604,106797,19521,193,87519,false,C-l-0 C-l-0 C-m-0 
job-1743,2,10,7,87119,106797,106811,19678,14,87241,false,L-m-0 L-l-0 L-l-0 L-m-0 L-l-0 L-l-0 L-m-0 
job-1744,5,11,3,87166,106797,106839,19631,42,87390,false,C-m-0 C-l-0 C-l-0 
job-1745,3,11,3,87219,106839,106857,19620,18,87380,false,L-m-0 L-m-0 L-s-0 
job-1747,5,8,1,87316,106839,106862,19523,23,87499,false,C-m-0 
job-1746,4,6,4,87269,106839,106889,19570,50,87387,false,L-l-0 L-l-0 L-l-0 C-s-1 
job-1748,5,9,6,87370,106839,106897,19469,58,87559,false,C-l-2 C-l-1 C-l-0 C-l-2 C-l-1 C-l-0 
job-1749,5,10,2,87420,106839,107114,19419,275,87863,false,C-m-2 C-m-1 
job-1752,2,8,8,87576,107114,107169,19538,55,87728,false,C-l-0 C-l-0 C-s-2 C-l-0 C-l-0 C-l-0 C-s-2 C-l-0 
job-1753,1,5,7,87628,107169,107197,19541,28,87892,false,C-s-0 C-m-0 C-s-0 C-s-2 C-s-2 C-s-2 L-m-0 
job-1750,5,8,4,87473,107114,107202,19641,88,87857,false,L-m-0 L-l-0 L-l-0 C-m-0 
job-1751,2,8,7,87522,107114,107206,19592,92,87854,false,L-m-0 C-s-1 L-s-0 C-m-0 L-l-0 C-s-1 L-s-0 
job-1755,5,11,8,87727,107206,107232,19479,26,87759,false,C-m-0 L-l-0 C-l-0 C-l-1 C-l-1 L-l-0 C-l-0 L-m-0 
job-1754,4,6,4,87674,107169,107285,19495,116,87848,false,C-m-1 C-m-2 C-m-2 C-m-1 
job-1756,1,11,6,87774,107285,107301,19511,16,87837,false,L-m-0 L-l-0 L-l-0 L-m-0 L-l-0 L-l-0 
job-1757,1,11,2,87827,107285,107319,19458,34,87973,false,L-s-0 C-s-1 
job-1760,5,8,4,87981,107301,107443,19320,142,88417,false,C-l-2 L-l-0 L-l-0 C-l-2 
job-1758,4,6,6,87875,107285,107453,19410,168,88136,false,L-m-0 C-l-0 C-l-0 C-m-0 C-l-0 C-m-0 
job-1761,6,11,6,88026,107453,107492,19427,39,88274,false,L-m-0 C-l-0 L-l-0 C-m-0 C-l-0 L-l-0 
job-1759,5,11,3,87923,107285,107504,19362,219,88278,false,C-m-1 C-l-1 C-l-1 
job-1762,4,6,6,88072,107453,107550,19381,97,88184,false,L-s-0 C-l-2 C-m-2 C-m-2 C-l-2 C-l-2 
job-1763,4,7,7,88123,107492,107559,19369,67,88331,false,L-m-0 L-l-0 C-m-0 C-m-0 L-l-0 L-l-0 L-m-0 
job-1764,6,9,6,88171,107550,107635,19379,85,88481,false,C-l-0 C-l-0 C-l-1 C-l-2 C-l-2 C-l-1 
job-1766,6,4,7,88266,107635,107649,19369,14,88351,false,L-l-0 C-l-1 C-l-0 L-l-0 C-l-1 C-l-0 L-m-0 
job-1767,3,7,2,88322,107635,107677,19313,42,88643,false,C-m-0 C-m-0 
job-1768,3,5,7,88372,107635,107678,19263,43,88631,false,C-s-1 C-l-2 C-l-2 C-m-1 C-l-2 C-l-2 C-m-1 
job-1769,4,4,5,88411,107677,107691,19266,14,88610,false,L-m-0 L-l-0 L-l-0 L-m-0 L-l-0 
job-1765,2,7,1,88219,107635,107699,19416,64,88477,false,L-s-0 
job-1770,4,6,3,88469,107677,107718,19208,41,88761,false,C-l-0 C-l-0 C-l-0 
job-1771,4,10,6,88519,107718,107730,19199,12,88619,false,L-m-0 L-s-0 L-l-0 L-l-0 L-m-0 L-l-0 
job-1772,2,5,6,88578,107718,108102,19140,384,89170,false,C-l-0 C-l-0 C-l-0 C-l-0 C-l-0 C-l-0 
job-1773,2,12,8,88623,108102,108114,19479,12,88837,false,L-m-0 L-s-0 L-l-0 L-l-0 L-l-0 L-l-0 C-s-1 L-m-0 
job-1774,3,11,2,88661,108102,108168,19441,66,88812,false,C-m-0 C-m-0 
job-1776,1,6,4,88754,108114,108171,19360,57,89014,false,L-s-0 C-m-1 C-m-1 C-m-0 
job-1775,6,12,1,88700,108102,108172,19402,70,88798,false,C-m-1 
job-1777,6,11,7,88794,108114,108182,19320,68,88996,false,L-m-0 C-l-1 C-l-0 C-l-0 C-l-1 L-l-0 L-l-0 
job-1778,4,12,5,88843,108168,108209,19325,41,89012,false,C-s-1 C-l-2 C-l-2 C-m-0 C-l-2 
job-1779,1,4,2,88912,108209,108256,19297,47,89008,false,L-s-0 L-s-0 
job-1780,4,11,3,88958,108209,108466,19251,257,89468,false,L-l-0 L-l-0 L-l-0 
job-1783,3,9,3,89121,108466,108509,19345,43,89401,false,L-m-0 C-s-2 L-m-0 
job-1782,6,6,2,89069,108466,108527,19397,61,89337,false,L-l-0 L-l-0 
job-1785,5,11,8,89224,108509,108555,19285,46,89344,false,C-m-2 C-l-1 C-l-2 C-l-2 C-l-1 C-m-1 C-m-0 L-m-0 
job-1781,2,7,2,89011,108466,108579,19455,113,89220,false,L-s-0 L-s-0 
job-1786,3,6,6,89284,108579,108652,19295,73,89522,false,L-s-0 L-l-0 L-l-0 L-l-0 C-l-0 L-l-0 
job-1784,3,7,3,89167,108466,108653,19299,187,89490,false,C-l-0 C-l-0 C-l-0 
job-1788,6,5,3,89397,108579,108729,19182,150,89585,false,C-m-0 C-l-2 C-l-2 
job-1787,3,4,5,89338,108579,108797,19241,218,89670,false,L-m-0 C-l-1 C-l-1 L-m-0 C-l-1 
job-1791,5,6,7,89553,108797,108863,19244,66,89703,false,L-m-0 C-l-1 C-l-2 C-l-0 C-l-1 C-l-2 C-l-0 
job-1789,1,7,3,89450,108797,108917,19347,120,89673,false,L-m-0 L-m-0 L-m-0 
job-1790,4,12,8,89501,108797,108943,19296,146,89917,false,L-s-0 L-l-0 L-l-0 C-s-2 C-m-1 L-l-0 C-s-0 C-m-1 
job-1792,1,6,1,89598,108917,109051,19319,134,89898,false,L-m-0 
job-1793,1,6,7,89652,108917,109456,19265,539,90437,false,L-m-0 L-m-0 L-m-0 C-m-0 C-m-0 L-m-0 C-m-0 
job-1796,4,12,5,89805,109456,109488,19651,32,90115,false,C-m-0 C-l-1 C-l-1 C-m-0 C-l-1 
job-1794,2,8,7,89710,109456,109518,19746,62,89911,false,L-l-0 L-l-0 L-s-0 L-l-0 L-l-0 L-s-0 L-l-0 
job-1795,3,11,2,89753,109456,109573,19703,117,90059,false,L-m-0 L-m-0 
job-1798,2,12,8,89911,109456,109607,19545,151,90264,false,C-s-2 C-l-2 C-l-2 C-l-2 C-l-2 C-m-2 C-s-1 C-m-2 
job-1797,1,10,8,89859,109456,109739,19597,283,90399,false,L-m-0 C-l-0 C-l-0 C-m-1 C-l-0 C-m-1 C-l-0 C-m-1 
job-1799,6,6,5,89958,109739,109813,19781,74,90155,false,L-m-0 C-l-0 L-l-0 L-l-0 C-l-0 
job-1800,4,7,7,90005,109739,109914,19734,175,90206,false,L-s-0 C-l-1 C-l-1 C-l-2 C-l-1 C-l-2 C-l-2 
job-1801,3,10,2,90046,109914,109935,19868,21,90069,false,L-m-0 L-m-0 
job-1802,3,4,7,90102,109914,109939,19812,25,90335,false,L-s-0 L-l-0 L-l-0 C-m-0 L-l-0 L-l-0 C-m-0 
job-1803,4,10,4,90153,109914,110050,19761,136,90293,false,C-l-0 C-l-0 C-l-0 C-s-1 
job-1804,1,9,6,90192,109914,110266,19722,352,90814,false,L-m-0 C-m-0 C-m-0 L-s-0 C-m-1 C-m-1 
job-1805,3,10,6,90237,110266,110311,20029,45,90543,false,L-m-0 L-l-0 L-l-0 L-l-0 L-m-0 L-l-0 
job-1806,5,6,1,90297,110266,110326,19969,60,90378,false,C-m-0 
job-1807,3,8,7,90355,110311,110328,19956,17,90616,false,L-m-0 L-l-0 C-m-0 L-l-0 L-l-0 L-l-0 L-m-0 
job-1808,6,5,6,90404,110311,110489,19907,178,90641,false,C-l-0 C-l-0 C-l-2 C-l-1 C-l-2 C-l-1 
job-1810,6,12,8,90505,110489,110519,19984,30,90623,false,C-l-0 C-l-0 C-l-1 C-l-2 C-l-1 C-m-0 C-l-2 L-m-0 
job-1809,1,9,6,90450,110489,110546,20039,57,90673,false,L-s-0 L-l-0 L-l-0 L-l-0 L-l-0 L-l-0 
job-1811,6,11,7,90564,110519,110619,19955,100,90712,false,L-m-0 C-l-1 C-l-0 C-l-2 C-l-1 C-l-2 C-l-0 
job-1812,1,7,2,90618,110619,110861,20001,242,91097,false,L-s-0 L-s-0 
job-1813,4,4,4,90667,110861,110874,20194,13,90822,false,L-l-0 L-l-0 L-s-0 L-l-0 
job-1814,6,12,6,90714,110861,110985,20147,124,91064,false,L-m-0 C-l-2 C-l-0 C-m-0 C-l-0 C-l-2 
job-1815,4,6,5,90748,110985,111006,20237,21,90909,false,L-m-0 L-l-0 L-l-0 L-l-0 L-m-0 
job-1816,3,8,4,90805,110985,111035,20180,50,91096,false,C-l-0 C-l-0 C-l-0 C-l-0 
job-1818,2,12,8,90909,111035,111051,20126,16,91015,false,C-m-0 L-l-0 L-l-0 L-l-0 L-l-0 L-m-0 C-m-0 L-m-0 
job-1817,1,5,3,90855,110985,111111,20130,126,91147,false,L-s-0 L-s-0 L-s-0 
job-1819,3,9,5,90953,111035,111131,20082,96,91174,false,C-l-2 C-l-2 C-l-2 C-s-1 C-l-2 
job-1820,1,11,5,91002,111035,111186,20033,151,91205,false,C-s-2 C-l-0 C-l-0 C-l-0 C-l-0 
job-1821,6,5,4,91069,111035,111489,19966,454,91549,false,C-m-2 C-l-1 C-l-1 C-m-1 
job-1822,1,10,2,91120,111489,111526,20369,37,91175,false,L-m-0 L-m-0 
job-1823,6,8,5,91158,111489,111599,20331,110,91471,false,L-l-0 C-l-0 L-m-0 L-l-0 C-l-0 
job-1824,6,8,7,91208,111489,111657,20281,168,91545,false,C-m-2 C-l-1 C-l-2 C-m-1 C-l-1 C-l-2 C-m-0 
job-1826,1,11,8,91304,111657,111714,20353,57,91383,false,L-m-0 C-l-0 C-s-1 L-l-0 C-l-0 L-l-0 L-s-0 L-m-0 
job-1827,3,9,7,91367,111657,111714,20290,57,91659,false,C-s-2 C-l-1 C-l-1 C-m-0 C-l-1 C-l-1 C-m-0 
job-1825,5,9,5,91262,111599,111721,20337,122,91674,false,C-l-0 L-l-0 C-l-0 L-m-0 L-l-0 
job-1828,3,6,4,91398,111714,111731,20316,17,91449,false,L-s-0 C-m-1 C-m-1 L-m-0 
job-1829,6,8,4,91445,111714,111886,20269,172,91820,false,C-l-1 C-l-2 C-l-1 C-l-2 
job-1830,4,4,7,91505,111714,111918,20209,204,91812,false,C-s-2 C-m-2 C-m-0 C-s-1 C-m-0 C-s-0 C-m-2 
job-1833,5,8,6,91629,111886,111960,20257,74,91945,false,C-l-0 C-l-2 C-l-0 C-l-1 C-l-2 C-l-1 
job-1832,3,6,6,91584,111886,111991,20302,105,91879,false,L-m-0 L-l-0 L-l-0 L-l-0 L-l-0 L-m-0 
job-1831,2,5,1,91554,111886,112032,20332,146,91817,false,L-s-0 
job-1834,1,10,2,91679,111991,112092,20312,101,91928,false,L-s-0 L-m-0 
job-1835,2,10,4,91723,112092,112116,20369,24,91941,false,L-l-0 L-l-0 L-l-0 L-l-0 
job-1836,3,11,6,91767,112092,112160,20325,68,92022,false,L-m-0 C-l-2 C-l-2 L-m-0 C-l-2 C-l-2 
job-1837,2,10,1,91812,112160,112256,20348,96,92038,false,L-s-0 
job-1838,4,10,1,91860,112256,112273,20396,17,91877,false,L-s-0 
job-1839,2,9,6,91900,112256,112295,20356,39,91969,false,L-m-0 L-l-0 L-l-0 L-l-0 L-l-0 L-l-0 
job-1840,2,10,2,91943,112295,112420,20352,125,92220,false,L-m-0 L-m-0 
job-1841,3,10,5,91994,112295,112432,20301,137,92381,false,L-m-0 L-l-0 L-l-0 L-l-0 L-l-0 
job-1842,2,6,1,92040,112432,112449,20392,17,92267,false,L-s-0 
job-1843,2,10,7,92082,112432,112590,20350,158,92498,false,L-l-0 L-s-0 L-l-0 L-m-0 L-l-0 L-l-0 L-m-0 
job-1844,4,10,3,92123,112590,112607,20467,17,92324,false,L-m-0 L-m-0 L-s-0 
job-1846,4,12,7,92224,112590,112608,20366,18,92332,false,L-l-0 C-l-1 C-l-0 C-l-1 C-l-0 C-l-1 C-l-0 
job-1845,4,9,2,92176,112590,112620,20414,30,92305,false,L-l-0 L-l-0 
job-1847,4,10,2,92268,112590,112656,20322,66,92403,false,C-m-0 C-m-0 
job-1848,1,5,4,92314,112590,112735,20276,145,92643,false,C-s-1 C-s-2 C-s-2 C-s-2 
job-1849,4,10,5,92376,112735,112754,20359,19,92656,false,L-m-0 L-l-0 L-l-0 L-l-0 L-m-0 
job-1850,2,9,4,92427,112735,112761,20308,26,92706,false,C-m-2 C-m-2 L-s-0 C-m-2 
job-1851,4,6,1,92488,112735,112914,20247,179,92761,false,C-s-1 
job-1852,5,11,4,92535,112735,112935,20200,200,93023,false,C-l-2 C-l-0 C-l-0 C-l-2 
job-1854,2,4,8,92631,112914,112960,20283,46,92801,false,L-l-0 L-l-0 C-l-0 C-l-2 L-l-0 L-l-0 L-l-0 L-l-0 
job-1853,4,4,2,92589,112914,112977,20325,63,92906,false,L-m-0 L-m-0 
job-1855,5,10,8,92665,112935,113019,20270,84,92801,false,C-l-0 C-l-1 C-l-0 C-l-2 C-l-1 C-l-2 C-m-1 C-m-0 
job-1856,2,8,8,92708,112935,113102,20227,167,93033,false,C-m-2 L-s-0 C-l-1 L-s-0 C-m-1 C-m-2 C-m-2 C-m-0 
job-1857,1,9,3,92759,113102,113143,20343,41,92981,false,L-m-0 L-m-0 L-m-0 
job-1860,4,8,4,92895,113102,113148,20207,46,92969,false,C-l-2 C-l-2 C-l-2 C-s-1 
job-1858,3,10,2,92804,113102,113244,20298,142,92969,false,L-l-0 L-l-0 
job-1859,2,8,4,92851,113102,113316,20251,214,93337,false,L-s-0 L-l-0 L-l-0 L-l-0 
job-1862,4,8,7,92991,113316,113353,20325,37,93291,false,L-m-0 L-l-0 L-l-0 C-m-0 L-m-0 L-l-0 C-m-0 
job-1863,4,4,4,93034,113353,113367,20319,14,93061,false,L-m-0 L-m-0 L-l-0 L-l-0 
job-1861,2,8,2,92950,113316,113375,20366,59,93140,false,L-s-0 L-s-0 
job-1865,5,11,2,93147,113353,113409,20206,56,93467,false,C-l-0 C-l-0 
job-1864,3,4,3,93094,113353,113442,20259,89,93260,false,C-m-0 L-l-0 C-m-0 
job-1866,5,11,2,93181,113353,113500,20172,147,93539,false,C-l-1 C-l-1 
job-1867,5,9,4,93228,113353,113776,20125,423,93766,false,C-m-2 C-l-2 C-l-2 C-m-1 
job-1868,5,9,6,93284,113776,113809,20492,33,93460,false,L-m-0 C-l-0 C-l-0 C-m-0 L-l-0 L-l-0 
job-1869,4,8,1,93334,113809,113838,20475,29,93445,false,L-s-0 
job-1871,6,10,6,93432,113809,113876,20377,67,93649,false,C-l-0 C-l-1 L-l-0 C-l-0 C-l-1 L-l-0 
job-1872,3,8,7,93483,113809,113976,20326,167,93699,false,L-m-0 C-l-2 C-l-2 C-m-2 C-l-2 C-l-2 C-m-2 
job-1870,2,10,2,93383,113809,114010,20426,201,93622,false,L-m-0 L-m-0 
job-1873,2,9,8,93529,113809,114042,20280,233,93957,false,C-m-0 C-m-2 C-m-0 C-m-0 C-m-1 C-m-1 C-s-1 C-m-1 
job-1874,2,5,3,93578,114042,114061,20464,19,93619,false,L-m-0 L-m-0 L-m-0 
job-1875,4,9,6,93636,114042,114094,20406,52,93690,false,L-s-0 L-l-0 C-m-0 C-m-0 L-l-0 L-l-0 
job-1877,5,12,6,93722,114042,114135,20320,93,94050,false,C-l-2 C-l-1 C-l-0 C-l-2 C-l-1 C-l-0 
job-1876,1,10,7,93683,114042,114242,20359,200,94076,false,C-m-1 L-m-0 C-m-1 C-m-2 C-m-2 C-m-2 C-m-1 
job-1878,1,8,2,93768,114242,114310,20474,68,93965,false,L-s-0 L-s-0 
job-1879,5,10,8,93815,114242,114314,20427,72,94072,false,C-m-0 C-l-1 C-l-0 L-l-0 C-l-1 L-l-0 C-l-0 L-m-0 
job-1881,6,5,4,93910,114314,114328,20404,14,94087,false,L-l-0 C-l-0 C-l-0 L-l-0 
job-1880,2,4,4,93858,114314,114330,20456,16,94156,false,L-m-0 L-m-0 L-m-0 L-m-0 
job-1882,6,5,4,93963,114314,114364,20351,50,94252,false,C-l-1 C-l-2 C-l-1 C-l-2 
job-1883,5,12,3,94014,114314,114770,20300,456,94652,false,C-m-2 C-m-1 C-m-0 
job-1884,2,7,3,94061,114770,114791,20709,21,94125,false,L-m-0 L-m-0 L-m-0 
job-1885,2,9,6,94108,114770,114793,20662,23,94308,false,L-l-0 L-l-0 L-m-0 L-l-0 L-l-0 L-l-0 
job-1887,3,9,6,94206,114770,114823,20564,53,94482,false,C-m-0 C-l-2 C-l-2 C-m-0 C-l-2 C-l-2 
job-1886,4,5,4,94145,114770,114873,20625,103,94321,false,L-s-0 C-l-0 C-l-0 C-l-0 
job-1888,2,9,2,94250,114770,114881,20520,111,94570,false,C-s-1 C-m-0 
job-1889,3,12,7,94306,114873,114884,20567,11,94499,false,L-m-0 L-l-0 L-l-0 C-m-0 L-l-0 L-l-0 L-m-0 
job-1890,3,4,7,94347,114873,114909,20526,36,94393,false,C-s-2 C-l-0 C-l-0 L-s-0 C-l-0 C-l-0 C-m-0 
job-1892,5,5,4,94450,114873,114966,20423,93,94691,false,C-m-2 C-l-2 C-l-2 C-m-1 
job-1891,3,7,3,94403,114873,114972,20470,99,94513,false,C-l-1 C-l-1 C-l-1 
job-1893,3,9,6,94503,114884,114992,20381,108,94649,false,C-m-0 L-m-0 C-m-2 C-m-1 C-l-1 L-m-0 
job-1894,5,5,4,94560,114909,115009,20349,100,94849,false,C-m-0 L-l-0 L-l-0 C-l-0 
job-1895,1,12,1,94608,115009,115077,20401,68,94973,false,L-s-0 
job-1896,6,9,6,94661,115009,115080,20348,71,94882,false,L-m-0 C-l-1 L-l-0 C-m-0 C-l-1 L-l-0 
job-1897,6,10,3,94714,115009,115099,20295,90,95065,false,C-m-1 C-l-0 C-l-0 
job-1898,5,12,8,94767,115080,115181,20313,101,95112,false,C-m-0 L-l-0 C-l-1 C-l-2 C-l-1 L-l-0 C-l-2 L-m-0 
job-1901,6,6,4,94937,115181,115202,20244,21,95186,false,C-l-0 C-l-0 C-l-1 C-l-1 
job-1899,3,4,1,94834,115181,115212,20347,31,95143,false,L-s-0 
job-1900,4,7,5,94884,115181,115221,20297,40,95101,false,L-l-0 L-l-0 L-m-0 L-m-0 L-l-0 
job-1902,6,6,8,94980,115202,115285,20222,83,95249,false,C-l-0 C-l-2 C-l-1 C-l-2 C-l-0 C-m-1 C-l-1 C-m-0 
job-1903,6,4,5,95027,115285,115512,20258,227,95359,false,L-m-0 C-l-0 L-l-0 L-l-0 C-l-0 
job-1904,4,8,5,95076,115285,115520,20209,235,95603,false,L-s-0 C-l-2 C-l-2 C-s-1 C-l-2 
job-1905,2,8,6,95128,115512,115528,20384,16,95300,false,L-l-0 L-l-0 L-l-0 L-l-0 L-l-0 L-l-0 
job-1906,1,7,1,95181,115512,115533,20331,21,95351,false,L-m-0 
job-1907,5,9,7,95230,115512,115591,20282,79,95498,false,L-m-0 C-l-1 C-l-0 C-m-1 C-l-1 C-l-0 C-m-0 
job-1908,1,9,3,95272,115591,115690,20319,99,95548,false,L-m-0 L-m-0 L-m-0 
job-1909,1,5,5,95323,115690,115707,20367,17,95525,false,L-m-0 L-m-0 L-m-0 L-m-0 L-m-0 
job-1910,6,6,6,95364,115690,115745,20326,55,95694,false,C-l-0 L-l-0 C-l-1 C-l-1 C-l-0 L-l-0 
job-1911,2,11,7,95410,115745,115764,20335,19,95505,false,L-m-0 L-l-0 L-l-0 L-s-0 L-l-0 L-l-0 L-m-0 
job-1912,6,8,7,95461,115745,116026,20284,281,95749,false,C-l-1 C-l-0 C-l-1 C-l-2 C-l-0 C-l-2 C-m-0 
job-1913,6,12,4,95510,116026,116040,20516,14,95762,false,L-m-0 L-l-0 L-l-0 C-m-0 
job-1914,3,7,5,95550,116026,116087,20476,61,95678,false,L-s-0 C-l-0 C-l-0 C-l-0 C-l-0 
job-1915,1,10,7,95606,116087,116113,20481,26,95881,false,L-m-0 L-l-0 L-l-0 L-m-0 L-l-0 L-l-0 L-m-0 
job-1916,1,9,7,95652,116087,116500,20435,413,96297,false,L-s-0 C-l-0 C-l-0 C-s-1 C-l-0 C-l-0 C-l-0 
job-1917,2,4,8,95706,116500,116600,20794,100,95945,false,L-s-0 L-l-0 L-l-0 L-l-0 L-l-0 L-s-0 L-l-0 L-l-0 
job-1918,4,8,4,95753,116500,116674,20747,174,96103,false,C-m-0 L-m-0 L-m-0 C-m-0 
job-1919,1,5,1,95807,116600,116705,20793,105,96206,false,L-s-0 
job-1921,2,12,2,95912,116674,116714,20762,40,96229,false,L-m-0 L-l-0 
job-1920,3,9,2,95853,116674,116719,20821,45,96042,false,L-s-0 L-m-0 
job-1923,6,9,8,96015,116714,116739,20699,25,96137,false,C-m-0 L-l-0 C-l-0 C-l-2 C-l-1 C-l-1 C-l-0 C-l-2 
job-1922,1,9,4,95973,116714,116824,20741,110,96363,false,L-l-0 L-m-0 L-l-0 L-m-0 
job-1924,1,9,8,96071,116824,116836,20753,12,96194,false,L-m-0 L-l-0 L-l-0 L-l-0 L-l-0 L-m-0 L-l-0 L-m-0 
job-1925,5,11,3,96124,116824,116974,20700,150,96389,false,C-m-0 C-l-0 C-l-0 
job-1926,2,9,6,96170,116824,116977,20654,153,96605,false,L-s-0 C-m-1 C-l-0 C-m-0 C-m-1 C-m-1 
job-1927,1,9,6,96215,116977,117025,20762,48,96449,false,L-s-0 L-l-0 L-l-0 L-l-0 L-l-0 L-l-0 
job-1928,2,7,3,96259,116977,117071,20718,94,96555,false,L-m-0 L-m-0 L-s-0 
job-1929,4,7,1,96315,117071,117121,20756,50,96369,false,L-s-0 
job-1930,2,5,6,96368,117071,117270,20703,199,96719,false,L-l-0 L-l-0 L-l-0 L-l-0 L-l-0 L-l-0 
job-1932,5,8,6,96468,117071,117478,20603,407,96937,false,C-l-1 C-l-1 C-l-0 C-l-2 C-l-0 C-l-2 
job-1931,5,6,2,96417,117071,117630,20654,559,97115,false,L-m-0 C-m-0 
job-1934,6,8,6,96576,117630,117750,21054,120,96700,false,L-m-0 L-l-0 C-l-1 C-m-0 C-l-1 L-l-0 
job-1936,2,8,4,96672,117750,117781,21078,31,96884,false,L-m-0 C-s-2 C-s-1 C-s-2 
job-1935,2,9,7,96624,117750,117806,21126,56,96794,false,L-m-0 L-l-0 L-l-0 L-m-0 L-l-0 L-l-0 L-l-0 
job-1933,3,7,1,96522,117630,117906,21108,276,96955,false,L-s-0 
job-1938,1,12,4,96777,117750,117965,20973,215,97014,false,C-l-0 C-l-0 C-l-0 C-l-0 
job-1939,6,8,6,96815,117965,117983,21150,18,96923,false,L-m-0 C-l-0 L-l-0 C-m-2 C-l-0 L-l-0 
job-1937,2,10,6,96716,117750,117990,21034,240,97238,false,C-m-0 C-m-1 C-m-0 C-m-1 C-m-1 C-m-0 
job-1940,3,11,1,96867,117965,118009,21098,44,97142,false,L-s-0 
job-1943,4,11,7,97014,117983,118032,20969,49,97268,false,C-s-2 L-l-0 C-s-0 C-m-2 L-l-0 L-l-0 L-m-0 
job-1941,2,5,3,96920,117965,118033,21045,68,97245,false,C-s-1 C-m-2 L-m-0 
job-1942,4,9,6,96966,117965,118037,20999,72,97173,false,C-l-1 C-l-2 C-l-1 C-l-1 C-l-2 C-l-2 
job-1944,6,11,3,97080,117990,118127,20910,137,97335,false,C-l-0 C-m-0 C-l-0 
job-1945,6,8,3,97126,118127,118139,21001,12,97243,false,L-l-0 L-l-0 L-m-0 
job-1947,5,7,2,97222,118127,118180,20905,53,97468,false,C-l-0 C-l-0 
job-1948,2,12,4,97269,118127,118260,20858,133,97462,false,C-m-0 L-m-0 C-l-0 C-m-0 
job-1949,3,10,2,97313,118260,118295,20947,35,97535,false,L-m-0 L-m-0 
job-1950,5,9,2,97372,118260,118308,20888,48,97606,false,L-l-0 L-l-0 
job-1946,4,7,1,97176,118127,118323,20951,196,97378,false,L-s-0 
job-1952,6,10,1,97472,118260,118429,20788,169,97681,false,C-m-1 
job-1951,4,12,5,97414,118260,118458,20846,198,97622,false,C-m-0 C-l-0 C-l-0 C-m-0 C-l-0 
job-1953,4,5,8,97511,118429,118460,20918,31,97609,false,L-s-0 L-m-0 L-l-0 L-l-0 L-m-0 C-m-1 L-l-0 C-m-1 
job-1954,3,12,6,97575,118429,118465,20854,36,97728,false,C-s-2 C-l-1 C-l-1 C-s-1 C-l-1 C-l-1 
job-1955,3,5,5,97631,118429,118501,20798,72,97737,false,C-l-2 C-l-2 C-l-2 C-s-0 C-l-2 
job-1956,4,9,4,97680,118501,118512,20821,11,97968,false,L-l-0 L-l-0 L-s-0 L-l-0 
job-1957,5,12,8,97731,118501,118789,20770,288,98158,false,C-m-0 C-l-1 C-l-0 C-l-2 C-l-1 C-l-2 C-l-0 L-m-0 
job-1958,4,6,5,97783,118789,118871,21006,82,98115,false,L-m-0 L-l-0 L-l-0 L-l-0 L-m-0 
job-1959,6,6,1,97832,118789,118925,20957,136,97983,false,C-m-0 
job-1961,3,7,7,97945,118925,118944,20980,19,98257,false,C-m-0 L-l-0 L-l-0 C-m-0 L-l-0 L-l-0 L-s-0 
job-1962,1,12,3,97992,118925,118961,20933,36,98266,false,C-m-1 C-m-1 C-m-0 
job-1960,2,8,3,97886,118925,118966,21039,41,98135,false,L-m-0 L-m-0 L-m-0 
job-1964,3,8,3,98097,118925,119263,20828,338,98500,false,C-m-2 C-m-1 C-m-2 
job-1963,5,10,4,98046,118925,119362,20879,437,98682,false,C-l-1 C-l-0 C-l-0 C-l-1 
job-1968,4,11,4,98307,119362,119379,21055,17,98505,false,C-l-0 C-l-0 C-l-0 C-s-1 
job-1966,1,4,6,98190,119362,119407,21172,45,98316,false,L-m-0 L-m-0 L-m-0 L-m-0 L-m-0 L-m-0 
job-1965,6,7,2,98149,119362,119428,21213,66,98400,false,L-l-0 L-l-0 
job-1969,3,5,6,98361,119362,119434,21001,72,98537,false,C-m-0 C-l-2 C-l-2 C-m-0 C-l-2 C-l-2 
job-1967,3,8,1,98244,119362,119444,21118,82,98504,false,L-s-0 
job-1970,6,10,8,98404,119428,119575,21024,147,98553,false,L-l-0 C-l-1 C-l-0 C-l-1 C-l-0 C-m-1 L-l-0 L-m-0 
job-1971,1,11,5,98454,119434,119907,20980,473,99072,false,L-m-0 L-m-0 C-s-1 C-m-1 C-m-1 
job-1972,2,4,8,98505,119907,119931,21402,24,98741,false,L-s-0 L-l-0 L-l-0 L-l-0 L-l-0 L-s-0 L-l-0 L-l-0 
job-1973,3,5,8,98559,119907,119963,21348,56,98627,false,C-l-1 C-l-1 C-l-1 C-m-0 C-l-1 L-m-0 C-m-0 L-m-0 
job-1975,4,6,6,98666,119963,119991,21297,28,98702,false,L-s-0 L-m-0 C-l-1 L-m-0 C-l-1 C-l-1 
job-1974,6,6,8,98611,119931,119996,21320,65,98838,false,L-l-0 L-l-0 C-l-0 C-l-2 C-l-0 C-m-2 C-l-2 C-m-1 
job-1976,4,12,1,98719,119991,120012,21272,21,99012,false,L-s-0 
job-1977,5,12,7,98775,119996,120100,21221,104,99005,false,L-m-0 L-l-0 C-l-1 C-l-0 C-l-1 L-l-0 C-l-0 
job-1978,2,6,3,98820,120100,120309,21280,209,99229,false,L-m-0 L-m-0 L-m-0 
job-1979,6,6,3,98864,120100,120406,21236,306,99335,false,L-l-0 L-l-0 C-m-0 
job-1980,2,10,1,98919,120406,120523,21487,117,99283,false,L-s-0 
job-1981,3,9,3,98968,120406,120573,21438,167,99197,false,L-l-0 L-l-0 L-l-0 
job-1982,6,10,8,99016,120406,120580,21390,174,99208,false,C-l-0 C-l-2 C-l-1 C-l-2 C-l-0 L-m-0 C-l-1 C-m-0 
job-1984,5,12,8,99128,120580,120609,21452,29,99416,false,L-l-0 C-l-1 C-l-0 C-l-0 C-l-1 L-l-0 C-m-0 L-m-0 
job-1983,1,7,2,99076,120580,120679,21504,99,99368,false,L-s-0 L-s-0 
job-1985,4,11,2,99179,120580,120765,21401,185,99568,false,C-m-1 C-m-1 
job-1986,4,7,2,99238,120765,120791,21527,26,99540,false,L-m-0 L-m-0 
job-1988,3,4,7,99339,120765,120835,21426,70,99578,false,C-s-1 C-l-2 C-l-2 C-m-0 C-l-2 C-l-2 L-s-0 
job-1987,5,8,7,99283,120765,120855,21482,90,99566,false,C-m-0 L-l-0 C-l-1 C-l-0 C-l-1 L-l-0 C-l-0 
job-1989,2,6,7,99402,120765,120889,21363,124,99751,false,C-m-2 C-m-2 C-l-1 C-m-2 C-l-0 L-l-0 C-m-2 
job-1990,5,12,1,99447,120835,120902,21388,67,99593,false,L-m-0 
job-1991,3,12,7,99507,120835,120936,21328,101,99853,false,C-l-2 L-m-0 C-m-0 C-l-2 C-l-2 C-l-2 L-s-0 
job-1992,5,4,3,99558,120889,120960,21331,71,99690,false,L-l-0 L-l-0 C-m-0 
job-1993,6,11,7,99610,120936,120965,21326,29,99937,false,L-m-0 C-l-2 C-l-0 C-l-1 C-l-0 C-l-1 C-l-2 
job-1994,3,9,3,99653,120960,120981,21307,21,99729,false,L-l-0 L-l-0 L-l-0 
job-1995,2,11,5,99701,120960,121153,21259,193,100188,false,L-s-0 C-s-1 L-m-0 C-s-0 L-l-0 
job-1997,2,6,7,99797,121153,121183,21356,30,99970,false,L-l-0 L-l-0 L-l-0 L-m-0 L-l-0 L-l-0 L-l-0 
job-1996,3,11,1,99750,121153,121239,21403,86,99918,false,L-s-0 
job-1998,5,5,6,99853,121153,121269,21300,116,99974,false,C-m-0 C-l-0 C-l-1 L-m-0 C-l-1 C-l-0 
job-1999,5,10,6,99909,121183,121273,21274,90,100259,false,C-m-2 L-l-0 L-l-0 C-m-1 C-l-2 C-l-2 
job-2000,6,11,1,99959,121269,121447,21310,178,100340,false,L-m-0 
job-2001,6,9,5,100018,121269,121681,21251,412,100569,false,C-l-1 C-l-0 C-l-0 C-m-0 C-l-1 
job-2002,5,7,3,100055,121681,121855,21626,174,100281,false,L-l-0 L-l-0 L-m-0 
job-2003,1,12,1,100099,121855,121878,21756,23,100130,false,L-s-0 
job-2006,2,11,6,100236,121855,121888,21619,33,100544,false,C-s-0 C-l-2 C-l-2 C-s-2 C-l-2 C-l-2 
job-2007,1,10,5,100297,121855,121957,21558,102,100589,false,L-m-0 C-l-0 C-l-0 C-l-0 C-l-0 
job-2004,3,8,5,100145,121855,121965,21710,110,100350,false,L-m-0 L-l-0 L-l-0 L-l-0 L-l-0 
job-2005,4,6,2,100191,121855,121971,21664,116,100381,false,C-s-1 L-m-0 
job-2008,1,6,8,100357,121855,122014,21498,159,100664,false,C-l-1 C-l-1 C-l-1 C-l-1 C-l-1 C-l-0 C-l-1 C-l-1 
job-2009,1,4,2,100403,121888,122374,21485,486,101102,false,L-s-0 C-l-1 
job-2010,6,6,5,100468,122374,122441,21906,67,100571,false,L-m-0 C-l-0 L-l-0 L-l-0 C-l-0 
job-2011,1,10,7,100521,122374,122447,21853,73,100632,false,L-s-0 L-m-0 L-m-0 C-l-1 C-l-1 C-l-1 C-l-1 
job-2013,1,7,6,100616,122374,122452,21758,78,100893,false,C-m-0 C-m-0 C-m-0 C-m-1 C-l-1 C-m-0 
job-2012,3,11,2,100564,122374,122477,21810,103,100702,false,C-m-1 C-m-1 
job-2015,1,8,1,100722,122374,122550,21652,176,100973,false,C-s-1 
job-2014,4,10,2,100674,122374,122587,21700,213,100960,false,C-m-2 C-m-2 
job-2016,1,7,2,100784,122477,122599,21693,122,100971,false,L-s-0 C-s-1 
job-2018,1,12,2,100877,122599,122650,21722,51,101026,false,C-s-1 L-m-0 
job-2017,3,7,8,100832,122477,122669,21645,192,101223,false,C-s-2 L-s-0 L-l-0 L-l-0 L-l-0 L-m-0 L-l-0 L-m-0 
job-2020,3,5,5,100975,122599,122671,21624,72,101198,false,C-s-0 C-l-1 C-l-1 C-l-1 C-l-1 
job-2019,5,5,4,100925,122599,122683,21674,84,101115,false,C-l-2 C-l-0 C-l-0 C-l-2 
job-2021,3,6,1,101023,122599,122705,21576,106,101191,false,C-m-0 
job-2022,1,10,5,101073,122683,122811,21610,128,101365,false,L-m-0 C-m-0 L-m-0 L-m-0 C-m-0 
job-2024,4,4,7,101167,122811,122836,21644,25,101328,false,L-l-0 C-l-1 L-m-0 C-s-1 C-l-1 C-l-1 L-m-0 
job-2025,2,10,2,101226,122811,122866,21585,55,101533,false,C-m-0 C-m-0 
job-2023,2,11,5,101131,122683,122957,21552,274,101551,false,L-s-0 L-l-0 L-l-0 L-l-0 L-l-0 
job-2026,6,8,4,101288,122811,122969,21523,158,101484,false,C-l-0 C-l-2 C-l-2 C-l-0 
job-2027,1,7,8,101335,122957,122994,21622,37,101515,false,L-s-0 L-l-0 L-s-0 L-l-0 L-l-0 L-l-0 L-l-0 L-l-0 
job-2028,6,12,1,101368,122994,123006,21626,12,101626,false,L-m-0 
job-2029,4,12,6,101419,122994,123115,21575,121,101623,false,C-m-2 L-l-0 L-l-0 C-m-2 L-l-0 L-s-0 
job-2030,5,6,5,101461,122994,123289,21533,295,101783,false,C-m-0 C-l-2 C-l-2 C-l-0 C-l-0 
job-2032,4,10,3,101549,123289,123361,21740,72,101693,false,L-s-0 L-m-0 L-m-0 
job-2031,3,5,3,101506,123289,123424,21783,135,101930,false,L-l-0 L-l-0 L-l-0 
job-2034,6,8,5,101633,123424,123470,21791,46,101688,false,L-m-0 C-l-1 L-l-0 L-l-0 C-l-1 
job-2033,5,6,3,101590,123289,123473,21699,184,101904,false,C-l-0 C-m-0 C-l-0 
job-2035,6,6,8,101693,123470,123497,21777,27,101904,false,L-l-0 C-l-1 C-l-1 C-l-2 C-l-2 L-m-0 L-l-0 C-m-1 
job-2036,3,5,6,101751,123470,123521,21719,51,102007,false,L-s-0 C-m-2 C-s-1 C-m-2 C-m-0 C-s-2 
job-2037,1,5,6,101797,123521,123649,21724,128,102139,false,L-m-0 L-m-0 L-m-0 L-m-0 L-m-0 L-m-0 
job-2038,2,9,8,101851,123521,123787,21670,266,102247,false,C-m-2 L-l-0 L-l-0 L-l-0 L-l-0 C-m-2 C-m-2 L-l-0 
job-2040,6,6,2,101963,123787,123818,21824,31,102260,false,L-l-0 L-l-0 
job-2039,4,11,1,101923,123787,123837,21864,50,102140,false,L-s-0 
job-2041,6,9,1,102009,123787,123876,21778,89,102161,false,L-m-0 
job-2042,5,10,1,102052,123787,123887,21735,100,102314,false,C-m-0 
job-2043,3,8,6,102099,123876,123902,21777,26,102300,false,L-s-0 L-l-0 C-m-0 L-l-0 L-l-0 L-l-0 
job-2044,4,6,3,102140,123876,124214,21736,338,102757,false,L-m-0 C-s-1 L-m-0 
job-2045,1,12,2,102200,124214,124242,22014,28,102355,false,L-m-0 L-m-0 
job-2046,6,9,6,102254,124214,124258,21960,44,102300,false,L-l-0 C-l-0 C-l-1 L-l-0 C-l-0 C-l-1 
job-2047,5,9,5,102290,124214,124299,21924,85,102478,false,C-m-1 C-l-2 C-m-2 C-m-0 C-l-2 
job-2048,2,11,7,102337,124214,124301,21877,87,102469,false,L-s-0 C-l-2 C-m-2 C-m-1 C-s-2 C-s-1 C-m-0 
job-2049,6,12,6,102389,124299,124326,21910,27,102680,false,L-l-0 C-m-1 L-l-0 C-m-2 C-m-0 C-l-2 
job-2050,1,5,5,102431,124326,124352,21895,26,102735,false,L-m-0 L-m-0 L-m-0 L-m-0 L-m-0 
job-2052,3,5,2,102549,124352,124390,21803,38,102627,false,L-m-0 L-m-0 
job-2053,5,5,1,102601,124352,124416,21751,64,102683,false,L-l-0 
job-2051,2,5,1,102495,124352,124459,21857,107,102712,false,L-s-0 
job-2054,3,9,1,102640,124416,124798,21776,382,103089,false,L-m-0 
job-2055,3,11,5,102701,124798,124879,22097,81,103036,false,L-l-0 L-s-0 L-l-0 L-l-0 L-l-0 
job-2056,6,9,4,102768,124798,125056,22030,258,103232,false,C-l-0 C-l-0 L-m-0 C-m-0 
job-2057,2,12,4,102826,125056,125208,22230,152,103031,false,L-l-0 L-l-0 L-l-0 L-l-0 
job-2058,5,10,7,102875,125056,125219,22181,163,103210,false,C-l-0 C-l-1 C-l-0 L-m-0 C-l-1 C-l-2 C-l-2 
job-2059,1,4,1,102921,125219,125254,22298,35,102998,false,L-s-0 
job-2060,5,8,5,102966,125219,125291,22253,72,103135,false,L-l-0 C-l-0 L-l-0 L-m-0 C-l-0 
job-2062,3,6,4,103051,125291,125335,22240,44,103238,false,L-s-0 L-l-0 L-m-0 L-m-0 
job-2061,1,6,7,103015,125291,125337,22276,46,103223,false,L-l-0 L-l-0 L-l-0 L-l-0 L-l-0 L-l-0 L-l-0 
job-2063,1,10,2,103105,125335,125722,22230,387,103596,false,L-m-0 L-m-0 
job-2064,3,10,3,103152,125722,125808,22570,86,103526,false,L-m-0 L-m-0 L-s-0 
job-2065,4,12,2,103197,125808,125825,22611,17,103356,false,L-m-0 L-m-0 
job-2069,3,9,5,103386,125825,125910,22439,85,103476,false,L-m-0 C-s-2 C-s-1 L-m-0 C-s-0 
job-2068,6,5,8,103343,125808,125915,22465,107,103731,false,C-l-0 C-l-1 C-l-1 C-l-2 C-l-2 C-m-2 C-l-0 C-m-1 
job-2067,3,4,3,103295,125808,125924,22513,116,103598,false,L-s-0 C-m-0 C-m-0 
job-2066,6,4,2,103252,125808,125963,22556,155,103451,false,L-l-0 L-l-0 
job-2070,5,12,5,103426,125915,125979,22489,64,103727,false,L-m-0 C-l-1 C-l-0 C-l-0 C-l-1 
job-2071,4,12,6,103481,125963,125981,22482,18,103508,false,L-s-0 L-l-0 C-m-2 C-m-2 L-l-0 L-l-0 
job-2072,2,5,1,103519,125979,126015,22460,36,103670,false,L-m-0 
job-2073,5,4,3,103575,125979,126043,22404,64,103694,false,C-l-0 L-m-0 C-l-0 
job-2074,4,7,2,103633,126043,126066,22410,23,103671,false,L-m-0 L-m-0 
job-2075,1,7,6,103681,126043,126118,22362,75,103961,false,L-l-0 L-l-0 L-l-0 L-l-0 L-l-0 L-l-0 
job-2076,3,4,3,103732,126118,126131,22386,13,103838,false,L-l-0 L-l-0 L-l-0 
job-2077,2,9,6,103775,126118,126256,22343,138,104010,false,L-m-0 C-s-1 L-l-0 L-m-0 L-s-0 L-m-0 
job-2078,1,5,8,103820,126256,126308,22436,52,103958,false,L-s-0 L-m-0 L-s-0 L-s-0 L-m-0 L-m-0 L-m-0 L-m-0 
job-2079,4,7,8,103867,126256,126308,22389,52,104100,false,L-l-0 L-l-0 C-l-0 C-l-0 C-l-0 L-l-0 C-m-0 C-m-0 
job-2080,3,11,3,103920,126256,126356,22336,100,104196,false,C-s-1 C-s-2 C-s-0 
job-2081,1,12,2,103970,126256,126361,22286,105,104331,false,C-m-1 C-m-1 
job-2082,5,4,7,104011,126308,126457,22297,149,104348,false,C-m-2 C-l-2 C-l-1 C-m-1 C-l-2 C-l-1 L-m-0 
job-2083,5,11,2,104055,126457,126481,22402,24,104263,false,L-l-0 L-l-0 
job-2084,2,8,3,104109,126457,126663,22348,206,104495,false,L-s-0 L-s-0 L-l-0 
job-2085,3,9,6,104146,126457,126708,22311,251,104520,false,L-m-0 C-l-0 C-l-0 L-m-0 C-l-0 C-l-0 
job-2087,1,10,4,104252,126663,126852,22411,189,104545,false,L-l-0 L-l-0 L-l-0 L-l-0 
job-2088,6,6,4,104294,126852,126886,22558,34,104450,false,L-l-0 L-m-0 L-l-0 C-m-0 
job-2086,1,5,5,104190,126457,126925,22267,468,104898,false,C-s-1 L-m-0 L-m-0 C-s-1 C-s-1 
job-2089,1,10,5,104350,126852,127232,22502,380,104731,false,C-m-0 C-m-0 C-m-1 C-m-1 C-m-1 
job-2091,2,7,5,104464,127232,127316,22768,84,104564,false,L-m-0 L-s-0 L-s-0 L-m-0 L-m-0 
job-2090,6,9,2,104408,127232,127367,22824,135,104551,false,L-l-0 L-l-0 
job-2092,3,10,5,104515,127232,127828,22717,596,105225,false,C-s-1 C-l-0 C-l-0 C-l-0 C-l-0 
job-2093,4,6,6,104582,127828,127963,23246,135,104717,false,L-m-0 L-s-0 L-l-0 L-l-0 L-m-0 L-l-0 
job-2094,2,5,5,104630,127963,127988,23333,25,104913,false,L-l-0 L-l-0 L-l-0 L-l-0 L-l-0 
job-2095,4,10,1,104684,127963,128115,23279,152,104882,false,L-s-0 
job-2097,6,9,1,104783,128115,128141,23332,26,104967,false,L-m-0 
job-2096,4,11,1,104727,128115,128145,23388,30,104767,false,L-s-0 
job-2098,3,4,7,104839,128115,128151,23276,36,105025,false,L-l-0 C-l-2 C-l-2 C-l-2 C-l-2 L-l-0 L-l-0 
job-2099,5,6,8,104883,128141,128255,23258,114,105018,false,C-m-2 C-l-1 C-l-1 C-l-0 C-l-0 L-m-0 C-m-1 C-m-0 
job-2103,6,7,8,105092,128255,128274,23163,19,105206,false,C-l-0 C-l-2 C-l-0 C-l-1 C-l-1 C-l-2 C-m-1 C-m-0 
job-2101,5,12,3,104980,128255,128348,23275,93,105275,false,L-l-0 L-l-0 L-m-0 
job-2102,3,7,2,105037,128255,128396,23218,141,105363,false,C-s-2 L-m-0 
job-2100,1,10,1,104930,128255,128421,23325,166,105248,false,L-s-0 
job-2105,4,6,6,105185,128396,128427,23211,31,105466,false,L-m-0 L-l-0 L-l-0 C-s-1 L-l-0 L-m-0 
job-2104,3,4,7,105139,128274,128432,23135,158,105308,false,L-s-0 C-l-1 C-l-1 C-m-0 C-l-1 C-l-1 C-m-0 
job-2107,6,12,4,105279,128432,128507,23153,75,105445,false,C-m-1 C-l-1 C-l-1 C-m-0 
job-2106,6,8,7,105230,128427,128563,23197,136,105501,false,L-l-0 C-l-0 C-l-2 C-l-2 C-l-0 L-l-0 L-m-0 
job-2108,5,12,3,105344,128507,128572,23163,65,105598,false,C-l-1 C-l-1 C-m-0 
job-2109,2,4,8,105407,128507,128829,23100,322,105979,false,L-s-0 C-m-1 C-m-1 C-l-1 L-m-0 C-m-1 C-m-1 C-m-0 
job-2111,1,9,2,105508,128829,128859,23321,30,105601,false,C-m-0 C-m-0 
job-2110,4,11,7,105458,128829,128869,23371,40,105642,false,L-l-0 L-m-0 L-s-0 L-l-0 L-m-0 L-l-0 C-s-2 
job-2113,1,11,8,105601,128859,128901,23258,42,105814,false,C-l-0 C-l-1 C-l-1 C-l-0 C-l-1 C-l-1 C-l-0 C-l-0 
job-2112,4,11,1,105550,128859,128957,23309,98,105945,false,C-s-1 
job-2114,4,10,1,105664,128957,128996,23293,39,105804,false,L-s-0 
job-2115,3,8,3,105707,128957,129064,23250,107,105975,false,L-l-0 L-l-0 L-l-0 
job-2116,5,8,6,105743,128957,129183,23214,226,106179,false,L-m-0 C-m-0 C-l-1 C-l-0 C-l-0 C-l-1 
job-2117,1,8,3,105781,129183,129295,23402,112,106125,false,L-m-0 L-m-0 L-m-0 
job-2118,3,11,3,105826,129183,129297,23357,114,105988,false,L-l-0 L-l-0 L-l-0 
job-2119,6,12,6,105856,129183,129382,23327,199,106140,false,C-l-0 C-l-1 C-l-0 C-l-2 C-l-1 C-l-2 
job-2121,4,10,6,105962,129295,129442,23333,147,106360,false,C-s-0 C-m-2 L-m-0 C-m-2 L-m-0 C-s-1 
job-2120,1,5,4,105910,129295,129459,23385,164,106199,false,L-s-0 L-l-0 L-l-0 L-l-0 
job-2122,4,11,2,106004,129459,129477,23455,18,106065,false,L-m-0 L-m-0 
job-2123,3,4,6,106043,129459,129484,23416,25,106069,false,L-s-0 L-l-0 L-l-0 C-s-1 L-l-0 L-l-0 
job-2124,3,6,5,106101,129459,129661,23358,202,106477,false,C-s-2 C-l-1 C-l-1 C-l-1 C-l-1 
job-2125,4,11,7,106154,129661,129676,23507,15,106428,false,L-l-0 L-m-0 L-s-0 L-l-0 L-m-0 L-l-0 C-s-2 
job-2127,4,11,2,106265,129661,129768,23396,107,106375,false,C-m-0 C-m-0 
job-2126,6,7,4,106204,129661,129800,23457,139,106547,false,C-l-0 C-l-0 C-l-1 C-l-1 
job-2128,6,11,4,106331,129768,129825,23437,57,106558,false,L-m-0 L-l-0 L-l-0 C-m-0 
job-2129,6,5,7,106389,129800,130355,23411,555,107167,false,C-m-1 C-l-1 C-l-0 C-l-0 C-l-1 C-l-2 C-l-2 
job-2130,6,12,7,106440,130355,130450,23915,95,106577,false,L-m-0 C-l-0 C-l-1 L-l-0 C-l-0 C-l-1 L-l-0 
job-2131,5,4,1,106481,130450,130475,23969,25,106791,false,L-m-0 
job-2132,6,6,8,106534,130450,130560,23916,110,106645,false,L-l-0 L-l-0 C-l-0 C-l-2 C-l-0 C-l-2 C-l-1 C-l-1 
job-2133,6,7,4,106587,130475,130585,23888,110,106858,false,C-m-0 L-m-0 C-m-2 C-m-1 
job-2134,6,7,5,106633,130585,130597,23952,12,106857,false,L-m-0 C-l-0 L-l-0 L-l-0 C-l-0 
job-2136,6,9,3,106752,130585,130600,23833,15,106840,false,C-l-2 C-l-2 C-m-0 
job-2137,5,5,1,106805,130585,130653,23780,68,106909,false,C-m-1 
job-2135,4,12,1,106687,130585,130672,23898,87,106925,false,L-s-0 
job-2138,2,6,1,106857,130653,130733,23796,80,106969,false,L-m-0 
job-2139,5,12,4,106910,130653,130760,23743,107,107019,false,L-m-0 L-l-0 L-l-0 C-m-0 
job-2140,2,9,3,106967,130653,130762,23686,109,107168,false,C-s-1 L-l-0 C-m-0 
job-2141,4,7,3,107013,130733,130768,23720,35,107141,false,L-s-0 C-m-1 C-m-1 
job-2142,2,4,1,107061,130762,130797,23701,35,107109,false,L-m-0 
job-2144,4,11,7,107171,130762,130960,23591,198,107606,false,C-m-0 C-l-2 C-l-2 C-s-1 C-l-2 C-m-0 C-s-2 
job-2143,5,11,7,107115,130762,131021,23647,259,107672,false,L-l-0 C-l-0 L-m-0 C-l-1 C-l-1 L-l-0 C-l-0 
job-2145,6,11,7,107219,131021,131063,23802,42,107301,false,L-m-0 C-l-0 C-l-0 C-l-2 C-l-2 L-l-0 L-l-0 
job-2146,3,12,8,107276,131063,131079,23787,16,107393,false,L-m-0 L-l-0 C-s-1 L-l-0 L-l-0 L-l-0 L-m-0 L-s-0 
job-2147,6,11,6,107320,131063,131206,23743,143,107672,false,C-l-0 C-l-1 C-l-2 C-l-2 C-l-1 C-l-0 
job-2148,4,12,4,107358,131206,131223,23848,17,107661,false,L-l-0 L-l-0 L-s-0 L-l-0 
job-2150,6,6,8,107452,131206,131230,23754,24,107518,false,C-l-0 C-l-1 C-l-2 C-l-2 C-l-0 C-m-1 C-l-1 C-m-0 
job-2149,2,8,3,107400,131206,131244,23806,38,107492,false,L-m-0 L-m-0 L-m-0 
job-2151,2,4,5,107494,131206,131281,23712,75,107701,false,C-m-0 C-m-1 C-s-1 L-m-0 C-s-1 
job-2152,4,7,3,107558,131281,131304,23723,23,107647,false,L-l-0 L-l-0 L-l-0 
job-2153,6,12,6,107619,131281,131475,23662,194,108017,false,C-m-0 C-l-1 C-l-1 L-m-0 C-l-2 C-l-2 
job-2154,1,11,8,107676,131281,131635,23605,354,108306,false,C-s-1 C-l-0 C-l-0 C-l-0 C-m-0 C-l-0 L-s-0 L-m-0 
job-2156,4,6,8,107784,131635,131674,23851,39,107847,false,C-l-1 C-m-0 C-l-0 C-l-1 C-l-1 C-l-0 C-l-0 C-m-0 
job-2155,4,11,6,107735,131635,131704,23900,69,107856,false,L-m-0 L-s-0 L-l-0 L-l-0 L-m-0 L-l-0 
job-2157,4,7,4,107831,131635,131832,23804,197,108186,false,C-m-1 C-m-2 C-m-2 C-m-1 
job-2158,4,11,2,107880,131635,131883,23755,248,108292,false,C-s-2 C-s-1 
job-2159,2,8,7,107927,131883,131900,23956,17,108057,false,L-l-0 L-l-0 L-s-0 L-l-0 L-l-0 L-s-0 L-l-0 
job-2160,2,12,7,107978,131883,132146,23905,263,108330,false,L-m-0 C-l-0 C-l-0 C-s-1 C-l-0 C-l-0 L-m-0 
job-2161,3,6,6,108032,132146,132202,24114,56,108232,false,L-m-0 L-l-0 L-l-0 L-m-0 L-l-0 L-l-0 
job-2163,1,7,5,108134,132146,132308,24012,162,108516,false,C-l-0 C-l-0 C-l-0 C-l-0 C-l-0 
job-2162,2,10,2,108086,132146,132392,24060,246,108477,false,L-s-0 L-m-0 
job-2164,6,12,5,108182,132146,132427,23964,281,108604,false,C-l-2 C-l-2 C-l-0 C-l-1 C-l-1 
job-2166,1,5,6,108282,132202,132435,23920,233,108533,false,L-s-0 C-s-0 C-m-0 C-s-0 C-m-0 C-s-0 
job-2165,6,4,4,108232,132202,132465,23970,263,108606,false,L-l-0 L-m-0 L-l-0 C-m-0 
job-2169,5,9,2,108445,132427,132506,23982,79,108635,false,C-m-2 C-m-1 
job-2167,6,5,4,108336,132427,132514,24091,87,108712,false,C-l-0 C-l-1 C-l-1 C-l-0 
job-2168,5,10,2,108391,132427,132590,24036,163,108799,false,C-l-2 C-l-2 
job-2170,5,10,6,108507,132506,132884,23999,378,109054,false,C-m-0 L-l-0 L-l-0 L-m-0 C-m-1 C-m-2 
job-2171,3,7,1,108553,132884,133079,24331,195,108969,false,L-s-0 
job-2173,2,8,7,108656,133079,133107,24423,28,108739,false,L-l-0 L-l-0 L-l-0 L-m-0 L-l-0 L-l-0 L-l-0 
job-2172,1,4,5,108605,133079,133114,24474,35,108897,false,L-m-0 L-m-0 L-m-0 L-m-0 L-m-0 
job-2174,6,9,4,108702,133079,133145,24377,66,108984,false,C-l-0 C-l-1 C-l-1 C-l-0 
job-2175,2,10,2,108747,133079,133155,24332,76,109055,false,L-s-0 C-s-1 
job-2177,1,10,7,108830,133079,133478,24249,399,109356,false,C-m-0 C-m-1 C-m-1 C-m-1 C-m-0 C-s-0 C-m-0 
job-2176,1,8,8,108793,133079,133571,24286,492,109404,false,C-l-2 C-l-2 C-l-2 C-l-2 C-l-2 C-l-2 C-s-2 C-s-2 
job-2179,2,11,3,108935,133571,133592,24636,21,109239,false,C-l-0 C-l-0 C-l-0 
job-2178,1,11,8,108883,133571,133610,24688,39,109037,false,L-s-0 L-l-0 L-l-0 L-l-0 L-l-0 L-m-0 C-s-1 L-m-0 
job-2181,6,7,5,109026,133592,133620,24566,28,109158,false,C-l-0 C-l-1 L-m-0 C-l-0 C-l-1 
job-2180,2,12,1,108980,133592,133655,24612,63,109048,false,C-s-2 
job-2182,1,7,8,109073,133592,133804,24519,212,109508,false,C-s-0 C-l-2 C-l-2 C-l-2 C-l-2 C-l-2 C-s-0 C-l-2 
job-2183,4,5,8,109123,133610,133823,24487,213,109354,false,L-s-0 L-l-0 L-l-0 C-l-2 L-l-0 C-s-1 C-m-0 C-m-0 
job-2184,5,12,3,109189,133804,133862,24615,58,109485,false,L-m-0 C-m-1 C-l-2 
job-2186,6,10,5,109276,133862,133886,24586,24,109440,false,L-l-0 C-l-0 L-l-0 L-m-0 C-l-0 
job-2185,4,5,1,109239,133862,133904,24623,42,109336,false,L-s-0 
job-2188,1,5,6,109379,133862,133958,24483,96,109731,false,C-m-0 C-m-0 L-m-0 C-m-0 C-m-0 L-m-0 
job-2187,6,5,4,109336,133862,133960,24526,98,109663,false,C-l-1 C-l-2 C-l-2 C-l-1 
job-2189,5,4,2,109429,133958,133975,24529,17,109545,false,L-l-0 L-l-0 
job-2190,4,12,3,109478,133958,134050,24480,92,109808,false,L-m-0 L-m-0 L-s-0 
job-2191,6,11,8,109539,133960,134204,24421,244,109786,false,C-l-1 C-l-1 C-l-2 C-l-2 C-l-0 C-m-1 C-l-0 C-m-0 
job-2193,4,4,2,109640,134204,134225,24564,21,109687,false,L-m-0 L-l-0 
job-2192,1,7,8,109580,134204,134229,24624,25,109759,false,L-l-0 L-s-0 L-s-0 L-l-0 L-l-0 L-l-0 L-l-0 L-l-0 
job-2194,2,10,5,109687,134204,134233,24517,29,109971,false,L-m-0 L-m-0 C-m-1 C-m-1 C-m-1 
job-2195,5,9,4,109732,134204,134356,24472,152,110029,false,C-l-0 C-l-1 C-l-1 C-l-0 
job-2196,6,7,2,109783,134356,134384,24573,28,110086,false,L-l-0 L-l-0 
job-2197,6,6,3,109846,134356,134421,24510,65,110175,false,L-m-0 C-l-0 C-l-0 
job-2198,1,11,5,109887,134356,134585,24469,229,110362,false,L-s-0 L-m-0 L-m-0 C-m-0 C-m-0 
job-2199,3,4,8,109945,134585,134597,24640,12,110179,false,L-m-0 L-l-0 L-s-0 L-l-0 L-l-0 L-l-0 C-s-1 L-m-0 
job-2200,3,9,8,109992,134585,134740,24593,155,110163,false,C-l-0 C-l-0 C-l-1 C-l-0 C-l-1 C-l-1 C-l-0 C-l-1 
job-2201,2,7,7,110047,134740,134816,24693,76,110173,false,L-l-0 L-l-0 L-s-0 L-l-0 L-l-0 L-s-0 L-l-0 
job-2202,2,5,2,110079,134740,135079,24661,339,110486,false,L-m-0 L-l-0 
job-2203,1,8,2,110125,135079,135132,24954,53,110267,false,L-s-0 L-s-0 
job-2204,2,10,3,110166,135079,135328,24913,249,110604,false,L-m-0 L-m-0 L-m-0 
job-2205,3,6,3,110202,135328,135358,25126,30,110463,false,L-l-0 L-l-0 L-l-0 
job-2207,6,6,3,110298,135328,135387,25030,59,110602,false,C-l-2 C-m-0 C-l-2 
job-2206,3,9,8,110253,135328,135438,25075,110,110393,false,C-l-1 C-l-1 L-s-0 C-l-1 C-l-1 L-m-0 L-l-0 L-m-0 
job-2208,4,11,7,110342,135438,135448,25096,10,110552,false,L-l-0 L-m-0 L-s-0 L-l-0 L-m-0 L-l-0 C-s-2 
job-2209,2,4,6,110390,135438,135898,25048,460,110971,false,C-l-0 C-l-0 C-l-0 C-l-0 C-l-0 C-l-0 
job-2211,2,10,2,110504,135898,135957,25394,59,110782,false,L-l-0 L-l-0 
job-2210,4,8,2,110450,135898,136017,25448,119,110845,false,L-m-0 L-m-0 
job-2212,1,7,6,110561,135898,136219,25337,321,111001,false,L-s-0 L-l-0 L-l-0 L-l-0 L-s-0 L-l-0 
job-2213,6,6,2,110610,136219,136239,25609,20,110678,false,L-l-0 L-l-0 
job-2214,5,7,7,110652,136219,136296,25567,77,110892,false,C-l-0 C-l-1 C-l-0 C-l-2 C-l-1 C-l-2 L-m-0 
job-2215,2,10,8,110703,136219,136309,25516,90,110899,false,C-l-0 C-l-2 C-m-0 C-l-1 C-m-0 C-m-0 L-s-0 L-m-0 
job-2216,2,9,8,110753,136219,136324,25466,105,111038,false,C-s-1 C-m-2 C-m-2 C-s-0 C-m-1 C-m-1 C-m-2 C-m-1 
job-2218,5,12,6,110861,136309,136328,25448,19,110950,false,L-m-0 C-l-0 C-l-1 C-l-1 C-l-0 L-l-0 
job-2217,3,7,2,110815,136239,136383,25424,144,111195,false,L-l-0 L-l-0 
job-2219,1,12,6,110914,136328,136392,25414,64,111183,false,L-m-0 C-s-1 L-l-0 L-s-0 L-l-0 L-m-0 
job-2220,5,12,3,110957,136328,136698,25371,370,111450,false,C-m-0 C-l-0 C-l-0 
job-2222,5,4,2,111046,136698,136814,25652,116,111337,false,C-m-0 L-m-0 
job-2221,2,9,4,111004,136698,136899,25694,201,111379,false,L-l-0 L-l-0 L-l-0 L-l-0 
job-2225,4,4,5,111182,136814,136916,25632,102,111464,false,C-m-0 C-l-1 C-l-1 C-m-0 C-l-1 
job-2226,6,7,7,111232,136899,136922,25667,23,111413,false,C-l-2 C-l-2 C-l-0 C-m-1 C-l-0 L-l-0 C-m-2 
job-2224,2,10,4,111130,136814,136961,25684,147,111567,false,L-m-0 L-m-0 C-s-1 L-m-0 
job-2227,6,7,4,111280,136922,137038,25642,116,111657,false,L-l-0 C-l-0 C-l-0 C-m-0 
job-2223,1,4,5,111086,136814,137068,25728,254,111371,false,L-s-0 L-s-0 L-l-0 L-l-0 L-l-0 
job-2228,3,4,6,111334,137038,137069,25704,31,111601,false,C-s-1 L-l-0 L-l-0 L-m-0 L-l-0 L-m-0 
job-2230,5,7,7,111430,137038,137182,25608,144,111771,false,C-l-0 C-l-2 C-l-1 C-m-2 C-l-1 C-l-2 C-l-0 
job-2229,2,8,6,111375,137038,137232,25663,194,111772,false,C-s-2 C-s-0 L-s-0 C-s-2 L-m-0 C-s-0 
job-2231,5,11,2,111488,137182,137241,25694,59,111633,false,L-m-0 L-l-0 
job-2232,1,7,2,111526,137241,137278,25715,37,111801,false,L-s-0 L-s-0 
job-2233,1,9,3,111576,137241,137486,25665,245,111852,false,L-m-0 L-m-0 L-m-0 
job-2234,1,4,4,111622,137486,137521,25864,35,111846,false,L-s-0 L-s-0 L-s-0 L-s-0 
job-2235,4,7,8,111667,137486,137768,25819,282,111950,false,L-m-0 C-l-0 L-l-0 C-l-0 C-l-0 L-l-0 L-m-0 L-l-0 
job-2236,6,4,8,111713,137768,137791,26055,23,111759,false,L-l-0 C-l-0 C-l-0 C-l-1 C-l-1 L-l-0 C-m-0 L-m-0 
job-2239,4,10,5,111871,137791,137889,25920,98,112221,false,C-m-2 C-m-2 C-m-1 C-s-0 C-m-1 
job-2237,3,6,2,111765,137768,137902,26003,134,111920,false,L-s-0 C-s-1 
job-2241,3,7,8,111961,137889,137960,25928,71,112118,false,C-l-1 C-m-0 C-l-1 C-s-0 C-l-1 C-m-1 C-l-1 C-m-1 
job-2238,6,12,5,111822,137791,137966,25969,175,112055,false,L-m-0 L-l-0 C-l-0 L-l-0 C-l-0 
job-2240,5,5,1,111915,137791,137992,25876,201,112287,false,C-m-0 
job-2243,6,12,5,112039,137966,138279,25927,313,112530,false,L-m-0 C-l-0 C-l-0 L-l-0 L-l-0 
job-2242,4,12,6,112001,137889,138318,25888,429,112521,false,C-m-2 C-l-2 C-l-2 C-s-2 C-l-2 C-m-2 
job-2245,5,7,4,112153,138279,138342,26126,63,112218,false,C-m-0 L-l-0 L-l-0 L-m-0 
job-2246,2,10,6,112195,138279,138387,26084,108,112332,false,C-m-0 L-l-0 C-m-1 C-m-1 C-m-1 L-m-0 
job-2247,4,12,8,112250,138387,138420,26137,33,112476,false,C-l-0 L-l-0 L-l-0 C-l-0 C-l-0 L-l-0 L-m-0 L-m-0 
job-2248,2,9,5,112290,138387,138623,26097,236,112687,false,C-l-2 C-l-2 C-l-2 C-l-2 C-l-2 
job-2249,4,9,2,112350,138623,138746,26273,123,112533,false,L-m-0 L-m-0 
job-2250,3,8,2,112405,138746,138784,26341,38,112561,false,L-m-0 L-m-0 
job-2244,2,9,1,112093,138279,138821,26186,542,112841,false,L-s-0 
job-2252,5,4,7,112488,138784,138914,26296,130,112835,false,C-m-2 C-l-2 C-l-1 C-m-1 C-l-1 C-l-2 L-m-0 
job-2251,6,5,5,112439,138746,138990,26307,244,112927,false,L-l-0 C-l-0 L-l-0 C-m-0 C-l-0 
job-2254,5,5,7,112597,138990,139143,26393,153,112977,false,C-m-2 L-l-0 C-l-0 C-m-1 C-l-0 L-l-0 C-m-0 
job-2253,6,6,5,112542,138914,139212,26372,298,112900,false,L-m-0 C-l-1 C-l-1 C-l-2 C-l-2 
job-2258,3,5,7,112798,139143,139215,26345,72,113075,false,C-m-0 C-m-2 C-s-1 C-m-1 C-m-2 C-m-1 C-m-0 
job-2257,2,8,5,112747,139143,139227,26396,84,112938,false,C-l-0 C-l-0 C-l-0 C-l-0 C-l-0 
job-2259,6,5,4,112849,139212,139258,26363,46,112982,false,L-m-0 C-l-1 C-l-1 C-l-2 
job-2255,1,9,7,112646,139143,139269,26497,126,113061,false,L-l-0 L-m-0 L-m-0 L-l-0 L-l-0 L-l-0 L-l-0 
job-2260,6,5,3,112890,139215,139294,26325,79,113052,false,C-m-1 C-m-0 C-l-2 
job-2262,6,5,4,112989,139294,139308,26305,14,113197,false,L-l-0 L-m-0 L-l-0 C-m-0 
job-2261,1,12,2,112936,139294,139331,26358,37,113005,false,L-m-0 L-m-0 
job-2256,4,10,1,112690,139143,139340,26453,197,112956,false,L-s-0 
job-2263,6,10,7,113037,139294,139916,26257,622,113863,false,C-l-0 C-l-1 C-l-1 C-m-1 C-l-0 C-l-2 C-l-2 
job-2264,6,4,6,113102,139916,139991,26814,75,113323,false,C-m-0 C-l-0 L-l-0 L-m-0 C-l-0 L-l-0 
job-2265,4,6,2,113147,139991,140017,26844,26,113311,false,L-m-0 L-m-0 
job-2267,3,12,3,113247,139991,140037,26744,46,113539,false,C-l-1 C-l-1 C-l-1 
job-2266,4,6,6,113191,139991,140057,26800,66,113406,false,C-m-0 L-l-0 L-l-0 C-m-0 L-s-0 L-l-0 
job-2268,3,12,2,113300,139991,140092,26691,101,113481,false,C-s-1 C-l-1 
job-2269,3,10,2,113356,139991,140099,26635,108,113603,false,C-m-1 C-m-1 
job-2271,1,12,8,113448,139991,140101,26543,110,113603,false,C-m-1 C-l-2 C-l-0 C-l-2 C-l-0 C-l-0 C-l-2 C-l-2 
job-2270,4,11,1,113405,139991,140243,26586,252,113954,false,C-s-2 
job-2272,2,12,7,113506,140037,140296,26531,259,113909,false,L-m-0 C-l-1 C-l-0 C-s-0 C-l-1 C-l-1 L-m-0 
job-2274,4,9,8,113607,140296,140382,26689,86,113917,false,C-s-0 C-l-0 C-l-0 L-m-0 C-l-0 L-s-0 C-s-2 L-m-0 
job-2273,3,9,4,113564,140296,140392,26732,96,113809,false,L-l-0 L-l-0 L-l-0 L-l-0 
job-2275,2,10,5,113657,140382,140404,26725,22,113722,false,L-m-0 L-m-0 L-s-0 L-m-0 C-s-1 
job-2276,6,4,5,113709,140382,140492,26673,110,114068,false,C-l-0 C-l-1 C-l-1 C-m-0 C-l-0 
job-2278,1,8,7,113790,140492,140524,26702,32,114075,false,L-l-0 L-l-0 L-l-0 L-m-0 L-l-0 L-l-0 L-l-0 
job-2277,2,6,3,113755,140492,140530,26737,38,113908,false,L-m-0 L-m-0 L-m-0 
job-2280,4,5,3,113901,140492,140893,26591,401,114390,false,C-m-1 C-m-1 C-s-2 
job-2279,3,6,3,113855,140492,140909,26637,417,114366,false,L-s-0 C-m-0 C-m-0 
job-2281,1,8,5,113940,140893,140973,26953,80,114243,false,L-m-0 C-m-0 L-m-0 L-s-0 C-m-0 
job-2282,5,8,1,113995,140973,140999,26978,26,114151,false,L-m-0 
job-2284,4,7,8,114089,140999,141017,26910,18,114132,false,L-l-0 L-l-0 C-l-0 C-l-0 C-l-0 L-l-0 L-s-0 L-m-0 
job-2283,1,11,2,114035,140999,141060,26964,61,114357,false,L-m-0 L-m-0 
job-2285,2,4,7,114146,140999,141270,26853,271,114478,false,C-l-2 C-l-2 C-l-2 C-l-2 C-l-2 C-l-2 C-s-1 
job-2286,3,5,1,114187,141270,141326,27083,56,114524,false,L-s-0 
job-2287,1,5,2,114228,141270,141592,27042,322,114644,false,L-s-0 L-m-0 
job-2289,5,4,5,114323,141592,141674,27269,82,114703,false,C-l-0 C-l-0 C-l-1 L-m-0 C-l-1 
job-2288,6,11,2,114279,141592,141682,27313,90,114663,false,L-l-0 L-l-0 
job-2290,1,10,8,114371,141674,141711,27303,37,114541,false,L-s-0 C-l-0 C-l-0 C-l-0 C-l-0 L-m-0 L-m-0 L-m-0 
job-2291,1,11,3,114412,141711,141726,27299,15,114546,false,L-l-0 L-l-0 L-l-0 
job-2294,1,9,8,114552,141711,141784,27159,73,114743,false,C-l-1 C-l-1 C-l-1 C-l-1 C-l-1 C-m-0 C-m-0 C-m-0 
job-2295,1,6,6,114608,141711,141815,27103,104,114732,false,C-l-0 C-l-0 C-l-0 C-l-0 C-l-0 C-l-0 
job-2296,6,10,3,114658,141711,141836,27053,125,114863,false,C-l-2 C-l-2 C-l-0 
job-2297,6,10,5,114707,141784,141841,27077,57,114876,false,C-m-1 C-l-1 C-m-2 C-m-0 C-l-1 
job-2293,2,5,6,114500,141711,141841,27211,130,114746,false,L-s-0 L-l-0 L-s-0 C-s-1 L-m-0 C-s-1 
job-2292,6,5,2,114454,141711,141885,27257,174,114921,false,L-m-0 L-l-0 
job-2298,2,4,8,114764,141784,141888,27020,104,115108,false,C-s-2 L-l-0 L-l-0 C-s-0 C-m-2 C-m-0 C-s-2 C-m-1 
job-2300,6,6,4,114863,141841,141905,26978,64,115027,false,C-m-1 C-m-2 C-l-1 C-m-0 
job-2299,3,4,4,114810,141836,141927,27026,91,115060,false,C-l-0 C-l-0 C-l-0 C-l-0 
job-2301,1,12,7,114916,141841,141935,26925,94,115048,false,C-s-0 C-l-1 C-l-2 C-l-1 C-l-2 C-l-2 C-l-1 
job-2302,6,9,3,114964,141885,141980,26921,95,115173,false,L-m-0 C-l-2 L-l-0 
job-2303,2,7,1,115021,141980,142074,26959,94,115257,false,L-s-0 
job-2304,2,7,8,115061,141980,142174,26919,194,115472,false,L-m-0 L-m-0 L-l-0 L-l-0 L-l-0 L-s-0 L-l-0 L-l-0 
job-2306,2,10,3,115161,142074,142199,26913,125,115338,false,C-m-0 C-s-1 C-m-0 
job-2305,2,4,4,115109,141980,142318,26871,338,115597,false,L-m-0 L-l-0 C-s-1 L-m-0 
job-2309,6,9,6,115309,142318,142380,27009,62,115505,false,C-l-0 C-l-2 C-l-1 C-l-2 C-l-0 C-l-1 
job-2307,5,8,1,115211,142318,142416,27107,98,115424,false,L-m-0 
job-2308,2,6,8,115266,142318,142506,27052,188,115696,false,L-s-0 L-l-0 L-s-0 L-l-0 L-l-0 L-l-0 L-l-0 L-m-0 
job-2310,6,12,7,115349,142380,142619,27031,239,115836,false,C-l-0 C-l-2 C-l-1 C-l-1 C-l-0 C-l-2 C-m-0 
job-2312,3,8,7,115449,142619,142631,27170,12,115603,false,C-l-2 C-l-0 C-l-2 C-l-0 C-l-2 C-l-0 C-l-0 
job-2311,4,4,8,115399,142619,142636,27220,17,115622,false,L-l-0 L-m-0 L-l-0 L-l-0 C-m-0 L-s-0 L-m-0 C-m-0 
job-2313,2,8,2,115500,142619,142683,27119,64,115852,false,C-s-0 C-l-2 
job-2314,4,8,3,115555,142683,142701,27128,18,115736,false,L-l-0 L-l-0 L-l-0 
job-2316,3,11,4,115668,142683,142711,27015,28,115708,false,L-s-0 L-m-0 C-s-1 C-s-2 
job-2315,5,7,1,115613,142683,142778,27070,95,115964,false,L-m-0 
job-2318,5,8,8,115772,142778,142792,27006,14,116008,false,C-m-0 L-l-0 C-l-1 C-l-0 C-l-0 L-l-0 C-l-1 L-m-0 
job-2317,1,10,1,115717,142683,142903,26966,220,115937,false,C-s-0 
job-2319,4,7,2,115813,142778,142937,26965,159,116109,false,L-s-0 C-s-1 
job-2321,6,6,3,115916,142903,142943,26987,40,116234,false,L-m-0 C-l-0 C-l-0 
job-2320,1,11,4,115863,142903,143000,27040,97,116217,false,L-l-0 L-l-0 L-l-0 L-l-0 
job-2322,3,8,4,115954,143000,143010,27046,10,116145,false,L-l-0 L-l-0 L-l-0 L-l-0 
job-2323,6,10,7,116003,143000,143023,26997,23,116188,false,C-l-0 C-l-0 C-l-1 L-m-0 C-l-1 C-l-2 C-l-2 
job-2324,5,11,1,116044,143000,143050,26956,50,116307,false,C-m-0 
job-2325,2,4,5,116079,143050,143065,26971,15,116129,false,L-l-0 L-l-0 L-l-0 L-l-0 L-l-0 
job-2326,6,12,6,116121,143050,143116,26929,66,116447,false,L-m-0 C-l-0 C-l-1 C-m-0 C-l-0 C-l-1 
job-2327,5,8,4,116178,143116,143132,26938,16,116445,false,L-m-0 L-l-0 L-l-0 C-m-0 
job-2328,2,12,6,116222,143116,143160,26894,44,116323,false,L-s-0 L-l-0 L-m-0 C-m-0 C-m-1 C-m-1 
job-2329,2,5,8,116271,143116,143182,26845,66,116469,false,C-l-0 C-l-0 C-l-0 C-l-0 C-l-0 C-l-0 C-s-1 C-m-1 
job-2330,2,12,1,116322,143182,143199,26860,17,116340,false,L-s-0 
job-2332,5,7,2,116452,143182,143224,26730,42,116643,false,C-l-2 C-l-2 
job-2331,5,7,7,116378,143182,143230,26804,48,116636,false,L-l-0 L-l-0 L-m-0 C-l-0 C-l-1 C-l-1 C-l-0 
job-2333,4,6,8,116499,143182,143468,26683,286,116909,false,C-m-1 C-s-1 C-s-2 C-m-2 C-m-0 C-m-1 C-m-2 C-m-0 
job-2334,3,12,6,116549,143468,143517,26919,49,116708,false,L-m-0 L-l-0 L-l-0 L-l-0 L-m-0 L-l-0 
job-2335,6,7,4,116589,143468,143991,26879,523,117236,false,C-l-0 C-l-1 C-l-1 C-l-0 
job-2336,1,11,5,116641,143991,144085,27350,94,116922,false,L-s-0 L-l-0 L-l-0 L-l-0 L-l-0 
job-2337,2,5,2,116689,144085,144100,27396,15,116842,false,L-s-0 L-s-0 
job-2338,2,12,5,116748,144085,144118,27337,33,116876,false,L-l-0 L-m-0 L-m-0 L-l-0 L-l-0 
job-2339,6,7,1,116794,144118,144254,27324,136,117035,false,L-m-0 
job-2341,2,7,5,116890,144254,144324,27364,70,117088,false,L-m-0 L-s-0 L-s-0 L-m-0 L-m-0 
job-2340,4,12,3,116841,144118,144356,27277,238,117100,false,L-l-0 L-l-0 L-l-0 
job-2342,2,5,2,116952,144356,144366,27404,10,117147,false,L-s-0 L-s-0 
job-2343,2,5,1,117005,144356,144413,27351,57,117250,false,L-m-0 
job-2345,4,7,2,117090,144356,144487,27266,131,117265,false,C-m-0 C-m-0 
job-2347,4,12,8,117195,144356,144510,27161,154,117571,false,C-l-1 C-l-0 C-l-0 C-s-2 C-l-0 C-m-1 C-s-0 C-m-1 
job-2346,2,9,4,117140,144356,144525,27216,169,117565,false,C-l-1 C-l-1 C-l-1 C-l-1 
job-2344,3,6,7,117052,144356,144571,27304,215,117397,false,L-l-0 L-m-0 L-m-0 C-s-1 L-l-0 L-l-0 L-l-0 
job-2348,1,5,5,117251,144487,144613,27236,126,117462,false,C-s-1 L-m-0 L-m-0 L-s-0 L-s-0 
job-2349,4,12,8,117303,144510,144631,27207,121,117597,false,C-l-2 C-l-2 C-l-0 C-l-0 C-l-0 C-l-2 C-s-2 C-l-1 
job-2350,2,7,7,117361,144631,144645,27270,14,117636,false,L-l-0 L-l-0 L-s-0 L-l-0 L-l-0 L-s-0 L-l-0 
job-2351,5,6,2,117415,144631,144689,27216,58,117744,false,C-m-0 L-m-0 
job-2352,4,11,6,117460,144631,144743,27171,112,117743,false,C-l-0 C-l-1 C-l-1 C-l-0 C-l-1 C-l-0 
job-2353,4,5,8,117511,144631,144978,27120,347,118016,false,C-m-2 C-l-2 C-s-1 C-l-2 C-l-2 C-m-1 C-m-2 C-m-1 
job-2354,4,11,8,117562,144978,145019,27416,41,117866,false,L-l-0 L-m-0 L-l-0 L-m-0 C-m-1 L-s-0 L-l-0 C-m-1 
job-2355,5,10,2,117609,144978,145068,27369,90,117783,false,C-l-0 C-l-0 
job-2356,1,6,5,117654,144978,145205,27324,227,118129,false,C-m-0 C-m-0 C-l-0 C-l-0 C-m-0 
job-2357,4,4,8,117707,145205,145292,27498,87,118010,false,L-m-0 L-l-0 L-l-0 L-l-0 C-m-0 L-s-0 L-m-0 C-m-0 
job-2358,5,7,8,117763,145205,145348,27442,143,118114,false,C-m-2 C-l-1 C-l-1 C-l-2 C-l-0 C-l-2 C-l-0 C-m-1 
job-2359,1,5,3,117811,145348,145426,27537,78,118114,false,L-s-0 L-s-0 L-s-0 
job-2360,6,8,4,117870,145348,145548,27478,200,118159,false,L-m-0 L-l-0 L-l-0 C-m-0 
job-2361,1,5,1,117920,145548,145594,27628,46,118041,false,L-s-0 
job-2362,1,8,4,117965,145548,145620,27583,72,118221,false,L-s-0 L-m-0 L-m-0 L-m-0 
job-2363,6,4,4,118027,145548,145952,27521,404,118538,false,C-l-0 C-l-0 L-l-0 L-l-0 
job-2368,5,9,7,118269,145952,145982,27683,30,118479,false,C-m-0 C-l-2 C-l-1 C-l-2 C-l-1 C-l-0 C-l-0 
job-2364,3,7,1,118068,145952,145994,27884,42,118220,false,L-s-0 
job-2367,2,7,5,118209,145952,146001,27743,49,118351,false,C-s-2 C-m-1 L-m-0 C-s-2 L-l-0 
job-2366,3,10,4,118157,145952,146004,27795,52,118453,false,L-m-0 C-m-1 L-m-0 C-m-1 
job-2369,2,6,6,118317,145982,146009,27665,27,118361,false,C-l-0 C-l-0 C-l-0 C-l-0 C-l-0 C-l-0 
job-2365,2,8,5,118113,145952,146031,27839,79,118337,false,L-l-0 L-l-0 L-l-0 L-l-0 L-l-0 
job-2370,5,12,6,118374,145982,146091,27608,109,118759,false,C-m-0 C-l-1 C-l-2 C-m-2 C-l-1 C-l-2 
job-2371,2,7,2,118421,146091,146109,27670,18,118673,false,L-s-0 L-s-0 
job-2373,2,7,4,118517,146091,146216,27574,125,118890,false,C-s-2 C-m-0 L-m-0 C-s-2 
job-2372,6,8,4,118471,146091,146243,27620,152,118754,false,L-m-0 L-l-0 L-l-0 C-m-0 
job-2374,4,7,1,118559,146216,146265,27657,49,118765,false,L-s-0 
job-2375,5,6,5,118608,146216,146278,27608,62,118835,false,C-m-1 C-l-0 C-l-1 C-l-0 C-l-1 
job-2376,2,12,2,118663,146278,146547,27615,269,119053,false,L-m-0 L-m-0 
job-2377,2,10,4,118716,146547,146623,27831,76,118830,false,L-l-0 L-l-0 L-l-0 L-l-0 
job-2378,2,4,5,118760,146547,146641,27787,94,118900,false,L-m-0 L-m-0 L-l-0 L-m-0 L-l-0 
job-2379,1,4,5,118805,146641,146663,27836,22,118854,false,L-m-0 L-m-0 L-m-0 L-m-0 L-m-0 
job-2380,5,6,3,118856,146641,146769,27785,128,119200,false,L-l-0 L-l-0 C-m-0 
job-2382,2,7,7,118954,146769,146824,27815,55,119055,false,L-l-0 L-l-0 L-l-0 L-m-0 L-l-0 L-l-0 L-l-0 
job-2381,2,11,2,118907,146769,146830,27862,61,119209,false,L-m-0 L-m-0 
job-2383,6,12,8,118985,146769,146845,27784,76,119324,false,C-m-0 C-l-2 C-l-0 C-l-1 C-l-0 C-l-1 C-l-2 C-m-1 
job-2385,1,4,1,119096,146845,146913,27749,68,119383,false,L-m-0 
job-2386,5,9,1,119146,146913,146954,27767,41,119222,false,L-m-0 
job-2387,6,10,8,119205,146913,146954,27708,41,119350,false,L-l-0 C-l-1 C-l-0 C-l-0 C-l-1 L-l-0 C-l-2 C-l-2 
job-2384,4,6,1,119035,146769,146956,27734,187,119353,false,L-s-0 
job-2388,3,5,3,119252,146913,147309,27661,396,119713,false,C-m-0 C-m-0 L-m-0 
job-2389,5,9,3,119300,147309,147337,28009,28,119372,false,L-l-0 L-l-0 L-m-0 
job-2390,5,5,6,119341,147309,147341,27968,32,119480,false,C-l-2 C-l-0 C-l-0 C-l-2 C-l-1 C-l-1 
job-2391,2,4,8,119397,147309,147367,27912,58,119540,false,L-s-0 C-l-1 C-s-1 L-l-0 C-l-0 L-m-0 L-s-0 C-s-1 
job-2392,3,11,1,119454,147367,147402,27913,35,119640,false,L-s-0 
job-2393,1,7,7,119507,147367,147442,27860,75,119786,false,L-l-0 L-l-0 L-l-0 L-l-0 L-l-0 L-l-0 L-m-0 
job-2394,5,6,1,119562,147442,147456,27880,14,119662,false,L-m-0 
job-2395,5,6,5,119617,147442,147507,27825,65,119717,false,C-m-0 L-l-0 L-l-0 C-l-0 C-l-0 
job-2396,4,6,4,119663,147442,147514,27779,72,119860,false,L-s-0 C-l-1 C-l-1 C-l-1 
job-2398,4,6,8,119771,147507,147664,27736,157,119929,false,L-m-0 C-l-0 L-l-0 L-l-0 C-l-0 L-l-0 C-l-0 L-m-0 
job-2397,6,4,4,119721,147442,147666,27721,224,120077,false,C-m-2 C-l-2 C-l-2 C-m-1 
job-2399,2,12,7,119812,147664,147709,27852,45,120066,false,C-m-2 L-s-0 L-l-0 L-l-0 L-l-0 L-l-0 C-m-1 
job-2400,3,10,8,119854,147709,147722,27855,13,120087,false,L-l-0 L-s-0 L-l-0 L-l-0 L-l-0 L-m-0 C-s-0 L-m-0 
job-2401,2,7,3,119901,147709,147844,27808,135,120222,false,C-s-1 L-m-0 C-s-1 
job-2404,3,12,8,120056,147844,147863,27788,19,120223,false,C-l-0 C-l-1 C-l-0 C-l-1 C-l-1 C-l-0 C-l-0 C-l-1 
job-2403,2,5,6,120011,147844,147868,27833,24,120261,false,L-s-0 C-s-1 L-m-0 L-m-0 L-m-0 C-s-1 
job-2402,2,11,5,119963,147844,147873,27881,29,120144,false,L-s-0 L-l-0 L-l-0 L-l-0 L-l-0 
job-2405,3,6,5,120108,147844,147914,27736,70,120297,false,C-s-2 C-l-2 C-l-2 C-l-2 C-l-2 
job-2406,3,4,4,120169,147914,147938,27745,24,120244,false,L-l-0 L-l-0 L-l-0 L-l-0 
job-2408,5,4,7,120251,147914,148011,27663,97,120354,false,C-l-0 C-l-0 C-l-1 C-l-2 C-l-1 L-m-0 C-l-2 
job-2409,1,4,2,120312,148011,148041,27699,30,120525,false,L-m-0 L-m-0 
job-2407,4,12,1,120215,147914,148058,27699,144,120379,false,L-s-0 
job-2410,6,6,5,120366,148011,148116,27645,105,120522,false,L-l-0 C-l-0 L-m-0 L-l-0 C-l-0 
job-2411,4,12,6,120419,148116,148135,27697,19,120660,false,L-m-0 L-s-0 L-l-0 L-l-0 L-m-0 L-l-0 
job-2412,3,6,3,120469,148116,148277,27647,161,120896,false,C-l-0 C-l-0 C-l-0 
job-2413,2,7,4,120511,148277,148309,27766,32,120658,false,L-m-0 L-m-0 L-m-0 L-m-0 
job-2414,2,5,6,120565,148277,148342,27712,65,120824,false,L-l-0 L-l-0 L-l-0 L-l-0 L-l-0 L-l-0 
job-2415,6,11,7,120610,148277,148652,27667,375,121175,false,C-l-0 C-l-1 C-l-1 C-m-0 C-l-2 C-l-0 C-l-2 
job-2417,5,12,4,120695,148652,148697,27957,45,120751,false,L-m-0 L-l-0 L-l-0 C-m-0 
job-2418,6,11,5,120745,148697,148710,27952,13,121028,false,L-l-0 L-l-0 L-m-0 C-l-0 C-l-0 
job-2419,6,5,1,120788,148697,148801,27909,104,121139,false,C-m-0 
job-2416,4,6,1,120647,148652,148804,28005,152,120989,false,L-s-0 
job-2420,1,12,4,120843,148697,148833,27854,136,121252,false,C-s-1 L-m-0 C-m-0 C-m-0 
job-2421,5,7,3,120890,148801,148842,27911,41,121125,false,L-l-0 C-m-0 L-m-0 
job-2422,2,12,1,120941,148842,148929,27901,87,121157,false,L-s-0 
job-2423,1,11,3,120991,148842,148979,27851,137,121203,false,L-l-0 L-l-0 L-l-0 
job-2424,2,12,1,121038,148979,149016,27941,37,121083,false,L-s-0 
job-2425,5,7,5,121087,148979,149090,27892,111,121458,false,L-l-0 L-l-0 C-l-0 L-m-0 C-l-0 
job-2426,6,6,6,121137,148979,149118,27842,139,121530,false,C-m-1 C-l-1 C-l-1 C-m-0 C-l-2 C-l-2 
job-2427,1,12,3,121187,149118,149338,27931,220,121656,false,L-l-0 L-l-0 L-l-0 
job-2428,3,7,2,121238,149338,149379,28100,41,121573,false,L-m-0 L-m-0 
job-2429,4,9,2,121285,149338,149380,28053,42,121625,false,L-l-0 L-l-0 
job-2430,5,12,6,121342,149338,149427,27996,89,121599,false,C-l-2 C-l-0 C-l-1 C-l-2 C-l-0 C-l-1 
job-2431,4,8,7,121376,149427,149461,28051,34,121593,false,L-l-0 L-m-0 L-s-0 L-l-0 L-m-0 L-l-0 C-s-1 
job-2432,5,9,6,121443,149427,149560,27984,133,121618,false,C-l-0 C-l-1 C-l-2 C-l-2 C-l-1 C-l-0 
job-2433,5,9,2,121488,149560,149629,28072,69,121742,false,L-l-0 L-l-0 
job-2435,1,5,8,121578,149560,149648,27982,88,121862,false,L-s-0 L-l-0 C-s-1 L-s-0 L-l-0 L-m-0 L-s-0 L-m-0 
job-2434,6,10,3,121531,149560,149663,28029,103,121868,false,L-m-0 C-l-0 C-l-0 
job-2436,1,5,1,121622,149663,149774,28041,111,121828,false,L-s-0 
job-2438,5,4,1,121730,149774,149869,28044,95,121945,false,L-m-0 
job-2437,1,4,1,121676,149774,149945,28098,171,122027,false,L-s-0 
job-2439,1,10,1,121778,149945,149957,28167,12,121828,false,L-s-0 
job-2440,3,6,8,121845,149945,150088,28100,143,122110,false,L-m-0 L-l-0 L-l-0 L-l-0 L-l-0 L-s-0 C-s-1 L-m-0 
job-2441,1,10,5,121889,150088,150152,28199,64,121995,false,L-s-0 L-l-0 L-l-0 L-l-0 L-l-0 
job-2443,6,5,4,121990,150088,150156,28098,68,122277,false,C-l-0 C-l-1 C-l-0 C-l-1 
job-2444,1,4,6,122024,150088,150159,28064,71,122190,false,C-s-1 L-l-0 L-s-0 L-m-0 C-s-1 L-m-0 
job-2446,4,10,8,122110,150152,150171,28042,19,122130,false,C-m-2 C-s-0 C-m-0 C-m-0 C-m-2 C-m-1 C-s-2 C-m-1 
job-2445,3,9,6,122067,150152,150171,28085,19,122358,false,L-l-0 C-l-2 C-l-2 C-l-2 L-l-0 L-s-0 
job-2447,5,9,1,122152,150156,150195,28004,39,122418,false,C-l-0 
job-2442,5,4,2,121937,150088,150211,28151,123,122283,false,L-m-0 L-l-0 
job-2448,3,12,2,122211,150211,150285,28000,74,122309,false,L-m-0 L-m-0 
job-2449,5,5,8,122265,150211,150289,27946,78,122553,false,C-l-2 C-l-1 C-l-0 C-l-0 C-l-1 L-l-0 C-l-2 L-l-0 
job-2450,2,9,4,122326,150289,150358,27963,69,122674,false,L-l-0 L-l-0 L-l-0 L-l-0 
job-2451,3,8,2,122384,150289,150499,27905,210,122870,false,L-s-0 L-l-0 
job-2452,1,6,5,122421,150499,150573,28078,74,122638,false,L-m-0 L-m-0 L-m-0 L-m-0 L-m-0 
job-2454,6,10,5,122516,150499,150608,27983,109,122674,false,C-m-1 C-l-0 C-l-0 C-l-1 C-l-1 
job-2455,6,5,8,122566,150608,150715,28042,107,122821,false,C-l-0 C-l-2 C-l-0 C-l-1 C-l-1 C-m-1 C-l-2 L-m-0 
job-2453,5,7,3,122466,150499,150807,28033,308,122904,false,L-l-0 L-l-0 C-m-0 
job-2456,6,10,2,122624,150807,150845,28183,38,122689,false,L-l-0 L-l-0 
job-2457,1,11,5,122690,150807,150908,28117,101,123058,false,L-s-0 L-m-0 C-m-0 C-m-0 L-m-0 
job-2458,5,11,1,122736,150908,150958,28172,50,122907,false,L-m-0 
job-2459,5,6,5,122786,150908,151503,28122,595,123611,false,C-m-0 L-l-0 L-l-0 C-l-0 C-l-0 
job-2460,4,6,6,122830,151503,151572,28673,69,123073,false,L-m-0 L-s-0 L-l-0 L-l-0 L-m-0 L-l-0 
job-2463,5,12,7,122983,151503,151664,28520,161,123375,false,C-l-1 C-l-0 C-l-1 C-l-2 C-l-0 C-l-2 C-m-2 
job-2461,1,4,8,122879,151503,151669,28624,166,123231,false,C-s-2 C-s-1 C-s-1 C-s-2 C-s-2 C-s-1 C-s-1 C-s-2 
job-2462,5,7,1,122932,151503,151679,28571,176,123150,false,C-m-0 
job-2464,2,11,2,123037,151664,151750,28627,86,123294,false,L-s-0 C-m-0 
job-2465,1,12,2,123095,151664,151851,28569,187,123385,false,L-m-0 C-m-0 
job-2466,4,11,2,123144,151851,151872,28707,21,123311,false,L-m-0 L-m-0 
job-2469,3,10,5,123288,151851,151909,28563,58,123534,false,L-s-0 C-l-0 C-l-0 C-l-0 C-l-0 
job-2468,6,10,3,123229,151851,151913,28622,62,123559,false,C-l-1 C-m-0 C-l-1 
job-2467,2,12,4,123184,151851,152015,28667,164,123608,false,L-l-0 L-l-0 L-l-0 L-l-0 
job-2471,5,7,6,123387,152015,152048,28628,33,123422,false,L-m-0 C-l-0 C-l-0 C-m-0 L-l-0 L-l-0 
job-2470,4,4,2,123338,151851,152103,28513,252,123846,false,C-m-1 C-m-1 
job-2473,6,11,6,123482,152048,152222,28566,174,123935,false,L-m-0 L-l-0 L-l-0 C-m-0 C-l-0 C-l-0 
job-2472,5,8,3,123433,152015,152415,28582,400,124110,false,C-m-2 C-l-1 C-l-1 
job-2474,3,5,1,123531,152415,152464,28884,49,123861,false,L-s-0 
job-2475,1,9,4,123573,152415,152510,28842,95,123679,false,L-m-0 L-m-0 L-s-0 L-m-0 
job-2477,4,12,8,123670,152464,152513,28794,49,123751,false,C-s-1 C-l-1 C-l-1 C-m-2 C-l-1 C-m-2 C-m-1 C-m-1 
job-2478,3,4,8,123718,152464,152755,28746,291,124223,false,C-l-0 C-l-0 C-l-0 C-l-2 C-l-2 L-s-0 C-l-2 C-l-0 
job-2479,6,7,8,123767,152755,152765,28988,10,124076,false,C-l-0 L-m-0 C-l-1 C-l-2 C-l-1 C-l-2 C-l-0 C-m-0 
job-2480,1,11,8,123824,152755,152784,28931,29,123913,false,L-s-0 C-m-0 C-m-2 C-s-1 C-m-2 C-m-1 C-m-0 C-m-1 
job-2476,2,5,7,123620,152415,152861,28795,446,124104,false,L-l-0 L-l-0 L-m-0 L-l-0 L-l-0 L-l-0 L-l-0 
job-2481,2,10,2,123882,152861,152943,28979,82,124107,false,L-m-0 L-m-0 
job-2482,1,5,7,123928,152861,153009,28933,148,124203,false,L-l-0 L-m-0 L-m-0 L-l-0 L-l-0 L-l-0 L-l-0 
job-2483,5,5,6,123974,152861,153018,28887,157,124335,false,C-m-0 C-l-1 C-l-1 C-l-0 C-l-0 L-l-0 
job-2484,2,11,3,124011,153018,153110,29007,92,124278,false,L-m-0 L-m-0 L-s-0 
job-2485,1,9,5,124072,153018,153124,28946,106,124239,false,L-l-0 L-l-0 L-m-0 L-l-0 L-l-0 
job-2486,2,4,6,124123,153124,153137,29001,13,124252,false,L-l-0 L-l-0 L-l-0 L-l-0 L-l-0 L-l-0 
job-2487,3,5,4,124161,153124,153501,28963,377,124685,false,L-s-0 L-m-0 C-s-1 L-m-0 
job-2488,3,9,4,124201,153501,153511,29300,10,124315,false,L-l-0 L-l-0 L-l-0 L-l-0 
job-2491,5,5,5,124325,153501,153530,29176,29,124523,false,C-m-0 C-l-1 C-l-1 C-l-0 C-l-0 
job-2490,1,5,6,124290,153501,153530,29211,29,124378,false,L-s-0 C-s-1 L-s-0 C-s-1 C-s-1 L-s-0 
job-2492,4,10,2,124379,153530,153550,29151,20,124459,false,L-l-0 L-l-0 
job-2489,4,7,2,124246,153501,153572,29255,71,124485,false,L-m-0 L-m-0 
job-2493,5,8,8,124429,153530,153702,29101,172,124606,false,C-m-1 C-l-1 C-l-0 C-l-2 C-l-1 C-l-2 C-l-0 C-m-0 
job-2494,3,8,8,124475,153702,153762,29227,60,124601,false,L-l-0 L-s-0 L-l-0 C-s-2 L-l-0 L-l-0 L-m-0 L-m-0 
job-2496,4,8,8,124589,153702,153811,29113,109,124784,false,C-m-0 C-l-2 C-l-2 C-l-2 C-m-1 C-m-0 C-s-1 C-m-1 
job-2495,4,9,6,124542,153702,153826,29160,124,124777,false,C-l-0 C-l-1 C-l-1 C-l-0 C-l-1 C-l-0 
job-2499,4,8,6,124744,153762,153901,29018,139,125002,false,C-s-0 C-s-2 L-m-0 C-m-2 C-m-2 L-m-0 
job-2497,3,6,4,124634,153762,153959,29128,197,125083,false,L-l-0 L-l-0 L-l-0 L-l-0 
job-2500,3,6,8,124809,153811,154016,29002,205,125266,false,C-l-2 C-l-2 C-l-2 C-l-2 C-m-0 C-m-1 C-m-1 C-m-0 
job-2498,1,4,3,124689,153762,154057,29073,295,125141,false,L-s-0 L-s-0 L-s-0 
job-2501,2,10,1,124849,154016,154061,29167,45,125100,false,L-m-0 
job-2504,6,12,7,125001,154057,154069,29056,12,125122,false,L-l-0 C-l-1 C-l-1 C-l-2 C-l-0 C-l-2 C-l-0 
job-2502,1,8,4,124902,154057,154078,29155,21,124973,false,L-s-0 L-m-0 L-s-0 L-m-0 
job-2503,1,8,4,124959,154057,154098,29098,41,125097,false,L-l-0 L-l-0 L-l-0 L-l-0 
job-2506,5,9,1,125115,154057,154126,28942,69,125362,false,C-m-1 
job-2507,2,8,4,125159,154057,154153,28898,96,125349,false,C-m-1 C-m-2 C-m-2 C-m-2 
job-2505,1,5,7,125059,154057,154168,28998,111,125377,false,C-m-0 C-m-0 L-m-0 C-m-0 C-m-0 C-m-0 C-m-0 
job-2508,3,4,1,125212,154057,154246,28845,189,125533,false,C-s-1 
job-2509,6,11,1,125262,154246,154283,28984,37,125309,false,L-m-0 
job-2510,3,5,4,125309,154246,154402,28937,156,125674,false,L-l-0 L-l-0 L-l-0 L-l-0 
job-2511,3,11,4,125342,154402,154419,29060,17,125581,false,L-l-0 L-l-0 L-l-0 L-l-0 
job-2512,2,11,1,125388,154402,154501,29014,99,125525,false,L-s-0 
job-2513,1,8,3,125444,154501,154520,29057,19,125614,false,L-m-0 L-m-0 L-m-0 
job-2514,6,12,4,125493,154501,154755,29008,254,125796,false,L-l-0 C-l-0 C-l-0 L-l-0 
job-2515,3,10,4,125539,154501,154860,28962,359,126020,false,C-l-1 C-l-1 C-l-1 C-l-1 
job-2517,6,8,4,125640,154860,154871,29220,11,125770,false,C-l-0 C-l-0 C-l-1 C-l-1 
job-2516,3,12,7,125597,154755,154889,29158,134,125750,false,L-s-0 L-m-0 L-l-0 L-m-0 L-l-0 L-l-0 L-l-0 
job-2518,5,5,3,125696,154860,155067,29164,207,125916,false,C-l-2 C-l-2 C-m-0 
job-2519,5,12,8,125743,154889,155070,29146,181,126033,false,C-m-1 L-l-0 C-l-1 C-l-0 C-l-0 L-l-0 C-l-1 L-m-0 
job-2520,4,6,2,125795,154889,155097,29094,208,126235,false,L-s-0 C-s-1 
job-2521,6,7,2,125851,155067,155126,29216,59,125985,false,C-l-2 C-l-2 
job-2523,3,6,3,125965,155097,155130,29132,33,126069,false,L-l-0 L-l-0 L-l-0 
job-2522,1,6,5,125916,155097,155133,29181,36,125967,false,L-m-0 L-m-0 L-m-0 L-m-0 L-m-0 
job-2524,6,6,2,126031,155097,155228,29066,131,126415,false,C-l-0 C-l-0 
job-2525,3,11,5,126088,155097,155331,29009,234,126412,false,C-l-1 L-l-0 C-l-1 C-l-1 C-l-1 
job-2526,2,9,8,126135,155331,155341,29196,10,126382,false,L-l-0 L-l-0 L-l-0 L-l-0 L-l-0 L-m-0 L-m-0 L-m-0 
job-2527,4,12,5,126192,155331,155362,29139,31,126395,false,L-s-0 C-l-1 C-l-1 C-s-1 C-l-1 
job-2528,6,4,5,126241,155331,155431,29090,100,126437,false,C-l-0 C-l-0 C-l-2 C-m-0 C-l-2 
job-2529,6,7,5,126283,155341,155466,29058,125,126687,false,C-m-2 L-m-0 L-l-0 C-m-1 L-l-0 
job-2531,3,12,5,126389,155431,155473,29042,42,126543,false,C-s-2 C-l-1 C-l-1 C-l-1 C-l-1 
job-2530,4,6,2,126338,155431,155474,29093,43,126628,false,L-s-0 C-s-1 
job-2532,1,11,6,126437,155466,155486,29029,20,126648,false,L-m-0 L-l-0 L-l-0 L-m-0 L-l-0 L-l-0 
job-2534,4,12,7,126538,155466,155521,28928,55,126815,false,C-m-0 C-l-2 C-l-2 C-m-1 C-l-2 C-m-1 C-m-0 
job-2533,1,10,6,126492,155466,155568,28974,102,126693,false,L-m-0 C-l-0 C-s-0 C-l-0 C-l-0 C-l-0 
job-2535,2,10,8,126588,155473,155603,28885,130,126804,false,C-s-2 C-l-1 C-l-1 C-l-1 C-l-1 C-m-2 C-m-2 C-m-2 
job-2536,3,10,4,126634,155521,155604,28887,83,126938,false,L-m-0 L-l-0 L-l-0 L-m-0 
job-2537,5,11,5,126673,155521,155893,28848,372,127271,false,C-m-0 C-l-2 L-l-0 C-m-1 C-l-2 
job-2538,3,4,7,126721,155893,155924,29172,31,126921,false,L-s-0 L-l-0 L-l-0 L-m-0 L-l-0 L-l-0 L-m-0 
job-2540,5,7,6,126832,155924,156032,29092,108,127112,false,L-m-0 C-l-1 C-l-0 C-l-1 C-l-0 L-l-0 
job-2542,5,12,7,126930,156032,156098,29102,66,127095,false,C-m-1 C-l-1 C-l-0 C-l-0 C-l-1 L-l-0 L-m-0 
job-2541,4,10,6,126869,155924,156159,29055,235,127318,false,L-s-0 C-l-2 C-l-2 C-m-0 C-l-2 C-m-0 
job-2539,1,11,3,126772,155924,156357,29152,433,127380,false,L-l-0 L-l-0 L-l-0 
job-2543,3,9,1,126981,156357,156455,29376,98,127133,false,L-s-0 
job-2546,4,6,5,127148,156455,156468,29307,13,127347,false,C-m-0 C-l-2 C-l-2 C-m-0 C-l-2 
job-2544,3,11,3,127025,156455,156470,29430,15,127127,false,L-m-0 L-m-0 L-s-0 
job-2545,4,7,7,127087,156455,156481,29368,26,127186,false,L-l-0 C-l-1 C-l-1 C-s-1 C-l-1 L-l-0 L-l-0 
job-2548,3,9,1,127231,156468,156544,29237,76,127503,false,C-s-0 
job-2547,4,8,6,127201,156455,156546,29254,91,127351,false,C-s-2 C-l-0 C-l-0 C-m-1 C-l-0 C-m-1 
job-2551,6,8,7,127377,156546,156568,29169,22,127609,false,C-l-0 C-l-0 C-l-1 C-m-0 C-l-2 C-l-1 C-l-2 
job-2550,4,10,4,127333,156544,156574,29211,30,127600,false,C-s-0 L-m-0 L-s-0 L-m-0 
job-2549,5,11,2,127282,156544,156586,29262,42,127539,false,L-l-0 L-l-0 
job-2552,5,11,3,127442,156568,156678,29126,110,127575,false,C-m-0 C-l-1 C-l-1 
job-2553,6,9,7,127484,156678,156702,29194,24,127725,false,L-m-0 C-l-0 C-l-1 L-l-0 C-l-0 C-l-1 L-l-0 
job-2554,4,5,7,127525,156678,156729,29153,51,127697,false,L-s-0 C-l-2 C-l-2 C-m-1 C-l-2 C-s-1 C-m-1 
job-2555,4,12,4,127591,156678,156762,29087,84,127870,false,C-m-0 C-m-0 C-m-2 C-m-2 
job-2556,1,5,5,127631,156678,156820,29047,142,128053,false,C-s-2 L-m-0 L-m-0 C-s-2 C-s-2 
job-2557,3,11,2,127681,156820,156866,29139,46,128009,false,L-m-0 L-m-0 
job-2559,4,9,6,127792,156820,156907,29028,87,128031,false,L-s-0 C-l-2 C-l-2 C-m-0 C-l-2 C-m-0 
job-2558,5,10,6,127742,156820,156954,29078,134,127958,false,C-l-1 L-l-0 C-l-0 C-l-1 C-l-0 L-l-0 
job-2560,4,7,1,127841,156954,156964,29113,10,128007,false,L-s-0 
job-2561,1,5,7,127887,156954,156966,29067,12,127955,false,L-l-0 L-l-0 L-l-0 L-l-0 L-l-0 L-l-0 L-l-0 
job-2563,4,11,4,127981,156954,157019,28973,65,128198,false,L-m-0 C-l-0 C-l-0 C-l-0 
job-2566,1,11,7,128129,156964,157031,28835,67,128241,false,L-s-0 C-l-1 C-l-1 C-m-0 C-l-2 C-l-2 C-m-0 
job-2565,5,8,4,128069,156954,157044,28885,90,128445,false,C-l-1 C-l-2 C-l-1 C-l-2 
job-2564,1,6,4,128023,156954,157055,28931,101,128188,false,C-s-0 L-m-0 L-m-0 C-s-0 
job-2562,2,8,2,127933,156954,157065,29021,111,128119,false,L-m-0 L-l-0 
job-2567,6,12,8,128181,157044,157141,28863,97,128504,false,C-l-0 C-l-2 C-l-0 C-l-1 C-l-1 L-l-0 C-l-2 C-m-0 
job-2568,5,9,7,128235,157141,157158,28906,17,128486,false,C-l-1 L-l-0 C-l-0 C-l-1 C-l-0 L-l-0 L-m-0 
job-2569,1,11,5,128294,157158,157374,28864,216,128533,false,L-s-0 L-l-0 L-l-0 L-l-0 L-l-0 
job-2571,5,4,3,128382,157374,157395,28992,21,128414,false,C-m-0 C-l-0 C-l-0 
job-2570,2,9,7,128330,157374,157405,29044,31,128544,false,L-m-0 L-l-0 L-l-0 L-l-0 L-l-0 L-l-0 L-m-0 
job-2573,3,11,8,128473,157395,157493,28922,98,128656,false,C-l-0 C-l-0 C-l-0 C-l-2 C-l-0 C-l-2 C-l-2 C-l-2 
job-2574,5,8,3,128516,157395,157494,28879,99,128831,false,C-m-1 C-l-1 C-l-1 
job-2572,1,10,5,128425,157395,157581,28970,186,128853,false,L-s-0 L-m-0 C-m-0 C-m-0 C-m-0 
job-2575,2,5,5,128567,157581,157595,29014,14,128867,false,L-l-0 L-l-0 L-l-0 L-l-0 L-l-0 
job-2577,5,12,4,128658,157581,157654,28923,73,128829,false,C-l-0 C-l-1 C-l-1 C-l-0 
job-2576,3,9,8,128612,157581,157654,28969,73,128827,false,L-s-0 C-l-2 C-l-2 C-l-2 L-m-0 L-m-0 C-s-2 C-l-2 
job-2579,5,10,4,128754,157654,157665,28900,11,128783,false,L-l-0 C-l-0 C-l-0 L-l-0 
job-2578,2,8,2,128703,157654,157684,28951,30,128970,false,L-l-0 L-m-0 
job-2580,5,5,5,128796,157654,157749,28858,95,129012,false,C-m-1 C-l-1 C-m-2 C-m-0 C-l-1 
job-2581,3,7,5,128848,157749,157779,28901,30,128959,false,L-l-0 L-s-0 L-l-0 L-l-0 L-l-0 
job-2584,1,4,5,128990,157749,157841,28759,92,129102,false,C-s-2 L-s-0 C-s-2 C-s-2 C-s-2 
job-2582,2,8,6,128898,157749,157847,28851,98,129167,false,L-m-0 L-m-0 L-m-0 C-s-1 L-m-0 C-s-1 
job-2583,4,9,2,128939,157749,157856,28810,107,129303,false,C-m-0 C-m-0 
job-2585,6,10,6,129039,157749,157860,28710,111,129279,false,C-l-0 C-l-0 C-l-1 C-l-2 C-l-1 C-l-2 
job-2586,5,9,5,129086,157847,157927,28761,80,129188,false,L-m-0 L-l-0 C-m-2 C-m-1 L-l-0 
job-2588,3,12,8,129207,157860,157998,28653,138,129359,false,C-l-0 C-l-0 C-l-0 C-l-1 C-l-1 C-l-1 C-l-0 C-l-1 
job-2587,3,8,5,129145,157847,158038,28702,191,129482,false,L-s-0 C-s-2 L-m-0 C-m-1 C-m-2 
job-2589,6,10,2,129249,157998,158065,28749,67,129500,false,L-l-0 L-l-0 
job-2590,1,7,7,129294,158038,158079,28744,41,129413,false,L-m-0 L-m-0 L-m-0 C-s-1 L-m-0 L-s-0 L-s-0 
job-2591,5,12,3,129345,158038,158223,28693,185,129549,false,C-m-0 C-l-0 C-l-0 
job-2592,6,4,4,129388,158223,158254,28835,31,129506,false,L-m-0 L-l-0 L-l-0 C-m-0 
job-2593,4,11,4,129438,158223,158256,28785,33,129595,false,C-s-1 C-s-2 L-s-0 C-s-0 
job-2594,2,12,5,129504,158254,158271,28750,17,129526,false,L-l-0 L-m-0 L-m-0 L-l-0 L-l-0 
job-2595,3,8,8,129546,158254,158495,28708,241,130018,false,C-l-1 C-l-1 C-l-1 L-m-0 C-l-1 L-l-0 C-m-0 C-m-0 
job-2597,5,11,1,129643,158495,158516,28852,21,129740,false,C-m-0 
job-2596,3,12,6,129591,158495,158527,28904,32,129722,false,L-m-0 L-l-0 L-l-0 L-l-0 L-m-0 L-l-0 
job-2598,3,7,1,129700,158516,158552,28816,36,129982,false,L-s-0 
job-2599,4,4,4,129757,158516,159101,28759,585,130342,false,C-l-1 C-l-1 C-l-1 C-s-1 
job-2602,2,9,6,129908,159101,159173,29193,72,130223,false,C-s-2 C-l-0 C-l-0 C-l-0 C-l-0 C-l-0 
job-2600,3,4,8,129810,159101,159183,29291,82,130067,false,L-m-0 L-l-0 L-s-0 L-l-0 L-l-0 L-l-0 C-s-1 L-m-0 
job-2603,5,5,4,129965,159173,159195,29208,22,130200,false,C-l-0 C-l-1 C-l-1 C-l-0 
job-2605,6,5,1,130064,159183,159237,29119,54,130164,false,C-m-1 
job-2601,2,8,4,129856,159101,159242,29245,141,130164,false,C-m-0 L-m-0 C-m-0 C-m-0 
job-2604,6,7,5,130019,159183,159257,29164,74,130281,false,L-m-0 C-l-2 C-l-2 L-l-0 L-l-0 
job-2606,2,6,2,130117,159257,159267,29140,10,130150,false,L-s-0 L-s-0 
job-2607,5,5,5,130162,159257,159471,29095,214,130512,false,L-l-0 L-l-0 C-l-0 L-m-0 C-l-0 
job-2608,1,5,6,130214,159471,159519,29257,48,130282,false,L-m-0 L-m-0 L-m-0 L-m-0 L-m-0 L-m-0 
job-2609,1,11,6,130257,159471,159615,29214,144,130458,false,C-s-1 L-l-0 L-l-0 L-s-0 L-l-0 L-l-0 
job-2610,4,10,6,130313,159471,159696,29158,225,130581,false,C-l-0 C-l-2 C-l-2 C-l-0 C-l-0 C-l-2 
job-2611,4,11,1,130351,159615,159750,29264,135,130557,false,L-s-0 
job-2612,2,6,2,130406,159750,159762,29344,12,130681,false,L-s-0 L-s-0 
job-2614,6,5,4,130505,159750,159766,29245,16,130612,false,C-l-2 C-l-0 C-l-0 C-l-2 
job-2613,5,9,3,130452,159750,159783,29298,33,130655,false,L-l-0 L-m-0 L-l-0 
job-2615,2,6,6,130555,159750,159813,29195,63,130700,false,L-m-0 C-m-0 L-l-0 C-m-0 C-m-0 C-m-0 
job-2616,2,10,8,130603,159750,159820,29147,70,130852,false,C-s-2 C-l-1 C-l-1 C-l-1 C-m-1 C-m-1 C-l-1 C-m-1 
job-2617,3,7,1,130651,159820,159844,29169,24,130923,false,L-s-0 
job-2618,3,5,8,130707,159820,160294,29113,474,131419,false,C-m-0 L-l-0 L-l-0 L-l-0 L-l-0 L-m-0 C-m-0 L-m-0 
job-2620,3,11,8,130812,160294,160410,29482,116,131023,false,C-s-2 L-l-0 L-l-0 C-s-0 L-l-0 L-l-0 L-s-0 L-m-0 
job-2619,5,6,1,130756,160294,160517,29538,223,131114,false,L-m-0 
job-2621,6,7,1,130861,160517,160533,29656,16,130929,false,L-m-0 
job-2622,1,6,7,130898,160517,160546,29619,29,131147,false,L-l-0 L-m-0 L-m-0 L-l-0 L-l-0 L-l-0 L-l-0 
job-2623,4,9,4,130950,160517,160635,29567,118,131184,false,C-m-0 L-l-0 L-s-0 C-m-0 
job-2624,3,11,8,130991,160517,160968,29526,451,131490,false,C-l-1 C-l-1 C-l-2 C-l-2 C-l-2 C-l-1 C-l-1 C-l-2 
job-2626,5,10,6,131096,160968,161046,29872,78,131244,false,C-l-2 L-l-0 C-l-0 C-l-2 C-l-0 L-l-0 
job-2625,6,4,1,131044,160968,161055,29924,87,131321,false,L-m-0 
job-2627,1,12,5,131147,161046,161079,29899,33,131288,false,L-l-0 L-m-0 L-m-0 L-l-0 L-l-0 
job-2628,4,12,1,131212,161079,161106,29867,27,131432,false,L-s-0 
job-2629,5,8,4,131261,161079,161271,29818,192,131725,false,L-m-0 L-l-0 L-l-0 C-m-0 
job-2630,5,10,2,131313,161271,161296,29958,25,131588,false,L-l-0 L-l-0 
job-2631,2,12,6,131368,161271,161539,29903,268,131804,false,L-s-0 L-m-0 L-m-0 C-m-0 C-m-0 L-l-0 
job-2635,2,12,8,131561,161539,161562,29978,23,131865,false,C-m-0 C-l-0 C-l-1 C-l-1 C-l-1 C-l-0 C-l-0 C-l-0 
job-2634,1,10,3,131518,161539,161575,30021,36,131692,false,C-m-0 L-m-0 C-m-0 
job-2632,1,10,4,131421,161539,161603,30118,64,131670,false,L-l-0 L-l-0 L-l-0 L-l-0 
job-2633,3,11,3,131468,161539,161636,30071,97,131622,false,L-s-0 L-m-0 L-m-0 
job-2636,5,9,3,131619,161539,161647,29920,108,131750,false,C-l-2 C-l-1 C-l-2 
job-2637,6,10,4,131668,161562,161664,29894,102,131920,false,C-m-0 C-l-0 C-l-1 C-l-0 
job-2638,2,10,2,131726,161664,161677,29938,13,131831,false,L-m-0 L-m-0 
job-2639,6,5,6,131770,161664,161769,29894,105,132171,false,C-l-0 C-l-1 C-l-1 L-l-0 C-l-0 L-l-0 
job-2641,1,12,6,131858,161664,161881,29806,217,132142,false,C-m-0 C-m-1 C-s-1 C-m-1 C-m-0 L-s-0 
job-2640,3,4,6,131812,161664,161981,29852,317,132258,false,L-s-0 C-l-2 C-l-2 L-m-0 C-l-2 C-l-2 
job-2642,3,9,1,131910,161981,162097,30071,116,132177,false,L-s-0 
job-2644,6,12,7,132001,162097,162120,30096,23,132257,false,C-l-0 C-l-0 C-l-1 C-m-1 C-l-1 C-l-2 C-l-2 
job-2643,4,8,7,131950,161981,162133,30031,152,132317,false,L-m-0 L-m-0 L-l-0 C-m-0 L-l-0 L-l-0 C-m-0 
job-2645,6,6,6,132052,162120,162187,30068,67,132313,false,C-l-0 C-l-0 C-l-1 C-l-2 C-l-2 C-l-1 
job-2646,4,11,3,132103,162187,162203,30084,16,132273,false,L-m-0 L-m-0 L-s-0 
job-2649,4,6,3,132244,162187,162243,29943,56,132565,false,C-l-0 C-l-0 C-l-0 
job-2648,2,8,6,132196,162187,162262,29991,75,132408,false,C-m-0 L-l-0 L-l-0 C-m-0 L-l-0 C-m-0 
job-2647,5,6,1,132152,162187,162273,30035,86,132484,false,L-l-0 
job-2650,1,7,4,132293,162243,162281,29950,38,132623,false,L-s-0 L-s-0 L-l-0 C-m-0 
job-2651,3,11,7,132335,162243,162341,29908,98,132688,false,L-m-0 C-l-1 C-l-1 L-m-0 C-l-1 C-l-1 C-s-1 
job-2652,1,7,4,132387,162341,162388,29954,47,132531,false,L-m-0 L-m-0 L-m-0 L-m-0 
job-2653,2,7,8,132443,162341,162931,29898,590,133073,false,L-l-0 L-l-0 L-s-0 L-l-0 L-l-0 L-s-0 L-l-0 L-l-0 
job-2656,3,6,7,132577,162931,162976,30354,45,132881,false,L-m-0 C-l-1 C-l-1 C-m-0 C-l-1 C-l-1 C-m-0 
job-2657,3,4,8,132630,162976,162991,30346,15,132716,false,L-m-0 C-l-0 C-l-1 C-l-0 C-l-1 C-l-1 C-l-0 C-l-0 
job-2654,2,12,5,132484,162931,162996,30447,65,132842,false,L-l-0 L-s-0 L-l-0 L-l-0 L-l-0 
job-2655,2,4,3,132533,162931,163040,30398,109,132801,false,L-m-0 L-m-0 L-s-0 
job-2658,1,9,8,132685,162976,163045,30291,69,132952,false,C-l-2 C-l-1 C-l-1 C-l-2 C-l-2 C-l-1 L-m-0 C-l-2 
job-2659,3,5,7,132723,163045,163076,30322,31,132809,false,L-s-0 L-l-0 L-l-0 L-m-0 L-l-0 L-l-0 L-m-0 
job-2660,2,12,3,132773,163045,163101,30272,56,133071,false,C-m-0 L-m-0 C-m-0 
job-2661,4,4,3,132827,163045,163193,30218,148,133034,false,C-m-1 C-m-1 C-m-0 
job-2662,4,10,5,132877,163193,163232,30316,39,133200,false,L-m-0 L-l-0 L-l-0 L-l-0 L-m-0 
job-2663,3,12,3,132923,163193,163294,30270,101,133184,false,L-s-0 C-m-0 C-m-0 
job-2664,3,8,6,132972,163193,163478,30221,285,133300,false,C-l-1 C-l-1 C-l-1 C-m-1 C-l-1 C-m-1 
job-2665,1,6,8,133028,163478,163596,30450,118,133303,false,L-l-0 L-l-0 L-l-0 L-l-0 L-l-0 L-l-0 L-l-0 L-l-0 
job-2666,2,5,7,133082,163478,163616,30396,138,133363,false,C-m-0 L-m-0 L-m-0 C-m-0 C-m-0 L-m-0 C-m-0 
job-2667,6,6,2,133127,163478,163866,30351,388,133619,false,C-l-0 C-l-0 
job-2668,1,10,7,133169,163866,163919,30697,53,133387,false,L-m-0 L-l-0 L-l-0 L-m-0 L-l-0 L-l-0 L-m-0 
job-2670,4,7,7,133285,163866,163929,30581,63,133464,false,L-s-0 C-l-2 C-l-0 C-l-2 C-l-0 C-l-0 C-l-2 
job-2672,1,12,8,133368,163866,163974,30498,108,133476,false,C-m-0 C-s-0 C-m-2 C-s-1 C-m-1 C-m-2 C-s-2 C-m-0 
job-2671,6,9,3,133327,163866,164001,30539,135,133641,false,C-m-1 C-l-1 C-l-1 
job-2669,6,6,2,133229,163866,164066,30637,200,133442,false,C-m-0 L-l-0 
job-2673,6,12,2,133420,164066,164089,30646,23,133526,false,L-l-0 L-l-0 
job-2675,3,5,8,133514,164066,164135,30552,69,133837,false,L-s-0 C-l-1 C-l-1 C-l-1 C-l-1 C-m-0 C-m-0 L-m-0 
job-2674,1,8,3,133471,164066,164166,30595,100,133805,false,L-m-0 L-m-0 L-m-0 
job-2676,1,5,4,133556,164066,164491,30510,425,134065,false,L-s-0 C-m-0 C-s-1 C-m-0 
job-2677,4,12,4,133601,164491,164520,30890,29,133654,false,L-l-0 L-l-0 L-s-0 L-l-0 
job-2678,1,6,1,133652,164491,164557,30839,66,133822,false,L-m-0 
job-2679,2,12,7,133704,164491,164594,30787,103,134032,false,L-m-0 C-l-0 C-l-0 L-m-0 C-l-0 C-l-0 C-s-1 
job-2680,2,7,2,133761,164594,164606,30833,12,133995,false,L-s-0 L-s-0 
job-2681,2,12,8,133811,164594,164694,30783,100,134124,false,C-m-0 L-l-0 L-l-0 L-l-0 L-l-0 L-m-0 C-m-0 L-m-0 
job-2683,4,7,4,133907,164594,164794,30687,200,134296,false,C-m-1 L-m-0 C-m-1 C-m-0 
job-2687,6,4,5,134123,164794,164827,30671,33,134190,false,C-l-0 C-l-1 C-l-0 C-m-0 C-l-1 
job-2682,2,9,8,133859,164594,164845,30735,251,134186,false,C-l-2 C-l-2 C-l-2 C-l-2 C-l-2 C-m-2 C-m-2 C-m-2 
job-2688,2,6,4,134180,164827,164885,30647,58,134308,false,C-s-0 C-s-2 C-s-0 L-m-0 
job-2684,4,5,1,133962,164794,164891,30832,97,134114,false,L-s-0 
job-2686,3,9,4,134081,164794,164898,30713,104,134478,false,L-l-0 L-l-0 L-l-0 L-l-0 
job-2689,6,8,8,134229,164845,164952,30616,107,134379,false,C-l-0 C-l-1 C-l-2 C-l-1 C-l-0 C-m-0 C-l-2 C-m-1 
job-2685,2,7,3,134034,164794,164971,30760,177,134456,false,L-m-0 L-m-0 L-m-0 
job-2690,6,4,6,134273,164952,165068,30679,116,134465,false,C-l-0 C-l-1 C-l-1 L-l-0 C-l-0 L-l-0 
job-2692,6,12,6,134390,165068,165088,30678,20,134559,false,C-m-0 C-l-0 L-l-0 L-m-0 C-l-0 L-l-0 
job-2691,6,9,2,134329,164952,165099,30623,147,134537,false,C-l-2 C-l-2 
job-2694,6,4,2,134469,165068,165164,30599,96,134818,false,C-m-1 C-m-2 
job-2693,4,9,5,134426,165068,165184,30642,116,134699,false,L-s-0 C-l-1 C-l-1 C-s-1 C-l-1 
job-2695,4,9,7,134521,165088,165620,30567,532,135078,false,L-m-0 L-l-0 L-m-0 C-m-0 L-l-0 L-l-0 C-m-0 
job-2696,6,12,1,134579,165620,165632,31041,12,134730,false,L-m-0 
job-2697,1,10,6,134643,165620,165633,30977,13,134813,false,L-l-0 L-m-0 L-m-0 L-l-0 L-l-0 L-l-0 
job-2698,3,4,7,134685,165620,165644,30935,24,134892,false,L-l-0 C-l-0 C-l-0 L-s-0 C-l-0 C-l-0 L-l-0 
job-2699,6,10,2,134732,165620,165744,30888,124,134866,false,C-l-1 C-l-1 
job-2700,1,5,2,134789,165744,165765,30955,21,134904,false,L-s-0 L-s-0 
job-2701,5,5,1,134841,165744,165820,30903,76,135191,false,L-m-0 
job-2704,6,8,4,134978,165744,165869,30766,125,135304,false,C-l-0 C-l-0 C-l-1 C-l-1 
job-2703,3,8,7,134933,165744,165878,30811,134,135083,false,L-l-0 C-l-2 C-l-2 C-l-2 C-l-2 L-l-0 C-s-2 
job-2702,2,8,3,134883,165744,165887,30861,143,135309,false,L-l-0 L-m-0 L-l-0 
job-2705,3,9,2,135023,165887,165934,30864,47,135156,false,L-m-0 L-m-0 
job-2706,5,8,6,135086,165887,165996,30801,109,135411,false,C-l-1 L-l-0 C-l-0 C-l-1 C-l-0 L-l-0 
job-2707,2,11,5,135130,165934,166007,30804,73,135406,false,L-m-0 C-l-1 L-l-0 L-m-0 C-l-0 
job-2708,6,6,3,135173,166007,166025,30834,18,135194,false,L-l-0 L-l-0 L-m-0 
job-2711,4,12,3,135349,166007,166050,30658,43,135550,false,C-m-0 C-s-0 C-m-0 
job-2709,2,4,5,135234,166007,166085,30773,78,135345,false,C-s-1 L-s-0 L-m-0 C-s-1 L-s-0 
job-2710,1,4,4,135290,166007,166114,30717,107,135497,false,C-s-2 C-s-2 C-s-2 C-s-2 
job-2712,4,6,2,135386,166007,166179,30621,172,135843,false,C-m-1 C-m-1 
job-2713,3,9,1,135438,166179,166197,30741,18,135672,false,L-s-0 
job-2714,5,10,6,135488,166179,166272,30691,93,135752,false,L-m-0 C-l-0 L-l-0 C-m-0 C-l-0 L-l-0 
job-2715,2,4,2,135537,166272,166291,30735,19,135710,false,L-s-0 L-s-0 
job-2716,2,9,1,135584,166272,166498,30688,226,135841,false,L-m-0 
job-2718,3,4,7,135678,166498,166618,30820,120,135892,false,L-m-0 L-m-0 L-l-0 L-s-0 L-l-0 L-l-0 L-l-0 
job-2717,1,11,1,135623,166498,166620,30875,122,135955,false,L-s-0 
job-2719,3,6,6,135743,166498,166745,30755,247,136276,false,C-m-0 C-l-1 C-l-1 C-m-0 C-l-1 C-l-1 
job-2720,5,4,5,135800,166745,166759,30945,14,136084,false,L-l-0 L-l-0 C-l-0 L-m-0 C-l-0 
job-2721,4,11,4,135855,166745,166815,30890,70,136206,false,L-s-0 C-s-1 C-m-2 C-m-2 
job-2722,5,4,3,135911,166745,166890,30834,145,136233,false,C-m-0 C-l-1 C-l-1 
job-2723,1,4,1,135958,166890,166932,30932,42,136065,false,L-s-0 
job-2724,1,4,3,136011,166932,167018,30921,86,136347,false,L-s-0 L-s-0 L-s-0 
job-2726,6,8,1,136114,166932,167112,30818,180,136507,false,C-m-0 
job-2725,2,12,7,136067,166932,167167,30865,235,136554,false,L-m-0 L-m-0 L-l-0 L-l-0 L-l-0 L-l-0 C-s-1 
job-2728,2,9,6,136226,167167,167263,30941,96,136611,false,L-m-0 L-l-0 L-l-0 L-l-0 L-l-0 L-l-0 
job-2727,2,4,2,136168,167167,167264,30999,97,136383,false,L-s-0 L-s-0 
job-2729,2,12,5,136259,167263,167277,31004,14,136323,false,L-l-0 L-m-0 L-m-0 L-l-0 L-l-0 
job-2731,6,12,8,136377,167277,167299,30900,22,136501,false,L-l-0 C-l-1 C-l-2 C-l-1 C-l-2 L-m-0 C-m-1 C-m-0 
job-2730,6,7,3,136317,167263,167317,30946,54,136584,false,C-l-0 C-l-0 L-l-0 
job-2732,6,9,6,136409,167299,167404,30890,105,136647,false,L-l-0 C-l-1 C-l-1 L-m-0 C-l-2 C-l-2 
job-2735,6,11,8,136552,167404,167423,30852,19,136715,false,C-l-2 C-l-1 C-l-0 C-l-1 C-l-0 C-m-0 C-l-2 C-m-1 
job-2733,2,4,2,136454,167404,167452,30950,48,136687,false,L-s-0 L-s-0 
job-2734,4,12,4,136510,167404,167502,30894,98,136756,false,L-l-0 L-m-0 L-l-0 L-m-0 
job-2736,3,12,5,136600,167404,167683,30804,279,136940,false,C-m-2 C-m-2 C-s-0 C-s-1 L-l-0 
job-2737,5,8,5,136643,167683,167696,31040,13,136787,false,L-l-0 L-l-0 C-l-0 L-m-0 C-l-0 
job-2739,4,12,7,136745,167696,167740,30951,44,137068,false,L-m-0 L-m-0 L-l-0 C-s-1 L-l-0 L-l-0 L-s-0 
job-2738,6,8,7,136687,167683,167741,30996,58,136828,false,C-m-2 C-l-2 C-l-1 C-m-0 C-l-2 C-l-1 C-m-1 
job-2742,1,12,7,136883,167741,167773,30858,32,136950,false,L-l-0 C-l-0 C-l-0 C-l-0 C-l-0 L-l-0 L-s-0 
job-2740,1,5,4,136787,167741,167814,30954,73,136867,false,L-m-0 L-m-0 L-m-0 L-m-0 
job-2741,2,4,6,136829,167741,167831,30912,90,137215,false,L-l-0 L-m-0 L-m-0 L-l-0 L-l-0 L-l-0 
job-2744,6,4,4,136997,167741,167858,30744,117,137228,false,C-l-1 C-l-2 C-l-1 C-l-2 
job-2743,2,7,2,136940,167741,167934,30801,193,137330,false,C-s-1 L-l-0 
job-2745,6,5,1,137032,167934,167952,30902,18,137082,false,L-m-0 
job-2746,3,6,5,137090,167934,167978,30844,44,137406,false,L-l-0 L-l-0 L-l-0 L-s-0 L-l-0 
job-2747,1,5,5,137140,167934,168185,30794,251,137584,false,C-s-1 L-m-0 L-m-0 L-s-0 C-s-1 
job-2750,5,6,2,137285,168185,168205,30900,20,137432,false,C-l-2 C-l-2 
job-2749,5,4,7,137234,168185,168211,30951,26,137412,false,L-l-0 L-l-0 C-l-1 C-l-0 L-m-0 C-l-1 C-l-0 
job-2748,4,9,1,137184,168185,168222,31001,37,137454,false,L-s-0 
job-2751,6,11,3,137335,168185,168361,30850,176,137528,false,C-m-2 C-m-0 C-m-1 
job-2752,2,5,6,137384,168361,168379,30977,18,137583,false,L-l-0 L-l-0 L-l-0 L-l-0 L-l-0 L-l-0 
job-2754,4,7,8,137476,168361,168533,30885,172,137676,false,C-s-0 C-s-2 C-l-2 C-l-0 C-l-0 C-l-2 C-l-0 C-l-2 
job-2753,2,5,7,137441,168361,168534,30920,173,137667,false,L-m-0 L-m-0 L-s-0 C-s-1 L-m-0 L-s-0 C-s-1 
job-2755,3,8,5,137518,168533,168548,31015,15,137597,false,C-s-2 L-l-0 L-l-0 L-l-0 L-l-0 
job-2756,4,5,3,137561,168533,168596,30972,63,137758,false,C-l-0 C-l-0 C-l-0 
job-2757,5,12,5,137616,168596,168611,30980,15,137846,false,L-m-0 L-l-0 C-l-0 L-l-0 C-l-0 
job-2758,2,4,6,137667,168596,168647,30929,51,137953,false,L-s-0 C-s-1 L-s-0 L-m-0 C-l-0 L-l-0 
job-2759,5,7,8,137718,168647,168657,30929,10,137732,false,L-l-0 C-l-0 C-l-1 C-l-1 C-l-0 L-l-0 C-m-0 L-m-0 
job-2761,3,7,6,137821,168657,168824,30836,167,138234,false,L-m-0 L-l-0 L-l-0 L-m-0 L-l-0 L-l-0 
job-2760,3,10,1,137778,168657,168840,30879,183,138171,false,L-s-0 
job-2762,2,9,1,137865,168824,168916,30959,92,138239,false,L-m-0 
job-2764,1,9,3,137973,168824,169015,30851,191,138371,false,C-s-2 C-s-1 L-m-0 
job-2763,1,12,5,137919,168824,169031,30905,207,138386,false,L-m-0 L-l-0 L-l-0 L-l-0 L-l-0 
job-2765,2,10,7,138030,168824,169131,30794,307,138388,false,C-m-2 C-l-0 C-l-0 C-m-2 C-l-0 C-l-0 C-m-2 
job-2767,3,12,4,138121,169131,169156,31010,25,138352,false,C-m-0 L-m-0 L-m-0 C-m-0 
job-2766,3,6,5,138077,169131,169204,31054,73,138305,false,L-s-0 L-l-0 L-l-0 L-l-0 L-l-0 
job-2768,5,8,2,138173,169131,169443,30958,312,138624,false,C-l-0 C-l-0 
job-2771,4,4,6,138305,169443,169498,31138,55,138409,false,L-s-0 C-l-0 C-l-0 C-s-1 C-l-0 L-l-0 
job-2770,5,11,1,138260,169443,169506,31183,63,138441,false,L-l-0 
job-2769,3,7,2,138217,169443,169518,31226,75,138435,false,L-m-0 L-m-0 
job-2773,5,6,4,138410,169518,169617,31108,99,138634,false,L-m-0 C-m-2 L-l-0 C-m-1 
job-2772,6,6,8,138354,169498,169623,31144,125,138765,false,C-l-0 L-l-0 C-l-1 C-l-1 C-l-2 C-l-0 C-l-2 C-m-0 
job-2774,6,6,2,138454,169617,169815,31163,198,138804,false,L-m-0 L-l-0 
job-2775,5,9,7,138517,169623,169818,31106,195,138907,false,C-l-2 C-l-0 C-l-1 C-l-1 C-l-0 L-l-0 C-l-2 
job-2777,3,6,5,138607,169818,169838,31211,20,138679,false,C-l-0 C-l-0 L-m-0 C-l-0 C-l-0 
job-2778,3,5,4,138654,169818,169859,31164,41,138847,false,C-l-1 C-l-1 C-l-1 C-l-1 
job-2776,1,12,6,138565,169818,169864,31253,46,138873,false,L-m-0 L-l-0 L-l-0 L-m-0 L-l-0 L-l-0 
job-2779,4,9,8,138688,169818,169904,31130,86,139045,false,L-s-0 C-l-2 C-l-2 C-m-2 C-l-2 C-m-2 C-m-0 C-m-0 
job-2780,6,9,7,138743,169864,169934,31121,70,139103,false,C-l-0 C-l-1 C-l-1 L-m-0 L-l-0 L-l-0 C-l-0 
job-2781,3,11,1,138792,169864,169948,31072,84,139105,false,C-s-1 
job-2784,6,12,6,138944,169934,170002,30990,68,139215,false,C-m-2 C-l-0 C-l-1 C-m-1 C-l-1 C-l-0 
job-2783,6,6,4,138890,169934,170023,31044,89,139118,false,L-m-0 L-l-0 L-l-0 C-m-0 
job-2782,4,9,5,138834,169904,170026,31070,122,139041,false,L-s-0 C-l-2 C-l-2 C-s-2 C-l-2 
job-2785,6,7,4,138993,170002,170057,31009,55,139324,false,C-l-1 C-l-0 C-l-0 C-l-1 
job-2786,3,12,5,139028,170002,170200,30974,198,139351,false,C-s-0 C-m-1 C-m-2 C-m-1 C-m-2 
job-2788,1,7,3,139125,170200,170223,31075,23,139165,false,L-m-0 C-s-2 C-s-2 
job-2787,1,12,8,139081,170200,170231,31119,31,139354,false,L-m-0 L-l-0 L-s-0 L-l-0 L-l-0 L-l-0 C-s-1 L-m-0 
job-2789,4,6,1,139181,170200,170250,31019,50,139402,false,C-s-0 
job-2790,3,10,2,139234,170200,170307,30966,107,139468,false,C-m-0 C-m-0 
job-2791,4,6,3,139274,170200,170352,30926,152,139579,false,C-l-0 C-l-0 C-l-0 
job-2794,5,7,5,139418,170352,170380,30934,28,139603,false,C-m-0 C-l-0 C-m-2 C-m-1 C-l-0 
job-2792,6,11,7,139315,170231,170407,30916,176,139628,false,L-m-0 C-l-1 L-l-0 C-l-2 C-l-1 C-l-2 L-l-0 
job-2793,2,5,3,139370,170307,170454,30937,147,139570,false,L-s-0 L-s-0 L-m-0 
job-2795,5,11,4,139477,170380,170577,30903,197,139907,false,C-m-0 C-l-0 C-l-0 C-m-1 
job-2796,1,8,5,139526,170577,170624,31051,47,139848,false,L-l-0 L-l-0 L-l-0 L-l-0 L-l-0 
job-2797,6,6,2,139569,170624,170640,31055,16,139820,false,L-l-0 L-l-0 
job-2799,1,11,7,139661,170624,170806,30963,182,140042,false,C-s-1 C-l-0 C-l-0 C-m-1 C-l-0 C-l-0 L-m-0 
job-2798,3,8,5,139617,170624,170830,31007,206,140020,false,C-m-1 L-m-0 L-s-0 L-m-0 C-m-1 
job-2800,1,9,3,139708,170806,170833,31098,27,139975,false,L-l-0 C-m-1 L-m-0 
job-2801,2,8,4,139748,170833,170848,31085,15,139924,false,L-m-0 L-m-0 L-m-0 L-m-0 
job-2802,6,9,8,139791,170833,170911,31042,78,140024,false,L-l-0 L-l-0 C-l-0 C-l-2 C-l-1 C-l-2 C-l-0 C-l-1 
job-2803,4,12,6,139846,170833,170929,30987,96,140164,false,C-s-0 C-s-2 C-m-2 C-s-1 C-m-2 L-s-0 
job-2805,6,9,7,139942,170911,170929,30969,18,140141,false,L-l-0 C-l-1 C-l-0 L-m-0 C-l-0 C-l-1 L-l-0 
job-2804,2,6,1,139892,170911,170940,31019,29,140029,false,L-m-0 
job-2806,1,8,6,139991,170911,170956,30920,45,140308,false,C-l-2 C-l-2 C-l-2 C-l-2 C-l-2 C-l-2 
job-2807,6,8,8,140042,170929,170964,30887,35,140133,false,L-m-0 L-l-0 C-l-0 C-l-1 C-l-0 C-l-1 L-l-0 C-m-0 
job-2808,5,12,8,140099,170964,171199,30865,235,140339,false,C-m-0 C-l-0 C-l-0 C-l-1 C-l-1 L-l-0 L-m-0 L-l-0 
job-2809,3,7,5,140133,171199,171291,31066,92,140315,false,L-l-0 L-s-0 L-l-0 L-l-0 L-l-0 
job-2810,4,8,4,140179,171291,171314,31112,23,140337,false,L-l-0 L-l-0 L-s-0 L-l-0 
job-2811,6,6,8,140228,171291,171558,31063,267,140714,false,C-l-0 C-l-1 C-l-0 C-l-2 C-l-1 C-m-0 C-l-2 L-m-0 
job-2812,5,6,8,140284,171558,171618,31274,60,140461,false,L-l-0 C-l-0 C-l-1 C-l-1 C-l-0 L-l-0 C-m-0 L-m-0 
job-2813,1,11,2,140331,171618,171659,31287,41,140489,false,L-m-0 L-m-0 
job-2814,1,9,3,140380,171618,171707,31238,89,140728,false,L-l-0 L-m-0 L-l-0 
job-2815,4,5,3,140430,171618,171714,31188,96,140681,false,L-s-0 L-l-0 L-l-0 
job-2818,1,10,8,140573,171714,171764,31141,50,140736,false,C-m-1 C-m-0 C-m-0 C-m-1 C-m-0 L-m-0 C-m-1 L-m-0 
job-2819,4,10,7,140634,171714,171830,31080,116,140831,false,C-l-0 C-l-1 C-l-0 C-s-1 C-l-1 C-l-1 C-l-0 
job-2821,6,5,3,140741,171764,171836,31023,72,140828,false,C-m-2 C-m-1 C-m-0 
job-2820,4,4,4,140681,171714,171861,31033,147,141082,false,C-s-2 C-l-2 C-l-2 C-l-2 
job-2817,3,9,5,140525,171714,171882,31189,168,140895,false,L-m-0 L-l-0 L-l-0 L-l-0 L-l-0 
job-2816,1,9,1,140477,171714,171911,31237,197,140773,false,L-s-0 
job-2823,3,4,4,140824,171861,171915,31037,54,140907,false,C-l-0 C-l-0 L-s-0 C-l-0 
job-2822,2,8,5,140775,171836,171963,31061,127,141164,false,C-s-1 L-m-0 C-s-0 C-s-1 L-m-0 
job-2824,6,5,4,140876,171861,172026,30985,165,141340,false,C-l-1 C-l-2 C-l-1 C-l-2 
job-2825,1,5,4,140921,171963,172242,31042,279,141382,false,L-m-0 L-m-0 L-m-0 L-m-0 
job-2826,4,10,4,140967,172242,172281,31275,39,141096,false,L-l-0 L-l-0 L-s-0 L-l-0 
job-2827,1,5,8,141005,172242,172306,31237,64,141358,false,L-m-0 L-m-0 C-s-1 C-s-1 L-m-0 L-m-0 C-s-1 L-m-0 
job-2828,1,10,2,141052,172242,172314,31190,72,141165,false,C-m-0 C-m-0 
job-2829,1,10,8,141098,172242,172442,31144,200,141340,false,C-m-1 C-l-1 C-l-1 C-l-1 C-l-1 C-m-1 C-m-1 C-m-0 
job-2830,6,5,5,141145,172442,172493,31297,51,141246,false,L-m-0 C-l-0 L-l-0 L-l-0 C-l-0 
job-2831,4,6,7,141186,172442,172509,31256,67,141515,false,L-s-0 C-l-1 C-l-1 C-l-2 C-l-1 C-l-2 C-l-2 
job-2832,2,11,8,141227,172493,172520,31266,27,141494,false,C-m-0 L-l-0 L-l-0 L-l-0 L-l-0 L-m-0 C-m-0 L-m-0 
job-2833,1,9,7,141271,172493,172639,31222,146,141551,false,L-m-0 C-l-0 C-m-0 C-l-0 C-l-0 C-l-0 C-l-0 
job-2834,6,7,2,141324,172639,172692,31315,53,141387,false,L-l-0 L-l-0 
job-2835,1,10,2,141370,172692,172707,31322,15,141434,false,L-m-0 L-m-0 
job-2836,2,9,3,141421,172692,172774,31271,82,141703,false,L-l-0 L-m-0 L-l-0 
job-2837,2,8,1,141467,172774,172831,31307,57,141624,false,L-s-0 
job-2839,3,10,8,141574,172774,172835,31200,61,141813,false,L-l-0 L-l-0 C-l-2 C-l-2 L-l-0 C-l-2 C-l-2 L-l-0 
job-2840,4,5,8,141628,172774,172839,31146,65,141715,false,C-l-0 C-l-1 C-l-0 C-l-1 C-l-1 C-m-0 C-l-0 C-m-0 
job-2838,1,6,6,141526,172774,172874,31248,100,141880,false,L-m-0 L-m-0 L-s-0 L-m-0 L-m-0 L-m-0 
job-2842,1,9,1,141730,172774,172970,31044,196,141946,false,C-s-2 
job-2843,6,8,3,141791,172835,172972,31044,137,142214,false,C-m-1 L-l-0 L-l-0 
job-2841,3,11,1,141689,172774,173006,31085,232,142107,false,C-s-1 
job-2844,1,11,1,141855,172972,173111,31117,139,142181,false,L-s-0 
job-2847,3,9,5,141995,173111,173121,31116,10,142122,false,C-s-1 C-l-0 C-l-0 C-l-0 C-l-0 
job-2846,6,4,3,141950,173111,173123,31161,12,142060,false,L-l-0 L-l-0 C-m-0 
job-2848,6,4,5,142046,173111,173145,31065,34,142298,false,C-l-2 C-l-1 C-l-2 C-m-1 C-l-1 
job-2845,2,5,5,141909,172972,173160,31063,188,142164,false,L-m-0 L-s-0 L-m-0 L-m-0 L-m-0 
job-2849,3,10,7,142083,173121,173279,31038,158,142255,false,C-s-0 C-l-0 C-l-0 C-m-2 C-l-0 C-l-0 C-m-2 
job-2850,1,6,4,142129,173279,173315,31150,36,142313,false,L-m-0 L-m-0 L-m-0 L-m-0 
job-2853,2,9,8,142263,173279,173342,31016,63,142471,false,C-m-1 C-l-0 C-l-0 C-l-0 C-l-0 C-l-0 C-m-1 C-m-1 
job-2852,2,8,7,142224,173279,173343,31055,64,142553,false,L-l-0 L-m-0 C-m-0 C-m-0 C-m-0 L-s-0 C-m-0 
job-2851,2,10,4,142171,173279,173397,31108,118,142341,false,L-l-0 L-l-0 L-l-0 L-l-0 
job-2854,6,11,7,142306,173342,173400,31036,58,142603,false,C-l-0 C-l-2 L-m-0 C-l-0 C-l-1 C-l-1 C-l-2 
job-2856,6,4,5,142405,173397,173517,30992,120,142704,false,C-m-0 L-l-0 C-m-2 C-m-1 L-l-0 
job-2855,1,5,4,142355,173342,173526,30987,184,142626,false,C-s-2 C-s-2 L-s-0 C-s-2 
job-2857,1,4,5,142446,173517,173531,31071,14,142642,false,L-s-0 L-m-0 L-s-0 L-m-0 L-m-0 
job-2858,3,11,7,142490,173517,173536,31027,19,142800,false,C-m-2 L-l-0 L-l-0 C-m-2 L-l-0 L-l-0 L-m-0 
job-2861,4,10,8,142635,173517,173637,30882,120,142831,false,C-m-1 C-l-1 C-l-2 C-l-2 C-l-1 C-l-1 C-l-2 C-m-1 
job-2860,4,6,4,142580,173517,173640,30937,123,142733,false,C-s-1 C-l-0 C-l-0 C-l-0 
job-2864,5,12,6,142789,173637,173658,30848,21,142916,false,C-m-1 C-l-1 C-l-2 C-m-2 C-l-1 C-l-2 
job-2863,1,9,8,142728,173637,173661,30909,24,142832,false,L-s-0 L-l-0 C-s-2 L-l-0 L-m-0 L-m-0 C-m-0 L-m-0 
job-2859,3,9,2,142528,173517,173672,30989,155,142934,false,C-m-0 C-m-0 
job-2862,5,12,2,142684,173637,173674,30953,37,143002,false,L-l-0 L-l-0 
job-2865,1,4,5,142829,173658,173725,30829,67,143165,false,C-s-2 L-m-0 L-s-0 C-m-0 C-s-1 
job-2866,5,8,3,142870,173658,173819,30788,161,143131,false,C-m-1 C-l-0 C-l-0 
job-2867,5,7,2,142923,173819,173886,30896,67,143252,false,L-l-0 L-l-0 
job-2868,1,6,6,142972,173819,173887,30847,68,143047,false,L-l-0 L-m-0 L-l-0 L-m-0 L-m-0 L-m-0 
job-2869,6,7,6,143018,173819,174018,30801,199,143470,false,C-l-1 C-l-2 C-l-0 C-l-2 C-l-0 C-l-1 
job-2870,1,5,8,143072,174018,174123,30946,105,143207,false,L-s-0 L-m-0 L-s-0 L-s-0 L-m-0 L-m-0 L-m-0 L-m-0 
job-2871,4,10,1,143129,174018,174239,30889,221,143454,false,L-l-0 
job-2874,1,12,8,143279,174239,174292,30960,53,143375,false,C-l-0 C-l-0 C-l-2 C-l-0 C-l-0 C-l-2 C-l-2 C-l-2 
job-2873,4,5,5,143218,174239,174326,31021,87,143350,false,L-l-0 L-m-0 L-m-0 L-l-0 L-l-0 
job-2872,1,8,2,143170,174239,174333,31069,94,143426,false,L-s-0 L-s-0 
job-2877,6,5,6,143422,174326,174351,30904,25,143639,false,L-l-0 C-l-2 C-l-0 C-l-0 C-l-2 L-l-0 
job-2875,3,9,5,143348,174239,174354,30891,115,143490,false,C-l-1 C-l-1 C-s-1 C-l-1 C-l-1 
job-2876,1,4,8,143383,174326,174361,30943,35,143621,false,L-m-0 L-m-0 L-m-0 L-m-0 L-m-0 C-s-1 L-m-0 L-m-0 
job-2878,5,4,3,143475,174326,174690,30851,364,144076,false,C-m-0 C-m-1 C-m-2 
job-2879,2,8,7,143520,174690,174738,31170,48,143831,false,L-l-0 L-l-0 L-s-0 L-l-0 L-l-0 L-s-0 L-l-0 
job-2880,5,7,3,143572,174690,174854,31118,164,143839,false,L-m-0 C-l-0 C-l-0 
job-2882,2,9,4,143692,174854,174914,31162,60,143873,false,L-l-0 L-l-0 L-l-0 L-l-0 
job-2881,1,10,3,143621,174854,174921,31233,67,143812,false,L-m-0 L-m-0 L-m-0 
job-2883,3,6,2,143745,174854,174933,31109,79,144073,false,L-s-0 L-l-0 
job-2884,1,9,6,143801,174854,174986,31053,132,144040,false,C-l-0 C-l-0 C-l-0 L-s-0 C-l-0 C-l-0 
job-2885,4,5,4,143851,174854,175048,31003,194,144158,false,C-s-1 C-l-1 C-l-1 C-l-1 
job-2886,5,6,8,143892,174933,175168,31041,235,144130,false,C-m-1 L-l-0 C-m-2 C-l-2 C-l-2 L-l-0 C-m-0 L-m-0 
job-2887,1,7,5,143938,175168,175386,31230,218,144328,false,L-l-0 L-l-0 L-l-0 L-l-0 L-l-0 
job-2889,5,6,7,144038,175386,175415,31348,29,144315,false,L-m-0 C-l-1 C-l-0 C-l-2 C-l-1 C-l-0 C-l-2 
job-2888,5,9,2,143996,175386,175431,31390,45,144339,false,L-l-0 L-l-0 
job-2890,5,7,3,144101,175386,175495,31285,109,144303,false,C-m-1 C-m-2 C-m-0 
job-2891,4,12,8,144142,175495,175510,31353,15,144360,false,L-m-0 L-m-0 L-l-0 L-l-0 C-m-1 L-s-0 L-l-0 C-m-1 
job-2892,5,7,8,144192,175495,175849,31303,354,144600,false,C-l-0 C-l-1 C-l-0 C-l-2 C-l-1 C-m-0 C-l-2 C-m-2 
job-2893,4,11,3,144231,175849,175996,31618,147,144506,false,L-m-0 L-m-0 L-s-0 
job-2894,2,7,5,144285,175849,176073,31564,224,144639,false,L-l-0 L-l-0 L-l-0 L-l-0 L-l-0 
job-2895,3,4,2,144353,176073,176089,31720,16,144490,false,L-m-0 L-m-0 
job-2896,1,12,5,144400,176073,176104,31673,31,144649,false,L-l-0 L-m-0 L-m-0 L-l-0 L-l-0 
job-2898,4,5,4,144495,176073,176156,31578,83,144786,false,L-s-0 C-l-1 C-l-1 C-l-1 
job-2897,6,9,3,144452,176073,176160,31621,87,144610,false,C-l-0 L-l-0 C-l-0 
job-2900,3,12,6,144608,176160,176195,31552,35,144763,false,L-s-0 L-l-0 L-l-0 C-s-1 L-l-0 L-l-0 
job-2899,3,10,2,144550,176160,176212,31610,52,144833,false,L-m-0 L-m-0 
job-2901,1,5,7,144656,176160,176233,31504,73,144913,false,C-s-0 C-s-2 L-m-0 C-s-0 C-s-2 C-s-2 L-m-0 
job-2903,4,4,3,144749,176160,176284,31411,124,144977,false,C-l-2 C-l-2 C-l-2 
job-2904,4,5,5,144789,176160,176317,31371,157,145110,false,C-m-0 C-m-0 C-m-2 C-m-1 C-m-1 
job-2906,3,4,4,144883,176233,176327,31350,94,145234,false,C-m-2 L-l-0 L-l-0 L-l-0 
job-2902,5,8,4,144703,176160,176328,31457,168,144928,false,C-l-0 C-l-0 C-l-1 C-l-1 
job-2905,6,7,1,144830,176233,176337,31403,104,145012,false,L-m-0 
job-2909,6,4,2,145031,176328,176490,31297,162,145264,false,C-l-0 C-l-0 
job-2910,1,8,7,145081,176328,176500,31247,172,145410,false,C-l-1 C-l-1 C-l-1 C-s-1 C-l-1 C-l-1 C-l-1 
job-2911,6,5,1,145135,176328,176521,31193,193,145594,false,C-m-1 
job-2908,1,9,8,144990,176328,176525,31338,197,145209,false,L-l-0 L-l-0 L-l-0 L-l-0 L-l-0 C-m-0 C-m-0 C-m-0 
job-2907,2,12,2,144935,176328,176559,31393,231,145365,false,L-s-0 L-m-0 
job-2912,2,11,8,145181,176490,176567,31309,77,145325,false,C-m-2 C-l-2 C-l-2 C-l-2 C-l-2 C-m-1 C-m-2 L-m-0 
job-2913,3,10,6,145228,176559,176586,31331,27,145372,false,L-m-0 C-m-1 L-s-0 C-m-2 C-m-1 L-m-0 
job-2914,1,8,6,145287,176559,176597,31272,38,145606,false,L-l-0 L-l-0 L-l-0 L-l-0 L-l-0 L-l-0 
job-2915,6,10,6,145331,176567,176600,31236,33,145420,false,C-l-1 C-l-2 C-l-0 C-l-1 C-l-2 C-l-0 
job-2916,3,7,7,145377,176586,176643,31209,57,145469,false,L-m-0 L-m-0 L-s-0 C-m-1 C-m-0 C-m-1 C-m-0 
job-2917,5,10,4,145424,176600,176773,31176,173,145865,false,L-l-0 L-l-0 C-l-0 C-l-0 
job-2918,3,4,8,145481,176773,176830,31292,57,145763,false,L-m-0 L-l-0 L-s-0 L-l-0 L-l-0 L-l-0 C-s-1 L-m-0 
job-2920,4,8,4,145573,176773,176855,31200,82,145774,false,C-s-2 C-l-0 C-l-0 C-l-0 
job-2919,4,10,2,145519,176773,176929,31254,156,145842,false,C-m-0 C-m-0 
job-2922,6,7,6,145684,176830,176936,31146,106,145872,false,L-l-0 L-m-0 C-l-2 C-m-1 L-l-0 C-l-2 
job-2921,6,5,2,145625,176773,176948,31148,175,145904,false,C-l-1 C-l-1 
job-2923,2,7,3,145741,176830,177197,31089,367,146286,false,L-s-0 C-m-1 L-m-0 
job-2924,1,6,3,145789,177197,177222,31408,25,146102,false,L-m-0 L-m-0 L-m-0 
job-2925,4,11,3,145845,177197,177242,31352,45,146060,false,L-l-0 L-m-0 L-l-0 
job-2926,4,11,8,145883,177197,177521,31314,324,146229,false,L-l-0 C-l-2 C-l-2 C-l-0 C-l-0 C-l-0 C-l-2 L-s-0 
job-2927,5,7,1,145932,177521,177562,31589,41,146160,false,L-m-0 
job-2928,5,10,2,145978,177521,177577,31543,56,146315,false,L-l-0 L-l-0 
job-2929,4,12,6,146028,177521,177708,31493,187,146354,false,C-s-0 C-m-2 L-s-0 C-s-1 C-m-2 C-s-2 
job-2930,4,7,2,146078,177708,177761,31630,53,146342,false,L-m-0 L-m-0 
job-2932,6,7,4,146184,177761,177789,31577,28,146360,false,L-m-0 C-l-1 C-l-1 C-m-1 
job-2931,4,4,6,146139,177708,177828,31569,120,146500,false,C-m-0 L-l-0 L-l-0 C-m-0 L-s-0 L-l-0 
job-2933,5,10,4,146245,177761,177832,31516,71,146426,false,C-l-0 C-l-2 C-l-0 C-l-2 
job-2934,3,11,1,146302,177828,177864,31526,36,146445,false,L-s-0 
job-2935,3,9,8,146348,177828,178194,31480,366,146852,false,C-m-0 L-l-0 L-l-0 L-l-0 L-l-0 L-m-0 C-m-0 L-m-0 
job-2936,5,11,3,146392,178194,178221,31802,27,146699,false,L-l-0 L-l-0 L-m-0 
job-2937,6,4,2,146447,178194,178478,31747,284,146793,false,C-l-0 C-l-0 
job-2939,4,7,6,146549,178478,178503,31929,25,146735,false,C-m-0 L-l-0 L-m-0 C-m-0 L-l-0 L-l-0 
job-2938,3,11,4,146507,178194,178516,31687,322,146975,false,L-s-0 C-m-2 C-m-2 L-m-0 
job-2940,6,4,4,146590,178478,178631,31888,153,146859,false,C-l-0 C-l-1 C-l-1 C-l-0 
job-2941,6,5,4,146641,178631,178654,31990,23,146801,false,L-m-0 L-l-0 L-l-0 C-m-0 
job-2942,5,12,1,146710,178631,178701,31921,70,146849,false,C-m-1 
job-2944,6,6,8,146809,178701,178719,31892,18,147096,false,L-l-0 L-l-0 C-l-1 C-l-2 C-l-1 L-m-0 C-l-2 C-m-0 
job-2943,2,6,1,146760,178701,178779,31941,78,147022,false,L-s-0 
job-2946,3,9,3,146911,178701,178807,31790,106,147212,false,C-m-1 C-m-1 C-s-1 
job-2945,4,7,3,146860,178701,178840,31841,139,147248,false,C-l-0 C-l-0 C-l-0 
job-2947,3,7,7,146949,178779,178851,31830,72,147191,false,L-s-0 L-l-0 L-l-0 L-l-0 L-l-0 L-m-0 L-m-0 
job-2948,1,4,7,147005,178840,178855,31835,15,147258,false,C-s-2 L-m-0 L-m-0 C-s-2 C-s-2 L-s-0 C-s-2 
job-2949,3,9,3,147057,178840,178856,31783,16,147274,false,C-l-0 C-l-0 C-l-0 
job-2951,6,10,1,147178,178840,178886,31662,46,147249,false,C-m-0 
job-2950,5,9,4,147116,178840,178898,31724,58,147336,false,C-l-1 C-l-2 C-l-1 C-l-2 
job-2952,4,6,8,147228,178851,178938,31623,87,147498,false,C-m-2 L-l-0 C-m-2 L-l-0 L-l-0 C-m-1 C-m-1 L-m-0 
job-2953,4,10,5,147274,178855,178950,31581,95,147377,false,L-m-0 C-s-1 L-s-0 C-s-0 C-s-2 
job-2954,1,4,8,147327,178856,179127,31529,271,147856,false,C-l-0 C-l-2 C-l-1 C-l-2 C-m-0 C-m-0 C-l-1 C-l-0 
job-2955,4,7,1,147380,179127,179173,31747,46,147686,false,L-s-0 
job-2956,6,10,5,147425,179127,179236,31702,109,147667,false,L-m-0 C-l-0 L-l-0 L-l-0 C-l-0 
job-2957,3,8,1,147469,179173,179249,31704,76,147704,false,L-s-0 
job-2960,2,9,8,147624,179249,179394,31625,145,147775,false,C-m-1 C-l-0 L-l-0 C-s-0 C-l-1 C-m-1 C-m-1 C-m-0 
job-2958,1,8,5,147519,179173,179418,31654,245,147953,false,C-s-1 L-m-0 L-m-0 L-s-0 C-s-1 
job-2959,5,7,8,147576,179236,179438,31660,202,147839,false,L-l-0 L-l-0 C-l-1 C-l-0 C-l-1 C-m-0 C-l-0 L-m-0 
job-2961,2,5,5,147665,179249,179480,31584,231,147966,false,C-s-0 C-s-2 L-s-0 C-m-1 C-s-2 
job-2962,4,9,3,147720,179249,179547,31529,298,148310,false,C-l-2 C-l-2 C-l-2 
job-2964,3,9,5,147821,179547,179570,31726,23,147974,false,L-l-0 L-l-0 L-m-0 L-l-0 L-l-0 
job-2965,5,12,5,147876,179547,179584,31671,37,148024,false,C-m-0 C-l-1 C-l-0 C-l-0 C-l-1 
job-2966,6,10,2,147927,179547,179593,31620,46,147992,false,C-l-2 C-l-2 
job-2963,1,11,2,147768,179547,179596,31779,49,147923,false,L-m-0 L-m-0 
job-2967,1,9,1,147982,179596,179658,31614,62,148331,false,L-s-0 
job-2968,3,5,5,148022,179596,179893,31574,297,148558,false,L-l-0 L-s-0 L-l-0 L-l-0 L-l-0 
job-2969,4,5,3,148073,179893,179924,31820,31,148325,false,L-l-0 L-l-0 L-l-0 
job-2970,1,11,4,148126,179893,179956,31767,63,148281,false,L-s-0 L-m-0 C-s-1 L-m-0 
job-2971,2,5,3,148172,179956,180075,31784,119,148309,false,L-m-0 L-m-0 L-m-0 
job-2974,4,4,4,148308,179956,180184,31648,228,148806,false,C-l-1 C-l-1 C-l-1 C-s-1 
job-2972,2,8,4,148217,179956,180254,31739,298,148710,false,L-l-0 L-m-0 L-l-0 L-l-0 
job-2973,1,4,8,148261,179956,180458,31695,502,148988,false,L-s-0 L-l-0 L-l-0 L-l-0 L-l-0 L-l-0 L-l-0 L-s-0 
job-2977,4,6,3,148447,180458,180490,32011,32,148714,false,C-m-0 C-m-0 L-l-0 
job-2975,1,6,7,148354,180458,180509,32104,51,148546,false,L-l-0 L-l-0 L-l-0 L-l-0 L-l-0 L-l-0 L-l-0 
job-2978,1,6,2,148493,180509,180549,32016,40,148764,false,L-l-0 L-m-0 
job-2976,3,12,3,148398,180458,180573,32060,115,148638,false,L-s-0 L-m-0 L-m-0 
job-2979,6,11,6,148547,180509,180629,31962,120,148929,false,C-m-0 C-l-1 C-l-1 C-l-0 C-l-0 L-l-0 
job-2980,6,4,3,148594,180509,180796,31915,287,149125,false,C-l-2 C-m-1 C-l-2 
job-2981,3,8,1,148644,180796,180901,32152,105,148946,false,L-s-0 
job-2984,6,4,8,148771,180796,180964,32025,168,149108,false,C-l-0 C-l-2 C-l-1 C-l-0 C-l-1 C-l-2 C-m-2 C-m-1 
job-2982,5,7,2,148686,180796,180987,32110,191,148963,false,L-l-0 L-l-0 
job-2985,1,11,8,148810,180987,181039,32177,52,149151,false,L-m-0 L-l-0 L-l-0 C-m-0 L-l-0 L-m-0 L-l-0 C-m-0 
job-2983,5,5,2,148732,180796,181042,32064,246,149107,false,C-m-0 L-m-0 
job-2986,4,8,6,148849,180987,181171,32138,184,149193,false,L-s-0 C-l-1 C-l-1 C-m-1 C-l-1 C-m-1 
job-2987,4,11,4,148902,181171,181185,32269,14,149136,false,L-l-0 L-l-0 L-s-0 L-l-0 
job-2988,6,10,2,148943,181171,181413,32228,242,149477,false,L-m-0 C-m-0 
job-2989,6,12,1,149004,181171,181422,32167,251,149525,false,C-m-1 
job-2990,4,9,5,149055,181413,181433,32358,20,149217,false,L-m-0 L-l-0 L-l-0 L-m-0 L-l-0 
job-2991,2,12,4,149107,181413,181517,32306,104,149400,false,L-s-0 C-m-1 C-m-0 C-m-0 
job-2994,6,6,6,149249,181517,181544,32268,27,149444,false,L-l-0 C-l-0 C-l-1 C-l-1 C-l-0 L-l-0 
job-2993,1,6,5,149199,181517,181563,32318,46,149384,false,L-m-0 L-m-0 L-s-0 L-m-0 L-m-0 
job-2992,1,5,1,149160,181517,181606,32357,89,149323,false,L-s-0 
job-2995,4,5,6,149299,181517,181677,32218,160,149509,false,C-m-0 L-m-0 C-l-2 C-m-0 C-l-2 C-l-2 
job-2996,2,6,7,149343,181677,181720,32334,43,149553,false,L-l-0 L-l-0 L-s-0 L-l-0 L-l-0 L-s-0 L-l-0 
job-2998,4,4,7,149428,181677,181754,32249,77,149787,false,L-m-0 C-l-2 C-l-2 C-l-2 C-l-1 C-l-1 C-l-1 
job-2997,1,12,7,149389,181677,181821,32288,144,149559,false,C-l-0 L-l-0 C-l-0 L-m-0 C-l-0 C-l-0 L-m-0 
job-2999,5,4,3,149487,181677,181923,32190,246,149988,false,C-m-2 C-m-1 C-m-0 
job-3000,4,10,2,149532,181923,181985,32391,62,149823,false,L-m-0 L-m-0 
job-3001,1,10,6,149589,181923,182317,32334,394,150112,false,C-s-1 L-l-0 L-l-0 L-s-0 L-l-0 L-l-0 
job-3002,4,10,1,149653,182317,182327,32664,10,149773,false,L-s-0 
job-3004,4,11,8,149747,182317,182407,32570,90,150023,false,C-m-2 C-l-2 C-s-1 C-l-2 C-l-2 C-m-1 C-m-2 C-m-1 
job-3003,5,10,8,149698,182317,182470,32619,153,149960,false,C-m-0 L-l-0 C-l-1 C-l-0 C-l-1 L-m-0 C-l-0 L-l-0 
job-3005,1,8,7,149806,182470,182486,32664,16,149842,false,L-s-0 L-s-0 L-l-0 L-l-0 L-l-0 L-l-0 L-l-0 
job-3006,1,8,8,149862,182470,182656,32608,186,150127,false,L-m-0 L-m-0 L-m-0 C-m-0 C-m-0 C-m-0 L-l-0 C-m-0 
job-3007,2,8,4,149910,182656,182708,32746,52,150002,false,L-m-0 L-m-0 L-m-0 L-m-0 
job-3008,3,5,3,149954,182656,182718,32702,62,150053,false,L-l-0 L-l-0 L-l-0 
job-3009,4,8,7,149995,182656,183014,32661,358,150608,false,L-s-0 C-l-0 C-l-1 C-l-1 C-l-0 C-l-1 C-l-0 
job-3010,2,10,8,150043,183014,183143,32971,129,150394,false,L-m-0 L-s-0 L-l-0 L-l-0 L-l-0 L-l-0 L-m-0 L-m-0 
job-3011,4,12,1,150090,183143,183154,33053,11,150166,false,L-s-0 
job-3012,3,12,2,150138,183143,183156,33005,13,150447,false,L-m-0 L-m-0 
job-3013,6,7,8,150194,183143,183183,32949,40,150449,false,L-l-0 C-l-2 C-l-0 C-l-2 C-l-0 L-l-0 C-l-1 C-l-1 
job-3014,5,10,6,150254,183183,183204,32929,21,150315,false,L-m-0 L-l-0 C-l-0 C-m-2 C-l-0 L-l-0 
job-3015,4,12,4,150299,183183,183242,32884,59,150586,false,C-s-2 C-m-1 L-s-0 C-m-1 
job-3016,4,4,4,150342,183183,183461,32841,278,150790,false,C-s-1 C-l-1 C-l-1 C-l-1 
job-3017,4,9,3,150395,183461,183508,33066,47,150443,false,L-m-0 L-m-0 L-s-0 
job-3018,4,5,1,150435,183461,183527,33026,66,150786,false,L-l-0 
job-3019,3,5,8,150488,183461,183596,32973,135,150689,false,C-l-1 L-l-0 C-l-1 C-l-1 L-l-0 C-m-0 C-l-1 C-m-0 
job-3020,2,6,1,150532,183596,183614,33064,18,150787,false,L-s-0 
job-3021,4,5,6,150581,183596,183689,33015,93,150778,false,C-s-1 L-l-0 L-l-0 L-m-0 L-l-0 L-m-0 
job-3022,1,7,3,150633,183689,183711,33056,22,150692,false,L-m-0 L-m-0 L-m-0 
job-3023,2,4,6,150676,183689,183713,33013,24,150847,false,L-m-0 L-l-0 L-m-0 L-l-0 L-l-0 L-l-0 
job-3025,6,6,8,150781,183713,183730,32932,17,150809,false,C-l-2 C-l-1 L-l-0 C-l-2 C-l-1 C-m-0 C-m-1 L-m-0 
job-3024,3,8,7,150726,183689,183744,32963,55,150990,false,L-l-0 C-l-0 C-l-0 C-s-1 C-l-0 C-l-0 L-s-0 
job-3026,3,8,6,150819,183730,183862,32911,132,150957,false,C-s-2 L-m-0 L-l-0 L-m-0 L-l-0 L-l-0 
job-3028,3,5,1,150922,183862,183902,32940,40,151140,false,L-m-0 
job-3027,2,8,1,150871,183862,183920,32991,58,151141,false,L-s-0 
job-3029,6,11,5,150969,183862,184260,32893,398,151475,false,L-l-0 C-l-1 L-l-0 C-m-0 C-l-1 
job-3030,5,8,2,151023,184260,184431,33237,171,151393,false,L-l-0 L-l-0 
job-3031,2,4,2,151080,184431,184452,33351,21,151162,false,L-s-0 L-s-0 
job-3032,1,5,6,151118,184431,184537,33313,106,151373,false,L-m-0 L-m-0 L-m-0 L-m-0 L-m-0 L-m-0 
job-3033,1,6,4,151173,184431,184606,33258,175,151553,false,L-l-0 L-l-0 L-l-0 L-l-0 
job-3034,1,6,6,151225,184606,184646,33381,40,151463,false,L-l-0 L-l-0 L-l-0 L-l-0 L-l-0 L-l-0 
job-3035,6,4,5,151274,184606,184804,33332,198,151583,false,C-m-0 C-l-0 L-l-0 L-m-0 C-l-0 
job-3037,1,6,1,151368,184804,184820,33436,16,151429,false,L-m-0 
job-3036,2,7,8,151323,184804,184822,33481,18,151480,false,L-l-0 L-l-0 L-l-0 L-l-0 L-l-0 L-s-0 L-l-0 L-s-0 
job-3038,5,9,7,151424,184804,184858,33380,54,151763,false,L-m-0 C-l-2 C-l-1 C-l-0 C-l-1 C-l-2 C-l-0 
job-3039,6,7,5,151488,184822,184901,33334,79,151760,false,C-m-0 L-l-0 C-m-2 C-m-1 L-l-0 
job-3040,1,4,7,151530,184858,185216,33328,358,151990,false,C-m-1 C-m-1 C-m-0 C-m-2 C-m-0 L-s-0 C-m-2 
job-3041,5,4,1,151576,185216,185227,33640,11,151825,false,L-m-0 
job-3042,6,10,6,151637,185216,185328,33579,112,151937,false,L-l-0 C-l-1 C-l-0 C-l-0 C-l-1 L-l-0 
job-3043,2,9,5,151682,185328,185408,33646,80,152033,false,L-l-0 L-l-0 L-l-0 L-l-0 L-l-0 
job-3044,2,7,8,151730,185328,185662,33598,334,152238,false,C-s-2 L-m-0 L-s-0 L-m-0 L-m-0 L-s-0 C-s-2 L-m-0 
job-3045,1,5,3,151785,185662,185699,33877,37,151974,false,L-s-0 L-s-0 L-s-0 
job-3046,4,5,7,151833,185662,185774,33829,112,152025,false,L-m-0 L-m-0 L-l-0 C-m-0 L-l-0 L-l-0 C-m-0 
job-3047,3,10,2,151883,185774,185824,33891,50,152174,false,L-m-0 L-m-0 
job-3048,6,9,7,151940,185774,185831,33834,57,152054,false,C-m-0 C-l-1 L-l-0 C-l-2 C-l-1 L-l-0 C-l-2 
job-3050,4,4,5,152044,185774,185850,33730,76,152280,false,L-s-0 C-s-1 C-s-2 C-m-2 C-m-2 
job-3051,4,7,7,152092,185831,185883,33739,52,152291,false,L-m-0 L-l-0 L-m-0 C-m-0 L-l-0 L-l-0 C-m-0 
job-3049,6,8,3,151996,185774,185887,33778,113,152273,false,C-l-0 C-l-0 C-m-1 
job-3052,1,8,5,152146,185831,185910,33685,79,152462,false,C-l-1 C-m-1 C-l-1 C-l-1 C-m-1 
job-3053,4,11,8,152200,185910,185928,33710,18,152495,false,L-l-0 L-m-0 L-l-0 L-m-0 C-m-1 L-s-0 L-l-0 C-m-1 
job-3054,5,5,6,152257,185910,186095,33653,185,152445,false,C-l-0 C-l-1 C-l-0 C-l-2 C-l-1 C-l-2 
job-3055,2,12,3,152313,186095,186310,33782,215,152592,false,L-m-0 L-m-0 L-s-0 
job-3056,3,11,2,152362,186310,186384,33948,74,152482,false,L-m-0 L-m-0 
job-3058,5,6,5,152447,186310,186410,33863,100,152642,false,C-m-0 C-l-0 C-l-0 C-l-1 C-l-1 
job-3057,1,11,7,152401,186310,186543,33909,233,152807,false,L-s-0 L-l-0 L-l-0 C-m-0 L-l-0 L-l-0 C-m-0 
job-3059,3,9,1,152489,186543,186607,34054,64,152590,false,L-s-0 
job-3061,3,9,1,152597,186543,186615,33946,72,152673,false,C-s-2 
job-3060,3,6,6,152541,186543,186620,34002,77,152750,false,L-l-0 L-m-0 L-m-0 L-l-0 L-l-0 L-l-0 
job-3062,6,4,4,152641,186543,186652,33902,109,152813,false,C-l-0 C-l-0 C-l-1 C-l-1 
job-3063,5,11,3,152699,186607,186659,33908,52,152844,false,C-l-2 C-l-2 C-m-0 
job-3065,5,12,6,152810,186659,186680,33849,21,153034,false,L-m-0 C-l-0 C-l-0 C-m-0 L-l-0 L-l-0 
job-3064,2,10,1,152752,186659,186729,33907,70,153025,false,L-s-0 
job-3066,5,4,7,152870,186680,186770,33810,90,153036,false,L-l-0 C-l-1 L-m-0 C-l-0 C-l-1 L-l-0 C-l-0 
job-3067,2,5,4,152912,186770,186795,33858,25,153172,false,L-m-0 L-m-0 L-m-0 L-m-0 
job-3069,1,9,4,153006,186795,186840,33789,45,153163,false,L-l-0 L-l-0 L-l-0 L-l-0 
job-3070,1,10,6,153070,186795,186855,33725,60,153425,false,L-m-0 L-m-0 L-l-0 C-m-0 C-m-0 L-m-0 
job-3071,2,5,8,153120,186795,186904,33675,109,153259,false,C-l-0 C-l-0 C-l-0 C-l-0 C-l-0 C-m-0 L-s-0 C-m-0 
job-3068,1,8,1,152959,186770,186958,33811,188,153257,false,L-s-0 
job-3073,2,12,8,153228,186958,187006,33730,48,153396,false,L-l-0 L-l-0 L-l-0 L-s-0 L-m-0 L-m-0 L-l-0 C-m-1 
job-3072,5,12,1,153177,186795,187020,33618,225,153452,false,C-m-1 
job-3074,3,9,1,153273,187020,187049,33747,29,153554,false,L-s-0 
job-3075,1,12,8,153331,187020,187405,33689,385,153939,false,C-m-0 L-l-0 L-l-0 L-l-0 L-l-0 L-m-0 C-m-0 L-m-0 
job-3076,6,12,1,153378,187405,187418,34027,13,153558,false,L-m-0 
job-3077,3,5,5,153425,187405,187606,33980,201,153649,false,L-l-0 L-l-0 L-l-0 L-s-0 L-l-0 
job-3078,3,8,2,153482,187405,187761,33923,356,153965,false,C-m-0 C-m-0 
job-3080,1,9,8,153576,187761,187825,34185,64,153651,false,L-l-0 L-l-0 L-l-0 L-l-0 L-l-0 C-m-0 C-m-0 C-m-0 
job-3079,2,8,4,153525,187761,187854,34236,93,153659,false,L-m-0 L-m-0 L-m-0 L-m-0 
job-3081,2,5,4,153624,187761,187989,34137,228,154057,false,C-m-0 C-s-1 C-s-1 L-s-0 
job-3083,6,4,3,153730,187989,188010,34259,21,154030,false,L-l-0 L-l-0 C-m-0 
job-3084,2,12,3,153782,187989,188033,34207,44,154042,false,L-s-0 C-m-0 L-m-0 
job-3082,5,10,1,153679,187989,188043,34310,54,153743,false,L-m-0 
job-3086,4,11,7,153886,188033,188049,34147,16,154010,false,C-s-0 C-l-2 C-l-2 L-l-0 L-l-0 C-l-2 L-l-0 
job-3085,3,12,2,153835,188033,188050,34198,17,153860,false,L-s-0 L-m-0 
job-3087,2,8,3,153943,188033,188095,34090,62,154192,false,C-s-2 C-s-1 C-s-2 
job-3088,2,12,8,153995,188033,188185,34038,152,154396,false,C-l-0 C-l-0 C-l-1 C-l-1 C-l-0 C-l-0 C-l-1 C-l-1 
job-3090,5,4,5,154108,188185,188240,34077,55,154425,false,L-m-0 L-l-0 C-l-0 C-l-0 L-l-0 
job-3091,6,9,5,154162,188185,188242,34023,57,154239,false,C-m-0 C-l-2 C-l-1 C-l-2 C-l-1 
job-3089,2,7,2,154050,188185,188257,34135,72,154208,false,L-s-0 L-s-0 
job-3092,5,4,8,154215,188242,188364,34027,122,154401,false,L-l-0 C-l-1 C-l-0 C-l-0 C-l-1 L-l-0 C-m-0 L-m-0 
job-3093,5,10,7,154263,188364,188484,34101,120,154393,false,C-l-1 L-l-0 C-l-0 C-l-1 C-l-0 L-l-0 L-m-0 
job-3094,2,10,5,154311,188364,188609,34053,245,154621,false,L-s-0 L-l-0 C-l-1 L-m-0 C-l-0 
job-3095,3,9,5,154357,188364,188745,34007,381,155026,false,C-s-1 C-l-2 C-l-2 C-l-2 C-l-2 
job-3096,4,12,3,154404,188745,188825,34341,80,154780,false,L-m-0 L-m-0 L-s-0 
job-3097,3,11,2,154465,188745,188826,34280,81,154809,false,L-l-0 L-l-0 
job-3100,3,4,5,154623,188826,188888,34203,62,154813,false,C-l-0 C-l-0 L-l-0 C-l-0 C-l-0 
job-3099,4,6,4,154569,188826,188889,34257,63,154846,false,L-m-0 L-l-0 L-m-0 L-l-0 
job-3101,4,8,4,154673,188888,188903,34215,15,154963,false,L-l-0 C-l-0 C-l-0 C-l-0 
job-3102,4,10,2,154720,188888,188904,34168,16,154966,false,C-m-0 C-m-0 
job-3098,4,9,1,154518,188826,188912,34308,86,154749,false,L-s-0 
job-3104,2,11,5,154818,188888,188971,34070,83,154942,false,C-l-1 C-l-1 C-l-1 C-l-1 C-m-1 
job-3105,3,11,5,154877,188971,189023,34094,52,155101,false,L-s-0 L-l-0 L-l-0 L-l-0 L-l-0 
job-3103,3,7,2,154764,188888,189031,34124,143,155087,false,C-m-1 C-m-1 
job-3107,6,4,4,154980,189031,189043,34051,12,155113,false,L-m-0 L-l-0 L-l-0 C-m-0 
job-3106,2,6,1,154930,189031,189061,34101,30,155126,false,L-s-0 
job-3108,1,6,2,155023,189043,189190,34020,147,155257,false,L-s-0 L-m-0 
job-3109,5,7,4,155068,189190,189203,34122,13,155098,false,L-m-0 L-l-0 L-l-0 C-m-0 
job-3110,3,10,5,155130,189190,189239,34060,49,155371,false,C-m-0 L-m-0 L-s-0 C-s-2 C-s-0 
job-3111,2,10,2,155186,189239,189252,34053,13,155406,false,L-m-0 L-m-0 
job-3113,5,8,1,155291,189239,189284,33948,45,155345,false,C-m-0 
job-3112,4,10,4,155238,189239,189302,34001,63,155528,false,L-l-0 L-m-0 L-l-0 L-l-0 
job-3115,3,4,7,155412,189302,189410,33890,108,155681,false,L-m-0 L-l-0 L-l-0 L-m-0 L-l-0 L-l-0 C-s-1 
job-3114,1,4,2,155351,189302,189671,33951,369,155998,false,L-s-0 L-s-0 
job-3116,2,5,4,155472,189671,189754,34199,83,155784,false,L-m-0 L-m-0 L-m-0 L-m-0 
job-3117,4,10,3,155518,189671,189879,34153,208,155807,false,L-l-0 L-l-0 L-l-0 
job-3118,3,5,5,155573,189671,189956,34098,285,155885,false,L-s-0 C-l-0 C-l-0 C-l-0 C-l-0 
job-3119,3,11,3,155624,189956,189982,34332,26,155859,false,L-m-0 L-m-0 L-s-0 
job-3121,4,7,3,155728,189956,189993,34228,37,155942,false,C-l-0 C-l-0 C-l-0 
job-3120,4,10,5,155674,189956,189998,34282,42,155859,false,C-m-0 L-l-0 L-l-0 C-m-0 L-l-0 
job-3122,2,12,4,155779,189956,190032,34177,76,155855,false,C-l-1 C-l-1 C-l-1 C-l-1 
job-3123,4,11,5,155828,190032,190051,34204,19,155953,false,L-m-0 L-l-0 L-l-0 L-l-0 L-m-0 
job-3124,4,6,8,155876,190032,190064,34156,32,155955,false,C-s-1 C-l-2 C-l-0 C-l-0 C-l-2 C-l-0 L-s-0 C-l-2 
job-3126,2,10,2,155978,190032,190078,34054,46,156157,false,C-m-1 C-m-1 
job-3127,3,11,2,156017,190078,190132,34061,54,156213,false,L-m-0 L-m-0 
job-3125,1,9,1,155927,190032,190153,34105,121,156115,false,C-s-2 
job-3128,6,4,1,156080,190078,190160,33998,82,156186,false,L-l-0 
job-3129,2,12,3,156130,190160,190386,34030,226,156406,false,L-m-0 L-m-0 L-s-0 
job-3130,6,10,5,156195,190386,190401,34191,15,156319,false,L-m-0 C-l-0 L-l-0 L-l-0 C-l-0 
job-3131,1,5,3,156243,190386,190417,34143,31,156525,false,L-s-0 L-m-0 L-m-0 
job-3132,5,7,6,156281,190386,190516,34105,130,156571,false,C-m-0 C-l-1 C-l-1 C-m-1 C-l-2 C-l-2 
job-3133,4,10,7,156323,190516,190531,34193,15,156589,false,L-l-0 L-m-0 L-s-0 L-l-0 L-m-0 L-l-0 C-s-1 
job-3134,3,8,5,156372,190516,190551,34144,35,156620,false,C-s-2 C-l-0 C-l-0 C-l-0 C-l-0 
job-3135,5,6,6,156417,190516,191319,34099,803,157249,false,C-m-0 C-l-1 C-l-2 C-m-1 C-l-1 C-l-2 
job-3136,2,11,2,156464,191319,191394,34855,75,156597,false,L-m-0 L-m-0 
job-3137,1,5,3,156519,191394,191405,34875,11,156644,false,L-s-0 L-s-0 L-s-0 
job-3139,4,11,8,156613,191394,191512,34781,118,156933,false,L-m-0 C-l-0 C-l-0 C-l-0 C-l-1 L-m-0 C-l-1 C-l-1 
job-3140,6,7,3,156658,191512,191581,34854,69,157020,false,L-m-0 C-l-0 C-l-0 
job-3138,3,11,3,156569,191394,191685,34825,291,157040,false,L-l-0 L-l-0 L-l-0 
job-3141,1,7,4,156703,191685,191749,34982,64,157052,false,L-m-0 L-m-0 L-m-0 L-m-0 
job-3142,4,4,4,156761,191685,191851,34924,166,157183,false,L-l-0 L-m-0 L-l-0 L-l-0 
job-3143,5,11,5,156806,191685,191887,34879,202,157080,false,C-m-0 C-l-1 C-l-0 C-l-0 C-l-1 
job-3144,4,4,7,156854,191887,191908,35033,21,157173,false,L-l-0 L-m-0 L-s-0 L-l-0 L-m-0 L-l-0 C-s-1 
job-3145,6,8,3,156905,191887,192088,34982,201,157321,false,C-l-1 C-m-0 C-l-1 
job-3146,3,12,1,156945,192088,192104,35143,16,157110,false,L-s-0 
job-3147,6,6,2,156997,192088,192160,35091,72,157322,false,L-l-0 L-l-0 
job-3148,2,7,8,157045,192088,192255,35043,167,157449,false,C-m-0 L-m-0 L-m-0 L-m-0 C-m-0 C-m-0 L-m-0 C-m-0 
job-3149,2,6,1,157106,192255,192289,35149,34,157417,false,L-s-0 
job-3151,1,9,5,157210,192255,192517,35045,262,157701,false,L-s-0 L-m-0 L-m-0 C-m-0 C-m-0 
job-3150,6,10,3,157161,192255,192569,35094,314,157739,false,L-l-0 L-m-0 L-l-0 
job-3152,1,10,2,157269,192569,192627,35300,58,157446,false,L-m-0 L-m-0 
job-3153,2,10,5,157328,192569,192840,35241,271,157890,false,L-l-0 L-l-0 L-m-0 L-l-0 L-l-0 
job-3154,3,12,3,157375,192840,192924,35465,84,157692,false,L-m-0 L-m-0 L-s-0 
job-3155,2,8,2,157421,192840,192958,35419,118,157721,false,L-l-0 L-m-0 
job-3156,3,9,2,157480,192958,192984,35478,26,157610,false,L-m-0 L-m-0 
job-3157,2,12,6,157538,192958,193017,35420,59,157748,false,L-s-0 L-l-0 L-m-0 L-l-0 L-l-0 L-l-0 
job-3158,3,11,3,157575,192958,193037,35383,79,157791,false,C-l-0 C-l-0 C-l-0 
job-3160,1,8,2,157661,193017,193092,35356,75,157866,false,L-s-0 L-m-0 
job-3159,1,4,7,157621,192958,193092,35337,134,157849,false,C-s-2 C-l-0 C-l-0 L-s-0 C-s-2 C-l-0 C-s-2 
job-3161,3,12,4,157708,193092,193128,35384,36,157955,false,L-l-0 L-l-0 L-l-0 L-l-0 
job-3162,2,9,5,157755,193092,193161,35337,69,158123,false,C-s-0 L-m-0 L-s-0 L-m-0 L-m-0 
job-3166,3,10,7,157956,193161,193186,35205,25,158254,false,L-m-0 C-l-2 C-l-2 C-s-1 C-l-2 C-l-2 L-m-0 
job-3163,6,12,3,157802,193092,193187,35290,95,157916,false,C-l-0 C-l-0 C-m-0 
job-3164,3,4,1,157850,193128,193194,35278,66,157999,false,L-l-0 
job-3168,6,6,7,158065,193187,193200,35122,13,158192,false,C-m-2 C-l-2 C-l-0 C-m-0 C-l-0 C-l-2 L-m-0 
job-3167,4,8,2,158012,193161,193209,35149,48,158069,false,C-m-1 C-m-1 
job-3169,2,10,8,158122,193187,193212,35065,25,158398,false,C-l-1 C-l-1 C-l-1 C-s-1 C-m-2 C-l-1 L-s-0 L-m-0 
job-3170,4,8,7,158169,193200,193224,35031,24,158400,false,C-m-0 C-s-2 C-s-0 C-m-2 C-l-1 L-l-0 L-m-0 
job-3165,2,6,6,157907,193161,193224,35254,63,158065,false,L-s-0 L-l-0 L-l-0 C-m-0 L-l-0 L-l-0 
job-3171,5,5,3,158223,193200,193238,34977,38,158410,false,C-l-0 C-l-2 C-l-0 
job-3172,4,12,3,158264,193209,193308,34945,99,158472,false,C-m-1 C-l-2 C-m-1 
job-3173,6,12,3,158315,193308,193356,34993,48,158655,false,L-l-0 L-l-0 L-m-0 
job-3174,3,9,5,158359,193308,193498,34949,190,158720,false,L-s-0 C-l-0 C-l-0 C-l-0 C-l-0 
job-3175,3,8,6,158411,193308,193672,34897,364,158986,false,C-m-0 C-l-2 C-l-2 C-m-0 C-l-2 C-l-2 
job-3178,5,5,4,158554,193672,193729,35118,57,158629,false,C-l-1 C-l-0 C-l-0 C-l-1 
job-3176,5,9,2,158466,193672,193741,35206,69,158666,false,L-l-0 L-l-0 
job-3179,3,8,4,158612,193729,193751,35117,22,158870,false,L-s-0 C-s-2 L-m-0 C-s-0 
job-3177,2,12,3,158516,193672,193761,35156,89,158712,false,L-m-0 L-m-0 L-l-0 
job-3180,5,7,2,158669,193729,194029,35060,300,158988,false,C-l-0 C-l-0 
job-3181,2,7,7,158723,194029,194062,35306,33,158780,false,L-l-0 L-l-0 L-s-0 L-l-0 L-l-0 L-s-0 L-l-0 
job-3182,6,5,2,158765,194029,194085,35264,56,159049,false,L-m-0 C-m-0 
job-3183,1,9,1,158832,194085,194117,35253,32,159100,false,L-s-0 
job-3184,6,6,6,158882,194085,194216,35203,131,159275,false,L-m-0 C-l-1 L-l-0 C-m-0 C-l-1 L-l-0 
job-3186,6,5,5,158966,194216,194276,35250,60,159309,false,C-m-0 L-l-0 C-l-0 L-l-0 C-l-0 
job-3188,5,6,2,159061,194216,194292,35155,76,159433,false,C-m-2 C-m-1 
job-3187,6,8,4,159012,194216,194296,35204,80,159212,false,C-l-1 C-l-2 C-l-2 C-l-1 
job-3189,6,10,8,159102,194296,194307,35194,11,159282,false,L-l-0 C-l-2 C-l-0 C-l-1 C-l-1 L-l-0 C-l-2 C-l-0 
job-3185,1,5,4,158917,194216,194346,35299,130,159074,false,L-m-0 L-m-0 L-m-0 L-m-0 
job-3190,6,5,8,159146,194307,194446,35161,139,159447,false,L-l-0 C-l-2 C-l-0 C-l-1 C-l-1 L-l-0 C-l-2 C-l-0 
job-3191,3,5,7,159201,194307,194540,35106,233,159618,false,C-m-0 L-m-0 C-s-1 C-m-1 C-m-0 L-s-0 C-m-1 
job-3193,5,12,3,159304,194540,194556,35236,16,159379,false,L-m-0 C-l-0 C-l-0 
job-3192,1,9,5,159250,194540,194635,35290,95,159431,false,L-l-0 L-l-0 L-l-0 L-l-0 L-l-0 
job-3194,1,6,2,159359,194635,194676,35276,41,159687,false,L-s-0 L-s-0 
job-3195,6,12,6,159422,194635,194683,35213,48,159719,false,L-m-0 C-l-1 L-l-0 C-m-0 C-l-1 L-l-0 
job-3196,6,9,6,159480,194635,194686,35155,51,159543,false,C-m-2 C-l-2 C-l-0 C-m-1 C-l-0 C-l-2 
job-3197,2,10,8,159533,194676,194751,35143,75,159680,false,C-s-1 C-m-2 L-s-0 C-s-0 C-m-1 L-m-0 C-s-2 C-m-0 
job-3199,1,7,6,159635,194751,194804,35116,53,159931,false,L-m-0 L-m-0 L-l-0 L-m-0 L-l-0 L-m-0 
job-3198,5,6,2,159579,194751,194817,35172,66,159930,false,L-l-0 L-l-0 
job-3200,2,6,7,159672,194751,194837,35079,86,159830,false,L-s-0 C-l-0 C-l-0 C-l-0 C-l-0 C-l-0 C-l-0 
job-3201,3,9,3,159720,194751,194869,35031,118,159901,false,C-l-1 C-l-1 C-l-1 
job-3202,2,8,3,159774,194751,194940,34977,189,160116,false,L-s-0 C-s-1 C-l-1 
job-3203,3,11,8,159819,194940,194952,35121,12,159958,false,L-m-0 L-l-0 L-l-0 L-m-0 L-l-0 L-l-0 C-s-2 L-s-0 
job-3205,6,10,5,159920,194940,194967,35020,27,159948,false,C-m-0 C-l-0 C-m-2 C-m-1 C-l-0 
job-3204,4,8,7,159876,194940,194969,35064,29,160161,false,C-s-1 C-l-1 C-l-1 C-l-2 C-l-1 C-l-2 C-l-2 
job-3206,6,12,5,159967,194967,194981,35000,14,159984,false,L-l-0 L-l-0 C-l-0 L-m-0 C-l-0 
job-3208,3,10,8,160073,194981,195060,34908,79,160163,false,C-s-1 L-s-0 C-l-2 C-l-2 C-l-2 C-l-2 C-m-0 L-m-0 
job-3207,5,8,8,160024,194981,195092,34957,111,160180,false,L-l-0 C-l-0 C-l-1 C-l-1 C-l-0 L-l-0 C-m-0 L-m-0 
job-3209,6,7,8,160128,195092,195244,34964,152,160294,false,L-l-0 C-l-0 C-l-0 C-l-1 C-l-1 L-l-0 C-m-0 L-m-0 
job-3210,6,4,5,160182,195244,195340,35062,96,160332,false,L-m-0 C-l-0 L-l-0 L-l-0 C-l-0 
job-3211,1,9,4,160236,195340,195377,35104,37,160367,false,L-l-0 L-l-0 L-l-0 L-l-0 
job-3212,6,11,7,160275,195340,195461,35065,121,160595,false,C-m-0 C-l-0 C-l-1 L-l-0 C-l-0 C-l-1 L-m-0 
job-3213,1,5,7,160321,195461,195481,35140,20,160433,false,L-l-0 L-l-0 L-l-0 L-l-0 L-l-0 L-l-0 L-l-0 
job-3214,5,8,3,160369,195461,195621,35092,160,160568,false,L-l-0 L-m-0 C-m-0 
job-3215,1,10,7,160430,195621,195691,35191,70,160761,false,L-m-0 L-l-0 L-l-0 L-m-0 L-l-0 L-l-0 L-m-0 
job-3217,4,6,8,160541,195691,195774,35150,83,160814,false,L-m-0 C-l-0 L-l-0 C-l-0 C-l-0 L-l-0 L-m-0 L-l-0 
job-3218,6,8,4,160588,195774,195806,35186,32,160773,false,L-m-0 L-l-0 L-l-0 C-m-0 
job-3219,6,5,2,160633,195774,195859,35141,85,160796,false,C-l-0 C-l-0 
job-3216,4,8,1,160482,195691,195975,35209,284,161042,false,L-s-0 
job-3220,4,5,7,160678,195774,196001,35096,227,160979,false,C-l-2 C-l-1 C-l-2 C-l-2 C-l-1 C-l-1 C-s-1 
job-3221,6,4,2,160722,195975,196010,35253,35,160770,false,L-l-0 L-l-0 
job-3225,6,10,3,160915,195975,196015,35060,40,161224,false,C-l-0 C-m-0 C-l-0 
job-3222,1,12,1,160773,195975,196016,35202,41,161052,false,L-s-0 
job-3226,2,7,8,160969,195975,196031,35006,56,161039,false,C-m-2 C-m-2 C-m-0 C-m-1 C-m-1 C-m-1 C-m-1 C-m-2 
job-3223,2,5,3,160821,195975,196059,35154,84,161038,false,L-m-0 L-m-0 L-m-0 
job-3224,1,4,6,160867,195975,196109,35108,134,161006,false,C-s-2 L-m-0 L-m-0 C-s-2 C-s-2 L-s-0 
job-3227,4,11,6,161027,196001,196182,34974,181,161242,false,C-l-2 C-l-1 C-l-2 C-l-2 C-l-1 C-l-1 
job-3228,2,5,7,161083,196182,196201,35099,19,161362,false,L-l-0 L-l-0 L-s-0 L-l-0 L-l-0 L-s-0 L-l-0 
job-3229,5,10,3,161132,196182,196251,35050,69,161217,false,L-m-0 C-l-0 C-l-0 
job-3230,4,6,1,161179,196182,196283,35003,101,161298,false,C-s-1 
job-3231,1,11,4,161237,196283,196300,35046,17,161345,false,L-l-0 L-l-0 L-l-0 L-l-0 
job-3233,5,8,2,161335,196283,196325,34948,42,161642,false,C-m-0 L-m-0 
job-3232,1,12,3,161281,196283,196409,35002,126,161480,false,L-s-0 L-m-0 L-m-0 
job-3234,2,8,8,161384,196283,196482,34899,199,161761,false,C-s-2 C-m-1 C-s-0 C-s-0 C-s-2 C-m-1 C-m-1 C-m-0 
job-3235,5,8,3,161448,196482,196504,35034,22,161754,false,L-l-0 L-l-0 L-m-0 
job-3237,2,10,6,161551,196504,196531,34953,27,161663,false,L-s-0 L-l-0 L-l-0 L-m-0 L-l-0 L-l-0 
job-3238,2,11,7,161609,196504,196548,34895,44,161936,false,L-m-0 C-l-0 C-l-0 C-l-0 C-l-0 C-s-1 L-m-0 
job-3236,2,4,1,161496,196504,196577,35008,73,161767,false,L-s-0 
job-3240,5,4,8,161727,196531,196641,34804,110,161970,false,C-m-1 L-l-0 C-l-1 C-l-2 C-l-1 L-l-0 C-m-0 C-l-2 
job-3241,3,9,4,161773,196641,196685,34868,44,161965,false,L-l-0 L-l-0 L-l-0 L-l-0 
job-3239,3,12,1,161671,196504,196692,34833,188,162084,false,C-s-2 
job-3242,4,7,3,161834,196641,196748,34807,107,162077,false,L-m-0 L-m-0 L-s-0 
job-3243,2,8,4,161885,196748,196773,34863,25,162180,false,L-m-0 L-m-0 L-m-0 L-m-0 
job-3244,2,7,3,161933,196748,196800,34815,52,162048,false,L-l-0 L-l-0 L-l-0 
job-3245,6,7,6,161981,196748,197066,34767,318,162539,false,C-l-0 C-l-2 C-l-0 C-m-0 C-l-2 L-l-0 
job-3247,6,5,6,162084,197066,197140,34982,74,162227,false,L-m-0 C-l-1 C-l-1 C-m-0 L-l-0 L-l-0 
job-3246,2,10,1,162037,197066,197157,35029,91,162296,false,L-s-0 
job-3248,2,11,6,162131,197140,197165,35009,25,162248,false,L-m-0 L-l-0 L-l-0 L-m-0 L-l-0 L-l-0 
job-3249,2,12,8,162186,197140,197193,34954,53,162470,false,C-l-0 C-l-0 C-l-1 C-l-1 C-l-1 C-l-1 C-l-0 C-l-0 
job-3250,3,7,7,162236,197193,197208,34957,15,162383,false,L-s-0 L-l-0 L-l-0 L-m-0 L-l-0 L-l-0 L-m-0 
job-3251,3,9,3,162296,197193,197241,34897,48,162537,false,C-l-0 C-l-0 C-l-0 
job-3252,2,6,3,162344,197193,197670,34849,477,163028,false,C-s-1 L-m-0 C-l-0 
job-3253,6,10,7,162402,197670,197717,35268,47,162690,false,L-m-0 C-l-0 C-l-1 L-l-0 C-l-0 C-l-1 L-l-0 
job-3254,3,6,5,162457,197670,197754,35213,84,162738,false,C-l-2 C-l-2 C-l-2 L-s-0 C-l-2 
job-3255,6,4,8,162493,197717,197840,35224,123,162764,false,L-l-0 C-l-1 L-l-0 C-l-0 C-l-1 L-m-0 C-l-0 C-m-0 
job-3256,1,5,6,162547,197717,197845,35170,128,162838,false,L-s-0 C-m-0 C-s-0 L-m-0 C-m-0 L-m-0 
job-3257,5,5,3,162579,197754,198011,35175,257,163018,false,C-l-2 C-l-2 C-m-1 
job-3258,4,9,1,162629,198011,198026,35382,15,162803,false,L-s-0 
job-3259,5,10,4,162681,198011,198044,35330,33,162775,false,L-m-0 L-l-0 L-l-0 C-m-0 
job-3260,4,12,3,162724,198011,198234,35287,223,163062,false,C-l-0 C-l-0 C-l-0 
job-3261,1,6,7,162786,198234,198292,35448,58,163015,false,L-l-0 L-l-0 L-l-0 L-l-0 L-l-0 L-l-0 L-l-0 
job-3262,3,8,5,162836,198234,198345,35398,111,163222,false,L-m-0 C-m-0 L-s-0 C-m-0 L-m-0 
job-3263,3,8,1,162888,198234,198427,35346,193,163084,false,C-s-1 
job-3264,3,7,8,162943,198427,198440,35484,13,163208,false,L-m-0 L-s-0 C-s-1 L-l-0 L-l-0 L-l-0 L-l-0 L-m-0 
job-3265,3,5,1,162988,198427,198445,35439,18,163091,false,C-s-2 
job-3266,1,9,6,163027,198427,198498,35400,71,163319,false,C-s-2 L-m-0 L-m-0 L-s-0 C-s-0 C-s-1 
job-3267,5,7,3,163086,198498,198516,35412,18,163346,false,L-l-0 L-l-0 L-m-0 
job-3268,2,7,6,163132,198498,198550,35366,52,163274,false,C-s-2 L-s-0 L-l-0 L-m-0 L-s-0 C-s-2 
job-3269,5,9,6,163169,198498,198610,35329,112,163288,false,C-l-0 C-l-1 C-l-1 C-l-2 C-l-0 C-l-2 
job-3270,2,5,7,163215,198610,198630,35395,20,163372,false,L-l-0 L-l-0 L-s-0 L-l-0 L-l-0 L-s-0 L-l-0 
job-3271,3,5,1,163262,198610,198639,35348,29,163331,false,L-m-0 
job-3274,4,9,7,163420,198610,198763,35190,153,163582,false,C-m-1 C-l-1 C-l-1 C-s-1 C-l-1 C-m-1 C-s-0 
job-3272,4,6,4,163324,198610,198767,35286,157,163495,false,C-l-0 C-l-0 C-l-0 L-m-0 
job-3273,6,8,3,163374,198610,198910,35236,300,163834,false,C-l-2 C-m-0 C-l-2 
job-3275,1,5,4,163467,198767,198952,35300,185,163756,false,C-m-0 C-m-0 L-s-0 L-s-0 
job-3276,6,6,2,163508,198910,198980,35402,70,163758,false,L-m-0 C-m-0 
job-3278,3,6,2,163601,198952,199020,35351,68,163708,false,L-s-0 C-s-2 
job-3277,6,6,8,163546,198910,199024,35364,114,163714,false,L-l-0 L-l-0 C-l-1 C-l-2 C-l-0 C-l-1 C-l-0 C-l-2 
job-3279,2,5,4,163661,198952,199181,35291,229,164050,false,L-m-0 C-s-1 C-s-1 C-m-0 
job-3280,1,4,3,163707,199181,199199,35474,18,163875,false,L-s-0 L-s-0 L-s-0 
job-3281,4,11,3,163749,199181,199202,35432,21,163821,false,L-l-0 L-l-0 L-l-0 
job-3282,4,12,5,163793,199181,199210,35388,29,164049,false,C-l-0 L-m-0 L-m-0 C-l-0 C-l-0 
job-3283,3,9,5,163837,199181,199219,35344,38,163998,false,C-l-1 C-l-1 C-l-1 C-s-1 C-l-1 
job-3284,4,7,6,163877,199181,199273,35304,92,164223,false,C-m-1 C-s-2 C-l-2 C-m-1 C-l-2 C-l-2 
job-3285,3,11,7,163918,199202,199282,35284,80,164280,false,L-s-0 L-l-0 L-l-0 C-m-0 L-l-0 L-l-0 C-m-0 
job-3287,5,10,5,164029,199219,199297,35190,78,164329,false,C-l-0 C-l-1 C-l-0 L-m-0 C-l-1 
job-3286,2,7,5,163982,199202,199407,35220,205,164389,false,C-m-2 C-m-0 C-m-2 C-m-2 C-m-2 
job-3288,4,9,8,164073,199407,199418,35334,11,164307,false,L-m-0 L-l-0 L-l-0 L-l-0 C-m-0 L-s-0 L-m-0 C-m-0 
job-3289,2,5,6,164121,199407,199432,35286,25,164336,false,C-l-0 C-l-0 C-l-0 C-l-0 C-l-0 C-l-0 
job-3290,2,11,1,164172,199407,199445,35235,38,164313,false,C-s-1 
job-3291,4,10,6,164224,199407,199593,35183,186,164585,false,C-l-1 C-l-2 C-l-2 C-l-1 C-l-2 C-l-1 
job-3292,4,11,7,164278,199418,200078,35140,660,165145,false,L-m-0 L-s-0 L-l-0 C-s-2 L-l-0 L-l-0 L-m-0 
job-3293,3,10,1,164334,200078,200326,35744,248,164666,false,L-s-0 
job-3295,4,5,3,164436,200078,200434,35642,356,164936,false,C-l-0 C-l-0 C-l-0 
job-3294,3,11,8,164388,200078,200545,35690,467,165108,false,C-s-0 L-l-0 L-l-0 L-l-0 L-l-0 L-m-0 C-s-1 L-m-0 
job-3296,1,8,7,164490,200545,200555,36055,10,164506,false,L-s-0 L-s-0 L-l-0 L-l-0 L-l-0 L-l-0 L-l-0 
job-3299,5,11,5,164640,200545,200681,35905,136,164924,false,C-m-0 C-l-1 C-m-2 C-m-1 C-l-1 
job-3298,4,11,7,164580,200545,200714,35965,169,164771,false,C-l-0 C-l-2 C-l-0 C-s-2 C-l-0 C-l-2 C-l-2 
job-3297,1,8,6,164540,200545,200714,36005,169,164985,false,L-l-0 L-m-0 L-m-0 C-s-1 L-m-0 C-s-1 
job-3300,1,9,4,164696,200714,200812,36018,98,164970,false,L-l-0 L-l-0 L-l-0 L-l-0 
job-3302,1,9,6,164780,200812,200832,36032,20,165009,false,L-m-0 L-l-0 L-l-0 L-l-0 L-l-0 L-l-0 
job-3301,2,8,1,164737,200812,200894,36075,82,164943,false,L-s-0 
job-3304,3,11,7,164885,200812,200920,35927,108,165159,false,C-l-2 C-l-2 C-l-0 C-s-1 C-l-2 C-l-2 L-m-0 
job-3303,2,12,8,164836,200812,200984,35976,172,165161,false,L-m-0 C-l-1 C-l-1 C-l-1 C-l-1 C-l-0 C-l-0 C-l-0 
job-3306,4,12,3,164990,200984,200999,35994,15,165061,false,L-m-0 L-m-0 L-s-0 
job-3305,5,12,2,164940,200984,201004,36044,20,165135,false,L-l-0 L-l-0 
job-3307,2,12,3,165044,200984,201189,35940,205,165534,false,C-m-0 C-m-0 L-l-0 
job-3308,5,4,2,165107,200984,201189,35877,205,165436,false,C-l-0 C-l-0 
job-3309,2,7,2,165157,201189,201212,36032,23,165334,false,L-s-0 C-l-0 
job-3311,2,12,7,165258,201189,201403,35931,214,165624,false,C-m-0 C-l-1 C-l-1 C-m-0 C-l-1 C-l-1 L-m-0 
job-3310,1,10,5,165210,201189,201412,35979,223,165594,false,L-m-0 L-l-0 L-l-0 L-l-0 L-l-0 
job-3312,4,8,8,165304,201403,201494,36099,91,165458,false,L-s-0 C-l-1 C-m-0 C-l-1 C-l-1 L-m-0 C-m-0 L-l-0 
job-3313,5,5,2,165358,201403,201498,36045,95,165490,false,C-l-0 C-l-0 
job-3314,2,11,2,165405,201494,201943,36089,449,166130,false,L-s-0 C-l-0 
job-3315,4,11,8,165459,201943,202136,36484,193,165800,false,L-l-0 L-m-0 L-l-0 L-m-0 C-m-1 L-s-0 L-l-0 C-m-1 
job-3316,6,10,3,165510,201943,202272,36433,329,166071,false,C-l-1 C-m-0 C-l-1 
job-3318,1,6,4,165596,202272,202303,36676,31,165693,false,C-m-0 C-m-0 C-m-0 C-m-0 
job-3321,4,12,2,165721,202272,202308,36551,36,165797,false,C-m-2 C-m-2 
job-3320,3,12,1,165679,202272,202317,36593,45,165974,false,C-s-0 
job-3319,4,9,1,165636,202272,202322,36636,50,165753,false,C-s-2 
job-3317,4,4,7,165552,202272,202323,36720,51,165785,false,L-l-0 L-m-0 L-s-0 L-l-0 L-m-0 L-l-0 C-s-1 
job-3322,5,9,8,165768,202303,202334,36535,31,166053,false,C-m-1 C-l-0 C-l-1 C-l-2 C-l-1 C-l-0 C-l-2 C-m-0 
job-3323,6,8,3,165819,202323,202517,36504,194,166068,false,L-m-0 L-l-0 L-l-0 
job-3324,1,12,5,165878,202517,202538,36639,21,165982,false,L-s-0 L-l-0 L-l-0 L-l-0 L-l-0 
job-3326,5,4,3,165975,202517,202819,36542,302,166540,false,C-m-1 C-l-1 C-l-1 
job-3325,5,4,4,165930,202517,202837,36587,320,166254,false,L-m-0 C-l-0 C-l-0 C-m-0 
job-3328,6,6,5,166071,202819,202946,36748,127,166216,false,C-m-1 C-l-2 C-l-1 C-l-1 C-l-2 
job-3327,3,12,6,166023,202819,203014,36796,195,166334,false,C-m-0 L-l-0 L-l-0 L-l-0 L-l-0 L-m-0 
job-3329,2,11,4,166120,203014,203036,36894,22,166192,false,L-l-0 L-l-0 L-l-0 L-l-0 
job-3330,4,10,1,166171,203036,203046,36865,10,166419,false,L-s-0 
job-3333,2,7,4,166314,203036,203064,36722,28,166370,false,C-m-0 L-m-0 C-m-0 C-m-0 
job-3331,4,11,3,166211,203036,203065,36825,29,166252,false,L-l-0 L-l-0 L-l-0 
job-3332,1,4,6,166264,203036,203149,36772,113,166402,false,L-m-0 L-m-0 L-m-0 L-m-0 L-m-0 L-m-0 
job-3334,5,5,4,166361,203036,203228,36675,192,166573,false,C-l-0 C-l-1 C-l-1 C-l-0 
job-3335,5,9,2,166416,203228,203254,36812,26,166491,false,L-l-0 L-l-0 
job-3336,5,8,7,166458,203228,203404,36770,176,166845,false,L-m-0 C-l-0 C-l-1 C-l-2 C-l-1 C-l-2 C-l-0 
job-3337,2,5,2,166509,203404,203527,36895,123,166924,false,L-s-0 L-s-0 
job-3339,4,12,2,166605,203404,203581,36799,177,167023,false,C-m-1 C-m-1 
job-3340,2,5,6,166653,203581,203612,36928,31,166723,false,L-s-0 L-m-0 L-s-0 C-s-1 L-m-0 C-s-1 
job-3338,1,11,6,166555,203404,203618,36849,214,166994,false,L-m-0 L-l-0 L-l-0 L-m-0 L-l-0 L-l-0 
job-3341,3,10,7,166716,203581,203687,36865,106,166903,false,C-s-0 C-l-0 C-l-0 C-m-0 C-l-0 C-l-0 C-m-0 
job-3342,6,5,8,166763,203618,203703,36855,85,167142,false,C-l-1 L-l-0 C-l-2 C-l-2 C-l-1 L-l-0 C-m-1 L-m-0 
job-3343,3,5,8,166821,203687,204241,36866,554,167519,false,C-s-1 C-l-0 C-l-0 L-s-0 C-l-0 C-m-0 C-l-0 C-m-0 
job-3344,1,11,5,166869,204241,204461,37372,220,167379,false,L-s-0 L-l-0 L-l-0 L-l-0 L-l-0 
job-3345,6,5,5,166914,204241,204516,37327,275,167447,false,C-l-0 C-l-1 C-l-0 L-m-0 C-l-1 
job-3346,6,5,7,166965,204461,204606,37496,145,167281,false,C-m-2 L-l-0 L-l-0 C-m-0 C-l-2 C-l-2 C-m-1 
job-3347,3,9,1,167012,204606,204643,37594,37,167308,false,L-s-0 
job-3348,6,11,6,167060,204606,204685,37546,79,167275,false,L-m-0 L-l-0 C-l-1 C-m-0 C-l-1 L-l-0 
job-3349,4,8,5,167105,204606,204702,37501,96,167446,false,C-m-1 C-l-2 C-l-2 C-m-1 C-l-2 
job-3350,3,11,8,167147,204606,204752,37459,146,167409,false,C-s-2 C-l-0 C-l-0 C-l-0 C-l-0 C-m-2 C-s-1 C-m-2 
job-3353,4,7,1,167302,204752,204845,37450,93,167667,false,C-s-2 
job-3354,6,8,1,167345,204752,204845,37407,93,167653,false,C-m-1 
job-3352,3,5,4,167248,204752,204848,37504,96,167379,false,L-l-0 L-l-0 L-l-0 L-l-0 
job-3351,4,9,3,167197,204685,204942,37488,257,167664,false,L-s-0 L-m-0 L-m-0 
job-3355,4,8,4,167382,204752,204946,37370,194,167850,false,C-s-1 C-l-1 C-l-1 C-l-1 
job-3356,1,7,7,167431,204752,205085,37321,333,167781,false,C-l-0 C-l-0 C-m-1 C-l-0 C-m-1 C-l-0 C-l-0 
job-3357,2,4,5,167484,205085,205098,37601,13,167619,false,L-l-0 L-l-0 L-l-0 L-l-0 L-l-0 
job-3359,5,7,4,167583,205085,205131,37502,46,167912,false,C-l-0 C-l-1 C-l-0 C-l-1 
job-3358,4,8,5,167535,205085,205149,37550,64,167653,false,L-s-0 L-m-0 L-m-0 C-m-0 C-m-0 
job-3360,1,9,2,167627,205131,205245,37504,114,167817,false,L-l-0 L-l-0 
job-3362,6,4,5,167707,205245,205411,37538,166,167986,false,L-m-0 C-l-0 L-l-0 L-l-0 C-l-0 
job-3363,5,5,1,167768,205411,205456,37643,45,167919,false,L-m-0 
job-3361,4,7,1,167669,205245,205466,37576,221,168164,false,L-s-0 
job-3364,6,6,7,167818,205411,205577,37593,166,168125,false,C-m-0 C-l-2 L-l-0 C-l-2 C-l-0 C-l-0 L-l-0 
job-3365,6,8,8,167869,205577,205663,37708,86,168248,false,L-l-0 C-l-0 C-l-0 C-l-1 C-l-1 L-l-0 C-m-0 L-m-0 
job-3367,1,11,6,167974,205663,205682,37689,19,168124,false,L-m-0 C-l-0 C-l-0 L-m-0 C-l-0 C-l-0 
job-3366,6,5,2,167923,205663,205708,37740,45,168169,false,L-l-0 L-l-0 
job-3368,3,7,5,168023,205663,205796,37640,133,168224,false,L-m-0 C-l-1 C-l-1 C-l-1 C-l-1 
job-3369,4,7,5,168079,205796,205823,37717,27,168237,false,L-m-0 L-l-0 L-l-0 L-l-0 L-m-0 
job-3370,4,11,2,168126,205796,205861,37670,65,168241,false,L-s-0 C-s-2 
job-3371,5,9,6,168180,205796,205942,37616,146,168357,false,C-l-0 C-l-1 C-l-2 C-l-2 C-l-1 C-l-0 
job-3372,4,11,1,168220,205861,205949,37641,88,168472,false,L-s-0 
job-3375,6,5,2,168363,205942,205987,37579,45,168450,false,C-l-0 C-l-0 
job-3373,2,12,5,168276,205942,205996,37666,54,168373,false,L-l-0 L-m-0 L-m-0 L-l-0 L-l-0 
job-3374,3,5,4,168323,205942,206036,37619,94,168486,false,L-m-0 L-l-0 L-l-0 C-s-1 
job-3376,6,8,5,168421,205942,206329,37521,387,169012,false,C-l-1 C-l-2 C-l-2 C-m-0 C-l-1 
job-3377,4,12,1,168477,206329,206543,37852,214,168812,false,L-s-0 
job-3378,2,4,8,168531,206543,206561,38012,18,168830,false,L-s-0 L-l-0 L-l-0 L-l-0 L-l-0 L-s-0 L-l-0 L-l-0 
job-3379,5,10,2,168565,206543,206584,37978,41,168715,false,L-m-0 C-m-0 
job-3380,1,6,8,168614,206543,206591,37929,48,168677,false,L-m-0 C-s-1 C-s-1 C-m-0 L-m-0 C-m-0 C-m-0 L-m-0 
job-3381,6,7,1,168671,206543,206619,37872,76,169025,false,C-m-1 
job-3383,6,5,6,168762,206619,206655,37857,36,168953,false,L-m-0 L-l-0 C-l-1 C-m-0 C-l-1 L-l-0 
job-3382,1,5,2,168716,206619,206838,37903,219,169107,false,L-s-0 L-s-0 
job-3384,2,6,1,168807,206838,206851,38031,13,169086,false,L-s-0 
job-3385,5,6,5,168853,206838,207252,37985,414,169386,false,L-m-0 C-l-0 C-l-0 L-l-0 L-l-0 
job-3386,6,6,8,168900,207252,207632,38352,380,169338,false,L-l-0 C-l-0 C-l-0 C-l-1 C-l-1 L-l-0 C-m-0 L-m-0 
job-3388,3,12,8,168986,207632,207690,38646,58,169337,false,C-m-0 L-l-0 L-l-0 L-l-0 L-l-0 L-m-0 C-m-0 L-m-0 
job-3387,3,4,1,168943,207632,207808,38689,176,169406,false,L-s-0 
job-3389,4,9,3,169034,207808,207826,38774,18,169131,false,L-m-0 L-m-0 L-s-0 
job-3390,3,6,2,169076,207808,207826,38732,18,169179,false,L-l-0 L-l-0 
job-3391,5,4,3,169123,207808,207855,38685,47,169442,false,L-l-0 C-l-0 C-l-0 
job-3392,6,6,8,169186,207826,207909,38640,83,169367,false,C-m-2 C-l-1 C-l-1 C-l-2 C-l-2 C-m-0 C-m-1 L-m-0 
job-3393,2,9,7,169231,207909,207930,38678,21,169372,false,L-m-0 L-l-0 L-l-0 L-l-0 L-l-0 L-l-0 L-m-0 
job-3394,3,4,8,169270,207909,208110,38639,201,169525,false,L-s-0 C-l-1 C-l-1 C-l-1 C-l-1 C-m-0 C-m-0 L-m-0 
job-3396,3,12,4,169371,208110,208128,38739,18,169676,false,L-l-0 L-l-0 L-l-0 L-l-0 
job-3395,1,5,1,169326,208110,208164,38784,54,169443,false,L-s-0 
job-3397,6,8,1,169420,208110,208584,38690,474,170120,false,L-m-0 
job-3398,3,4,7,169471,208584,208606,39113,22,169598,false,L-s-0 L-l-0 L-l-0 L-m-0 L-l-0 L-l-0 L-m-0 
job-3399,2,11,8,169527,208584,208704,39057,120,169714,false,C-l-0 L-m-0 C-l-1 C-l-1 C-l-1 C-l-1 C-l-0 C-l-0 
job-3400,6,7,7,169572,208704,208751,39132,47,169765,false,L-m-0 C-l-0 C-l-1 L-l-0 C-l-0 C-l-1 L-l-0 
job-3402,6,12,5,169673,208751,208892,39078,141,169822,false,C-l-0 L-l-0 L-l-0 C-l-0 L-m-0 
job-3401,4,10,4,169621,208704,208974,39083,270,170017,false,L-s-0 C-l-2 C-l-2 C-l-2 
job-3404,6,7,4,169778,208974,208992,39196,18,170052,false,C-m-0 C-l-0 C-l-0 L-m-0 
job-3403,4,6,3,169725,208974,209018,39249,44,169973,false,L-l-0 L-l-0 L-l-0 
job-3405,6,8,5,169831,208974,209135,39143,161,170255,false,C-m-1 C-l-1 C-l-1 C-l-2 C-l-2 
job-3406,6,10,1,169874,209135,209198,39261,63,170095,false,L-m-0 
job-3408,6,9,2,169983,209135,209215,39152,80,170128,false,C-m-0 L-l-0 
job-3409,3,7,5,170030,209198,209244,39168,46,170279,false,L-s-0 C-m-1 L-m-0 L-m-0 C-m-1 
job-3407,5,8,1,169924,209135,209309,39211,174,170316,false,L-l-0 
job-3410,1,6,3,170086,209309,209544,39223,235,170486,false,L-m-0 L-m-0 L-m-0 
job-3411,3,10,1,170128,209544,209570,39416,26,170363,false,L-s-0 
job-3412,2,11,2,170176,209544,209590,39368,46,170498,false,L-m-0 L-m-0 
job-3414,2,4,3,170258,209590,209636,39332,46,170420,false,L-m-0 L-m-0 L-m-0 
job-3416,5,9,4,170360,209590,209639,39230,49,170453,false,C-m-0 L-l-0 C-l-0 C-l-0 
job-3415,1,7,7,170307,209590,209656,39283,66,170532,false,L-l-0 L-m-0 L-s-0 L-l-0 L-l-0 L-m-0 L-l-0 
job-3418,6,7,6,170469,209636,209702,39167,66,170579,false,C-l-2 L-m-0 C-l-1 C-m-2 C-l-1 C-l-2 
job-3413,3,5,1,170217,209590,209724,39373,134,170440,false,L-s-0 
job-3417,3,7,4,170410,209590,209753,39180,163,170725,false,C-m-0 L-l-0 C-m-1 C-m-1 
job-3419,6,8,7,170529,209702,209870,39173,168,170972,false,C-l-0 C-l-0 C-l-1 L-m-0 C-l-1 L-l-0 C-m-2 
job-3420,5,8,1,170580,209870,209882,39290,12,170760,false,L-m-0 
job-3421,4,9,2,170631,209870,209903,39239,33,170906,false,L-l-0 L-l-0 
job-3422,3,9,8,170689,209870,209966,39181,96,170870,false,L-s-0 C-l-1 C-l-1 L-m-0 C-l-1 L-l-0 C-s-1 C-l-1 
job-3423,1,9,1,170727,209966,209999,39239,33,170935,false,L-s-0 
job-3424,6,4,6,170779,209966,210020,39187,54,171070,false,L-m-0 C-l-1 L-l-0 C-m-0 C-l-1 L-l-0 
job-3425,6,10,1,170832,209966,210140,39134,174,171267,false,C-m-1 
job-3426,5,12,4,170879,210140,210150,39261,10,171187,false,L-m-0 L-l-0 L-l-0 C-m-0 
job-3427,5,7,8,170927,210140,210188,39213,48,171141,false,C-m-2 C-l-1 C-l-2 C-l-0 C-l-1 C-l-2 C-l-0 C-m-1 
job-3429,1,12,3,171038,210188,210258,39150,70,171156,false,L-l-0 L-l-0 L-m-0 
job-3430,2,4,6,171079,210258,210344,39179,86,171245,false,L-l-0 L-l-0 L-l-0 L-m-0 L-l-0 L-m-0 
job-3428,1,5,4,170979,210188,210354,39209,166,171304,false,L-m-0 L-m-0 L-m-0 L-m-0 
job-3431,1,5,2,171120,210354,210371,39234,17,171220,false,L-s-0 L-s-0 
job-3432,1,10,6,171178,210354,210664,39176,310,171532,false,L-m-0 L-l-0 L-l-0 L-m-0 L-l-0 L-l-0 
job-3434,3,12,6,171278,210664,210678,39386,14,171498,false,L-s-0 L-l-0 L-l-0 C-s-1 L-l-0 L-l-0 
job-3433,3,9,2,171232,210664,210712,39432,48,171350,false,L-m-0 L-m-0 
job-3436,3,12,8,171365,210664,210735,39299,71,171538,false,C-l-0 C-l-1 C-l-0 C-l-1 C-l-1 C-l-0 C-l-0 C-l-1 
job-3435,1,5,5,171326,210664,210739,39338,75,171580,false,C-s-0 L-m-0 L-m-0 C-s-0 C-s-0 
job-3437,2,8,8,171411,210735,210749,39324,14,171546,false,L-l-0 L-l-0 L-l-0 L-l-0 L-l-0 L-m-0 L-l-0 L-m-0 
job-3439,3,12,8,171504,210735,210818,39231,83,171844,false,C-l-0 C-l-2 C-l-2 C-l-0 C-l-2 C-l-0 C-l-2 C-l-0 
job-3440,4,12,6,171546,210818,210879,39272,61,171890,false,L-m-0 L-m-0 L-l-0 C-s-2 L-l-0 L-l-0 
job-3438,4,9,5,171467,210735,210905,39268,170,171687,false,L-s-0 C-l-1 C-l-1 C-s-1 C-l-1 
job-3441,1,8,5,171596,210905,210919,39309,14,171613,false,L-l-0 L-l-0 L-l-0 L-l-0 L-l-0 
job-3442,1,4,4,171647,210905,210921,39258,16,171667,false,L-s-0 L-s-0 L-l-0 L-l-0 
job-3444,6,4,8,171745,210905,210978,39160,73,171998,false,C-l-0 C-l-2 C-l-1 C-l-1 C-l-0 C-m-1 C-l-2 C-m-0 
job-3443,1,7,4,171697,210905,211068,39208,163,172124,false,L-s-0 L-m-0 L-m-0 L-m-0 
job-3445,1,6,8,171804,210905,211134,39101,229,172316,false,C-m-2 C-m-2 C-m-2 C-m-0 C-m-0 L-m-0 C-m-1 C-m-1 
job-3446,5,4,6,171854,211134,211170,39280,36,172095,false,L-m-0 C-l-0 C-l-0 C-m-0 L-l-0 L-l-0 
job-3447,2,5,7,171901,211170,211194,39269,24,172163,false,L-l-0 L-l-0 L-s-0 L-l-0 L-l-0 L-s-0 L-l-0 
job-3448,6,12,4,171953,211170,211226,39217,56,172170,false,L-m-0 C-l-1 C-l-1 C-m-0 
job-3449,5,10,5,172003,211170,211378,39167,208,172383,false,C-m-1 C-l-2 C-l-0 C-l-0 C-l-2 
job-3450,3,10,4,172052,211378,211400,39326,22,172363,false,L-l-0 L-l-0 L-l-0 L-l-0 
job-3452,4,5,7,172161,211378,211455,39217,77,172279,false,L-m-0 C-l-1 L-m-0 C-m-0 C-l-1 C-l-1 C-m-0 
job-3451,4,10,1,172109,211378,211523,39269,145,172300,false,L-s-0 
job-3453,4,6,7,172206,211378,211529,39172,151,172473,false,C-m-1 C-m-2 C-l-0 C-m-2 C-l-0 C-l-0 C-m-1 
job-3454,1,8,6,172258,211378,211541,39120,163,172510,false,C-l-2 C-l-2 C-l-2 C-l-2 C-l-2 C-l-2 
job-3455,3,7,7,172304,211523,211556,39219,33,172471,false,L-s-0 L-l-0 L-l-0 L-m-0 L-l-0 L-m-0 L-l-0 
job-3456,3,5,3,172359,211523,211870,39164,347,172729,false,C-l-1 C-l-1 C-l-1 
job-3457,1,7,6,172407,211870,211967,39463,97,172765,false,L-l-0 L-l-0 L-l-0 L-l-0 L-l-0 L-l-0 
job-3458,4,5,7,172465,211870,212076,39405,206,172751,false,L-m-0 C-l-0 C-l-0 L-m-0 C-l-0 L-l-0 L-s-0 
job-3459,2,7,6,172508,212076,212087,39568,11,172815,false,L-l-0 L-l-0 L-l-0 L-l-0 L-l-0 L-l-0 
job-3460,5,7,8,172567,212076,212137,39509,61,172778,false,C-m-0 C-l-0 C-l-0 C-l-1 C-l-1 C-l-2 C-l-2 L-m-0 
job-3461,1,6,6,172613,212137,212450,39524,313,172932,false,L-l-0 L-l-0 L-l-0 L-l-0 L-l-0 L-l-0 
job-3463,6,12,6,172709,212450,212462,39741,12,172725,false,L-m-0 C-l-1 L-l-0 C-m-0 C-l-1 L-l-0 
job-3464,6,5,6,172750,212450,212467,39700,17,172814,false,C-m-2 C-l-2 C-l-0 C-m-1 C-l-2 C-l-0 
job-3462,1,6,2,172652,212450,212508,39798,58,172946,false,L-s-0 L-s-0 
job-3465,5,10,3,172796,212462,212573,39666,111,173116,false,L-l-0 L-m-0 L-l-0 
job-3466,6,8,6,172848,212467,212845,39619,378,173315,false,C-l-0 C-l-2 C-l-0 C-l-2 C-l-1 C-l-1 
job-3467,1,10,2,172908,212845,212858,39937,13,172969,false,L-m-0 L-m-0 
job-3468,2,11,8,172951,212845,213040,39894,195,173392,false,C-s-2 L-l-0 L-s-0 L-l-0 L-l-0 L-l-0 C-s-1 L-m-0 
job-3469,3,6,5,173001,213040,213087,40039,47,173106,false,L-s-0 L-l-0 L-l-0 L-l-0 L-l-0 
job-3470,1,4,1,173052,213087,213172,40035,85,173150,false,L-s-0 
job-3472,3,5,7,173155,213087,213199,39932,112,173524,false,C-m-1 L-s-0 C-l-1 C-m-1 C-l-1 C-l-1 C-l-1 
job-3471,4,10,7,173104,213087,213308,39983,221,173559,false,L-m-0 L-l-0 L-l-0 C-m-0 L-m-0 L-l-0 C-m-0 
job-3473,5,10,2,173209,213308,213323,40099,15,173310,false,L-l-0 L-l-0 
job-3474,1,8,5,173262,213308,213349,40046,41,173308,false,L-m-0 L-m-0 L-l-0 L-m-0 L-l-0 
job-3475,4,6,8,173299,213308,213512,40009,204,173532,false,C-l-0 C-l-1 C-l-0 C-l-1 C-l-1 C-l-0 L-s-0 L-m-0 
job-3476,3,11,6,173368,213512,213552,40144,40,173694,false,L-m-0 L-l-0 L-l-0 L-l-0 L-m-0 L-l-0 
job-3478,6,12,7,173479,213552,213567,40073,15,173695,false,C-m-1 L-l-0 C-l-2 C-m-0 C-l-2 L-l-0 L-m-0 
job-3477,5,8,4,173426,213512,213572,40086,60,173490,false,C-l-0 C-l-0 C-l-1 C-l-1 
job-3479,3,5,4,173533,213552,213759,40019,207,173947,false,L-s-0 C-m-2 C-s-1 C-m-2 
job-3480,4,8,5,173577,213759,213805,40182,46,173679,false,L-m-0 L-l-0 L-l-0 L-l-0 L-m-0 
job-3481,3,10,2,173629,213759,214065,40130,306,174145,false,L-s-0 C-s-2 
job-3483,6,4,7,173719,214065,214087,40346,22,173819,false,L-l-0 C-l-1 C-l-1 C-m-0 C-l-0 L-l-0 C-l-0 
job-3485,5,9,7,173831,214087,214099,40256,12,174023,false,L-l-0 C-l-0 C-l-1 C-m-0 C-l-1 L-l-0 C-l-0 
job-3484,6,12,4,173778,214065,214103,40287,38,173949,false,C-m-2 C-l-2 C-l-2 C-m-1 
job-3482,6,12,1,173675,214065,214125,40390,60,173971,false,L-m-0 
job-3486,6,10,8,173875,214103,214191,40228,88,174005,false,L-l-0 C-l-0 C-l-0 C-l-2 C-l-1 C-l-1 C-l-2 L-l-0 
job-3487,6,12,8,173923,214191,214209,40268,18,174235,false,L-l-0 C-l-0 C-l-0 C-l-1 C-l-1 L-l-0 C-m-0 L-m-0 
job-3488,4,5,6,173968,214191,214403,40223,212,174396,false,L-s-0 C-l-2 C-l-2 C-m-1 C-l-2 C-m-1 
job-3489,5,11,6,174025,214403,214426,40378,23,174071,false,L-m-0 L-l-0 C-l-0 C-m-0 C-l-0 L-l-0 
job-3490,1,8,5,174076,214426,214471,40350,45,174373,false,L-l-0 L-l-0 L-l-0 L-l-0 L-l-0 
job-3492,5,4,4,174180,214426,214566,40246,140,174343,false,C-l-1 C-l-0 C-l-0 C-l-1 
job-3491,6,8,3,174125,214426,214747,40301,321,174675,false,L-l-0 L-m-0 C-m-0 
job-3493,3,4,1,174236,214747,214761,40511,14,174352,false,L-s-0 
job-3494,1,9,2,174293,214747,214785,40454,38,174359,false,L-s-0 L-m-0 
job-3495,4,12,8,174345,214747,214833,40402,86,174492,false,L-m-0 C-l-0 L-l-0 C-l-0 C-l-0 L-l-0 C-s-1 L-l-0 
job-3496,5,10,6,174393,214747,214852,40354,105,174560,false,C-m-1 C-l-1 C-l-2 C-m-0 C-l-1 C-l-2 
job-3497,6,8,8,174437,214852,214874,40415,22,174754,false,L-l-0 C-l-0 C-l-0 C-l-1 C-l-1 L-l-0 C-m-0 L-m-0 
job-3498,5,9,1,174488,214852,214876,40364,24,174679,false,C-m-1 
job-3499,4,6,7,174526,214852,214960,40326,108,174806,false,L-s-0 C-l-2 C-l-2 C-m-2 C-l-2 C-s-1 C-m-2 
job-3500,6,7,1,174577,214874,215191,40297,317,175103,false,L-m-0 
job-3502,2,10,1,174683,215191,215206,40508,15,174964,false,L-s-0 
job-3501,6,8,2,174624,215191,215209,40567,18,174847,false,L-l-0 L-l-0 
job-3503,1,10,8,174741,215191,215467,40450,276,175251,false,C-s-1 C-l-0 C-l-0 C-l-0 C-l-0 L-m-0 L-m-0 L-m-0 
job-3504,4,6,4,174782,215467,215602,40685,135,174986,false,L-l-0 L-l-0 L-s-0 L-l-0 
job-3505,1,6,6,174823,215602,215613,40779,11,175113,false,L-l-0 L-l-0 L-l-0 L-l-0 L-l-0 L-l-0 
job-3506,6,8,5,174870,215602,215978,40732,376,175487,false,C-m-0 C-l-0 L-l-0 L-m-0 C-l-0 
job-3507,2,5,1,174913,215978,216088,41065,110,175171,false,L-s-0 
job-3509,5,4,5,175001,215978,216102,40977,124,175256,false,L-m-0 C-l-0 C-l-1 C-l-1 C-l-0 
job-3510,5,5,1,175067,216088,216122,41021,34,175333,false,C-m-0 
job-3508,3,10,3,174959,215978,216135,41019,157,175255,false,L-l-0 L-l-0 L-l-0 
job-3512,4,8,5,175175,216102,216257,40927,155,175383,false,L-s-0 C-l-2 C-l-2 C-s-1 C-l-2 
job-3511,6,5,5,175120,216102,216319,40982,217,175515,false,C-l-1 C-l-0 C-l-1 L-m-0 C-l-0 
job-3514,4,11,2,175281,216319,216358,41038,39,175549,false,L-l-0 L-m-0 
job-3513,2,5,2,175223,216257,216363,41034,106,175548,false,L-s-0 L-m-0 
job-3515,6,12,7,175341,216319,216432,40978,113,175468,false,L-l-0 C-l-2 C-l-0 C-l-2 C-l-1 C-l-1 C-l-0 
job-3517,1,6,5,175464,216432,216469,40968,37,175539,false,L-l-0 L-m-0 L-m-0 L-l-0 L-l-0 
job-3516,6,7,1,175395,216432,216496,41037,64,175598,false,L-m-0 
job-3519,1,4,7,175560,216469,216557,40909,88,175693,false,L-s-0 L-l-0 L-l-0 L-s-0 L-l-0 L-l-0 L-l-0 
job-3518,1,7,3,175513,216469,216583,40956,114,175914,false,L-s-0 L-m-0 L-m-0 
job-3520,1,7,4,175619,216557,216689,40938,132,175786,false,L-s-0 L-m-0 L-l-0 L-m-0 
job-3521,1,10,1,175668,216689,216714,41021,25,175928,false,L-s-0 
job-3522,4,5,2,175715,216689,216799,40974,110,175892,false,L-m-0 L-m-0 
job-3523,3,11,6,175768,216689,216820,40921,131,175927,false,C-m-2 L-l-0 L-l-0 C-m-2 L-l-0 L-l-0 
job-3524,4,11,5,175824,216799,216827,40975,28,175935,false,L-s-0 C-m-0 L-m-0 C-m-0 L-m-0 
job-3525,6,12,4,175878,216799,217093,40921,294,176428,false,C-l-0 C-l-1 C-l-1 C-l-0 
job-3527,4,4,3,175970,217093,217140,41123,47,176140,false,L-l-0 L-l-0 L-l-0 
job-3526,1,6,2,175937,217093,217164,41156,71,176114,false,L-s-0 L-s-0 
job-3528,5,4,6,176015,217093,217282,41078,189,176235,false,L-m-0 C-l-0 C-l-1 C-m-0 C-l-0 C-l-1 
job-3529,5,5,3,176049,217282,217292,41233,10,176078,false,L-l-0 L-l-0 L-m-0 
job-3530,5,5,4,176103,217282,217405,41179,123,176258,false,C-l-1 C-l-0 C-l-0 C-l-1 
job-3532,2,8,8,176202,217405,217444,41203,39,176444,false,L-s-0 C-l-0 C-l-0 C-l-0 C-l-0 C-l-0 C-l-0 L-m-0 
job-3531,3,11,6,176149,217405,217476,41256,71,176395,false,L-m-0 L-l-0 L-l-0 L-l-0 L-m-0 L-l-0 
job-3533,6,10,6,176254,217405,217550,41151,145,176694,false,C-m-1 C-l-2 C-l-2 C-m-0 C-l-1 C-l-1 
job-3534,5,12,8,176315,217550,217733,41235,183,176703,false,C-m-0 C-l-0 C-l-0 C-l-1 C-l-1 L-l-0 L-m-0 L-l-0 
job-3535,2,4,2,176355,217733,217821,41378,88,176571,false,L-s-0 L-s-0 
job-3537,5,4,4,176438,217821,217863,41383,42,176599,false,C-m-1 C-l-2 C-l-2 C-m-0 
job-3536,6,8,7,176393,217733,217885,41340,152,176820,false,L-l-0 C-l-1 C-l-0 C-l-0 C-l-1 L-l-0 L-m-0 
job-3538,5,10,3,176482,217863,217969,41381,106,176787,false,C-l-2 C-l-2 C-m-0 
job-3539,4,8,5,176535,217969,217992,41434,23,176613,false,L-m-0 L-l-0 L-l-0 L-l-0 L-m-0 
job-3541,6,12,3,176635,217969,218242,41334,273,177084,false,C-l-2 C-m-0 C-l-2 
job-3540,1,11,5,176590,217969,218300,41379,331,176955,false,C-l-0 C-l-0 C-l-0 L-s-0 C-l-0 
job-3542,1,4,8,176682,218300,218323,41618,23,176826,false,L-m-0 L-m-0 L-m-0 L-m-0 L-m-0 L-m-0 L-m-0 L-m-0 
job-3545,6,8,8,176838,218300,218352,41462,52,176961,false,C-m-0 C-l-2 C-l-0 C-l-0 C-l-1 L-l-0 C-l-2 C-l-1 
job-3544,1,6,3,176791,218300,218411,41509,111,177123,false,L-l-0 L-l-0 L-l-0 
job-3546,4,9,3,176890,218300,218437,41410,137,177204,false,C-m-1 C-m-1 C-s-1 
job-3543,2,11,1,176737,218300,218593,41563,293,177186,false,L-s-0 
job-3548,6,12,7,176990,218593,218609,41603,16,177078,false,C-l-0 C-l-0 C-l-1 L-m-0 C-l-1 L-l-0 L-l-0 
job-3547,4,4,1,176931,218593,218625,41662,32,177166,false,L-s-0 
job-3549,1,11,8,177029,218593,218896,41564,303,177344,false,L-m-0 C-l-2 C-l-2 C-l-2 C-l-2 C-s-1 C-m-1 C-m-1 
job-3551,3,6,8,177130,218896,218948,41766,52,177297,false,L-s-0 C-l-0 C-l-0 C-l-0 C-l-0 L-m-0 C-s-1 L-m-0 
job-3552,1,11,7,177187,218896,218980,41709,84,177296,false,C-m-0 C-l-1 C-l-1 C-m-0 C-l-1 C-l-1 L-m-0 
job-3553,6,11,2,177241,218948,218999,41707,51,177354,false,C-m-1 L-m-0 
job-3555,6,8,3,177347,218948,219042,41601,94,177682,false,C-l-0 C-l-0 C-m-0 
job-3550,3,12,4,177075,218896,219042,41821,146,177282,false,L-l-0 L-l-0 L-l-0 L-l-0 
job-3554,3,12,1,177295,218948,219083,41653,135,177459,false,L-s-0 
job-3557,1,5,8,177440,219042,219120,41602,78,177603,false,L-m-0 L-m-0 C-s-2 C-s-2 L-m-0 L-m-0 C-s-2 L-m-0 
job-3556,4,8,6,177405,218948,219120,41543,172,177623,false,C-m-2 C-s-1 C-l-2 C-m-2 C-l-2 C-l-2 
job-3560,4,12,8,177597,219120,219142,41523,22,177721,false,C-s-0 C-l-1 C-l-1 C-l-1 C-m-0 C-m-0 C-m-1 C-m-1 
job-3558,4,10,3,177494,219042,219144,41548,102,177746,false,C-l-0 C-l-0 C-l-0 
job-3559,3,7,8,177546,219120,219148,41574,28,177830,false,L-s-0 L-l-0 L-l-0 L-l-0 L-l-0 L-m-0 C-s-2 L-m-0 
job-3561,1,5,6,177655,219120,219329,41465,209,178130,false,C-s-2 C-s-1 L-m-0 L-s-0 C-s-1 L-m-0 
job-3562,4,5,3,177710,219120,219565,41410,445,178386,false,C-l-2 C-l-2 C-l-2 
job-3564,5,11,1,177814,219565,219594,41751,29,177950,false,L-l-0 
job-3563,2,4,4,177769,219565,219636,41796,71,178076,false,L-m-0 L-m-0 L-m-0 L-m-0 
job-3565,2,10,3,177850,219594,219644,41744,50,178148,false,L-l-0 L-l-0 L-l-0 
job-3566,1,11,1,177901,219644,219654,41743,10,178082,false,L-s-0 
job-3567,2,10,7,177949,219644,219674,41695,30,178156,false,L-m-0 L-l-0 L-l-0 L-m-0 L-l-0 L-l-0 L-m-0 
job-3569,4,8,5,178038,219644,219734,41606,90,178269,false,C-m-0 C-l-1 C-l-1 C-m-0 C-l-1 
job-3568,2,7,8,178003,219644,219746,41641,102,178321,false,C-s-1 C-l-2 C-l-2 C-l-2 C-l-2 L-l-0 C-l-2 C-l-2 
job-3570,6,10,8,178103,219734,219947,41631,213,178592,false,C-m-1 C-l-0 L-l-0 C-l-1 C-l-1 C-l-0 L-m-0 C-m-0 
job-3571,5,4,7,178152,219947,220057,41795,110,178421,false,C-l-1 L-l-0 C-l-0 C-l-1 C-l-0 L-l-0 L-m-0 
job-3572,5,9,1,178210,219947,220135,41737,188,178486,false,C-m-0 
job-3573,5,5,2,178250,220135,220161,41885,26,178505,false,L-l-0 L-l-0 
job-3574,6,12,8,178308,220135,220272,41827,137,178494,false,C-l-1 C-l-0 C-l-1 C-l-2 C-l-0 C-l-2 C-m-0 L-m-0 
job-3575,1,10,6,178361,220272,220363,41911,91,178489,false,L-m-0 L-l-0 L-l-0 L-m-0 L-l-0 L-l-0 
job-3576,1,7,4,178418,220272,220500,41854,228,178790,false,L-s-0 L-l-0 L-s-0 L-m-0 
job-3579,3,9,5,178534,220500,220528,41966,28,178618,false,L-m-0 C-m-1 L-m-0 C-s-2 C-m-1 
job-3580,3,5,3,178580,220500,220530,41920,30,178722,false,C-l-0 C-l-0 C-l-0 
job-3577,2,5,5,178450,220500,220569,42050,69,178767,false,L-l-0 L-l-0 L-l-0 L-l-0 L-l-0 
job-3578,1,4,4,178497,220500,220604,42003,104,178732,false,L-s-0 L-s-0 L-l-0 L-l-0 
job-3581,1,12,3,178642,220528,220790,41886,262,179035,false,L-m-0 C-l-0 C-l-0 
job-3582,5,5,4,178694,220790,220888,42096,98,178939,false,L-m-0 L-l-0 L-l-0 C-m-0 
job-3584,4,9,1,178794,220888,221082,42094,194,179117,false,L-m-0 
job-3585,5,7,4,178846,220888,221085,42042,197,179043,false,L-l-0 L-l-0 C-l-0 C-l-0 
job-3586,1,9,7,178903,221082,221168,42179,86,179166,false,L-s-0 L-l-0 C-l-0 L-m-0 C-l-0 L-l-0 L-m-0 
job-3583,1,5,1,178746,220888,221189,42142,301,179270,false,L-s-0 
job-3588,4,10,7,179013,221189,221220,42176,31,179303,false,L-s-0 C-l-0 L-l-0 C-l-0 C-l-0 L-l-0 L-l-0 
job-3587,3,6,8,178959,221082,221233,42123,151,179303,false,C-m-0 C-l-1 C-l-1 C-l-1 L-m-0 L-m-0 C-l-1 C-m-0 
job-3589,5,12,5,179051,221220,221356,42169,136,179443,false,L-l-0 L-l-0 C-l-0 C-m-1 C-l-0 
job-3591,1,11,2,179158,221356,221371,42198,15,179277,false,L-m-0 L-m-0 
job-3592,6,12,8,179200,221356,221380,42156,24,179428,false,C-l-0 L-l-0 C-l-0 C-l-2 L-l-0 C-l-1 C-l-2 C-l-1 
job-3590,2,7,1,179105,221356,221381,42251,25,179271,false,L-s-0 
job-3593,5,9,6,179261,221380,221403,42119,23,179291,false,L-m-0 C-l-0 C-l-0 C-m-0 L-l-0 L-l-0 
job-3596,2,7,6,179418,221403,221428,41985,25,179585,false,C-m-0 C-m-0 C-m-0 L-s-0 C-m-0 L-s-0 
job-3594,1,7,4,179314,221403,221433,42089,30,179481,false,L-m-0 L-m-0 L-m-0 L-m-0 
job-3598,4,5,3,179529,221403,221450,41874,47,179792,false,C-l-0 C-l-0 C-l-0 
job-3599,5,10,4,179589,221403,221478,41814,75,179792,false,C-l-1 C-l-2 C-l-1 C-l-2 
job-3597,3,12,2,179475,221403,221492,41928,89,179787,false,C-m-1 C-m-1 
job-3600,3,9,6,179653,221428,221500,41775,72,179965,false,C-s-0 C-m-0 C-s-2 L-s-0 C-m-0 C-s-1 
job-3595,4,12,3,179364,221403,221511,42039,108,179559,false,L-l-0 L-l-0 L-l-0 
job-3602,6,6,3,179751,221478,221556,41727,78,179852,false,C-l-2 C-l-1 C-l-1 
job-3601,3,11,8,179706,221450,221599,41744,149,180133,false,C-l-0 C-l-0 C-l-0 C-m-2 C-m-2 C-l-0 L-m-0 L-m-0 
job-3603,4,6,7,179797,221556,221605,41759,49,180096,false,L-s-0 C-l-1 C-l-1 L-l-0 C-l-1 L-l-0 L-l-0 
job-3604,5,12,6,179849,221599,221646,41750,47,180100,false,C-m-0 C-l-2 C-l-0 L-m-0 C-l-0 C-l-2 
job-3605,5,4,6,179896,221605,221885,41709,280,180475,false,C-m-2 L-l-0 C-l-1 C-m-1 C-l-1 L-l-0 
job-3607,1,7,7,179991,221885,221916,41894,31,180113,false,C-s-0 L-s-0 L-m-0 L-m-0 L-m-0 C-s-0 L-m-0 
job-3606,4,6,3,179952,221885,221920,41933,35,180218,false,L-l-0 L-l-0 L-l-0 
job-3608,1,4,3,180043,221916,221961,41873,45,180333,false,L-s-0 L-s-0 L-s-0 
job-3609,2,6,2,180084,221916,222050,41832,134,180463,false,L-m-0 L-m-0 
job-3610,4,10,2,180122,222050,222070,41928,20,180294,false,L-m-0 L-m-0 
job-3612,6,10,2,180208,222050,222105,41842,55,180352,false,C-l-0 C-l-0 
job-3611,6,6,3,180166,222050,222125,41884,75,180519,false,L-l-0 L-l-0 C-m-0 
job-3613,6,8,8,180267,222105,222201,41838,96,180504,false,C-l-0 C-l-2 C-l-0 C-l-1 C-l-1 C-m-1 C-l-2 L-m-0 
job-3614,4,4,2,180334,222201,222239,41867,38,180634,false,L-m-0 L-m-0 
job-3615,6,6,7,180382,222201,222328,41819,127,180622,false,C-l-0 C-l-2 C-l-0 C-m-0 C-l-2 L-l-0 L-l-0 
job-3616,3,6,7,180427,222201,222488,41774,287,180922,false,C-l-1 C-l-1 C-l-1 L-s-0 C-l-1 C-m-1 C-m-1 
job-3617,2,5,1,180481,222488,222511,42007,23,180660,false,L-s-0 
job-3618,1,6,2,180526,222488,222623,41962,135,180665,false,L-s-0 L-m-0 
job-3619,4,6,7,180584,222488,222729,41904,241,181012,false,C-l-0 C-l-0 L-m-0 L-l-0 L-l-0 C-l-0 L-l-0 
job-3620,3,12,5,180642,222729,222754,42087,25,180681,false,L-l-0 L-s-0 L-l-0 L-l-0 L-l-0 
job-3621,3,12,3,180690,222729,222791,42039,62,181038,false,C-s-1 L-m-0 L-m-0 
job-3622,4,10,3,180737,222729,222806,41992,77,180932,false,C-l-0 C-l-0 C-l-0 
job-3623,1,9,6,180772,222729,223110,41957,381,181295,false,C-s-2 C-l-1 C-l-1 C-l-1 C-l-1 C-l-1 
job-3626,6,9,5,180919,223110,223164,42191,54,181234,false,L-l-0 C-l-1 L-l-0 C-m-0 C-l-1 
job-3624,4,10,2,180808,223110,223331,42302,221,181237,false,L-m-0 L-m-0 
job-3627,2,7,8,180970,223331,223376,42361,45,181176,false,L-m-0 L-l-0 L-l-0 L-m-0 L-l-0 L-l-0 L-l-0 L-l-0 
job-3625,2,6,1,180875,223110,223389,42235,279,181200,false,L-s-0 
job-3628,2,12,1,181030,223376,223482,42346,106,181163,false,L-m-0 
job-3630,1,9,1,181135,223482,223548,42347,66,181376,false,L-m-0 
job-3629,2,8,1,181083,223482,223656,42399,174,181513,false,L-s-0 
job-3631,6,8,8,181191,223482,223659,42291,177,181422,false,L-l-0 C-l-1 C-l-0 C-l-1 C-l-0 L-l-0 C-m-0 L-m-0 
job-3633,5,4,6,181294,223659,223678,42365,19,181470,false,L-m-0 L-l-0 C-l-0 C-m-0 C-l-0 L-l-0 
job-3632,2,7,1,181244,223659,223682,42415,23,181344,false,L-s-0 
job-3634,3,10,1,181337,223678,223721,42341,43,181465,false,L-m-0 
job-3635,5,7,7,181381,223678,223764,42297,86,181611,false,L-m-0 C-l-1 L-l-0 C-l-1 C-l-0 L-l-0 C-l-0 
job-3636,4,6,1,181430,223764,223782,42334,18,181503,false,L-s-0 
job-3637,1,4,2,181489,223764,223819,42275,55,181608,false,L-m-0 L-m-0 
job-3639,3,5,7,181611,223819,223861,42208,42,181826,false,L-m-0 L-m-0 L-l-0 C-s-1 L-l-0 L-l-0 L-l-0 
job-3638,2,6,1,181557,223819,224005,42262,186,181874,false,L-s-0 
job-3640,5,8,6,181664,223819,224050,42155,231,182047,false,C-l-0 C-l-1 C-l-1 C-l-2 C-l-0 C-l-2 
job-3641,5,6,8,181715,224050,224085,42335,35,181862,false,L-l-0 C-l-0 C-l-1 C-l-1 C-l-0 L-l-0 C-m-0 L-m-0 
job-3642,5,10,6,181758,224085,224162,42327,77,182059,false,L-m-0 L-l-0 C-l-0 C-m-0 C-l-0 L-l-0 
job-3643,4,5,5,181810,224085,224166,42275,81,181915,false,L-s-0 C-l-1 C-l-1 C-s-1 C-l-1 
job-3644,4,5,5,181864,224085,224184,42221,99,182165,false,C-m-1 C-l-2 C-l-2 C-m-1 C-l-2 
job-3645,6,10,1,181917,224085,224383,42168,298,182249,false,C-m-2 
job-3646,3,12,5,181973,224383,224510,42410,127,182153,false,L-l-0 L-s-0 L-l-0 L-l-0 L-l-0 
job-3647,5,7,3,182023,224383,224597,42360,214,182352,false,L-m-0 C-l-0 C-l-0 
job-3648,3,7,3,182076,224597,224629,42521,32,182165,false,L-m-0 L-m-0 L-s-0 
job-3649,6,11,4,182136,224597,224722,42461,125,182523,false,C-l-0 L-l-0 C-l-0 L-l-0 
job-3650,4,11,1,182183,224722,224805,42539,83,182539,false,L-s-0 
job-3651,4,10,8,182233,224722,224818,42489,96,182573,false,L-m-0 C-l-0 L-l-0 C-l-0 C-l-0 L-l-0 L-l-0 L-m-0 
job-3653,5,4,8,182346,224818,224882,42472,64,182436,false,C-m-1 L-l-0 C-l-1 C-l-1 C-l-0 L-l-0 C-l-0 L-m-0 
job-3652,4,5,5,182287,224722,224892,42435,170,182645,false,C-m-0 C-l-2 C-l-2 C-m-0 C-l-2 
job-3654,2,5,6,182389,224818,224935,42429,117,182720,false,L-m-0 C-l-1 L-s-0 C-m-1 C-l-0 L-l-0 
job-3655,3,6,3,182430,224935,225021,42505,86,182643,false,L-l-0 L-l-0 L-l-0 
job-3657,5,6,2,182532,225021,225102,42489,81,182674,false,L-l-0 L-m-0 
job-3656,1,9,2,182475,225021,225138,42546,117,182699,false,L-m-0 L-m-0 
job-3658,4,9,3,182586,225021,225198,42435,177,182847,false,L-s-0 C-s-1 L-l-0 
job-3659,5,12,2,182649,225198,225208,42549,10,182945,false,L-l-0 L-l-0 
job-3660,4,4,7,182693,225198,225280,42505,82,182937,false,L-m-0 C-l-1 C-l-1 L-m-0 C-l-1 C-s-1 L-s-0 
job-3662,6,12,5,182794,225280,225346,42486,66,182900,false,L-m-0 C-l-0 L-l-0 L-l-0 C-l-0 
job-3661,4,9,5,182743,225198,225366,42455,168,183171,false,C-m-0 C-l-2 C-l-2 C-m-0 C-l-2 
job-3664,6,6,5,182891,225346,225395,42455,49,183138,false,L-m-0 L-l-0 C-l-0 L-l-0 C-l-0 
job-3663,5,4,3,182845,225280,225423,42435,143,183091,false,C-l-1 C-l-1 C-m-1 
job-3665,1,6,4,182946,225423,225730,42477,307,183296,false,L-m-0 L-m-0 L-m-0 L-m-0 
job-3666,2,4,8,183001,225730,225746,42729,16,183279,false,L-s-0 L-l-0 L-l-0 L-l-0 L-l-0 L-s-0 L-l-0 L-l-0 
job-3667,3,12,2,183063,225730,225822,42667,92,183271,false,L-m-0 L-m-0 
job-3669,6,10,4,183159,225730,225849,42571,119,183290,false,C-l-0 C-l-0 C-l-1 C-l-1 
job-3668,1,4,3,183117,225730,225873,42613,143,183496,false,C-s-0 L-m-0 L-m-0 
job-3670,3,12,3,183218,225873,225963,42655,90,183499,false,L-m-0 L-m-0 L-s-0 
job-3671,4,9,8,183265,225873,226070,42608,197,183671,false,L-l-0 L-l-0 C-l-0 C-l-0 C-l-0 L-l-0 C-m-0 C-m-0 
job-3672,4,9,4,183317,226070,226100,42753,30,183525,false,L-l-0 L-l-0 L-s-0 L-l-0 
job-3673,4,5,5,183374,226070,226158,42696,88,183703,false,L-m-0 C-l-0 L-m-0 C-l-0 C-l-0 
job-3674,4,4,8,183425,226070,226544,42645,474,183989,false,C-l-1 C-l-1 C-l-2 C-l-2 C-m-0 C-l-1 C-l-2 C-m-0 
job-3676,5,12,4,183542,226544,226576,43002,32,183807,false,C-m-0 C-l-2 C-l-2 C-m-1 
job-3675,6,8,7,183481,226544,226593,43063,49,183821,false,L-m-0 C-l-0 C-l-1 L-l-0 C-l-0 C-l-1 L-l-0 
job-3677,6,6,5,183588,226576,226593,42988,17,183810,false,C-m-0 C-l-2 C-m-2 C-m-1 C-l-2 
job-3678,1,11,7,183631,226593,226709,42962,116,183948,false,C-m-1 C-m-2 C-m-0 C-m-1 C-m-2 L-s-0 C-m-0 
job-3679,1,11,3,183686,226709,226731,43023,22,183778,false,L-l-0 L-l-0 L-l-0 
job-3680,1,8,6,183742,226709,226754,42967,45,184024,false,L-m-0 L-s-0 L-l-0 L-s-0 L-m-0 L-m-0 
job-3681,5,9,8,183799,226709,227012,42910,303,184157,false,C-l-0 C-l-1 C-l-0 C-l-1 C-l-2 C-m-1 C-l-2 C-m-0 
job-3682,3,12,1,183842,227012,227062,43170,50,184128,false,L-s-0 
job-3683,4,5,1,183885,227012,227084,43127,72,184109,false,L-m-0 
job-3684,6,6,6,183947,227012,227248,43065,236,184368,false,L-l-0 C-l-0 C-l-1 L-l-0 C-l-0 C-l-1 
job-3685,2,8,3,183999,227248,227266,43249,18,184282,false,L-m-0 L-m-0 L-m-0 
job-3686,3,7,6,184043,227248,227328,43205,80,184392,false,L-l-0 L-l-0 L-s-0 C-s-1 L-l-0 L-l-0 
job-3687,2,4,4,184106,227328,227365,43222,37,184269,false,L-m-0 L-m-0 L-m-0 L-m-0 
job-3688,2,12,5,184162,227328,227800,43166,472,184666,false,L-s-0 L-l-0 L-l-0 L-l-0 L-l-0 
job-3689,3,12,8,184228,227800,227848,43572,48,184477,false,L-m-0 L-l-0 C-s-1 L-l-0 L-l-0 L-l-0 L-m-0 L-s-0 
job-3692,5,5,4,184363,227848,227871,43485,23,184482,false,C-l-1 C-l-0 C-l-0 C-l-1 
job-3691,5,10,4,184317,227848,227873,43531,25,184563,false,L-m-0 L-l-0 L-l-0 C-m-1 
job-3690,4,8,2,184280,227800,227898,43520,98,184499,false,C-m-0 C-m-0 
job-3696,4,10,7,184568,227873,228005,43305,132,184749,false,L-s-0 C-l-2 C-l-2 C-m-2 C-l-2 C-m-2 L-m-0 
job-3693,2,9,2,184415,227873,228018,43458,145,184582,false,L-m-0 L-m-0 
job-3694,5,8,4,184470,227873,228064,43403,191,184889,false,C-l-0 L-l-0 L-l-0 C-l-0 
job-3695,5,10,1,184520,227873,228084,43353,211,184824,false,C-m-1 
job-3697,2,12,4,184617,228064,228118,43447,54,184906,false,L-l-0 L-l-0 L-l-0 C-m-1 
job-3698,4,5,1,184669,228118,228179,43449,61,184910,false,L-s-0 
job-3699,2,9,2,184717,228118,228213,43401,95,185023,false,L-m-0 L-m-0 
job-3702,6,11,5,184877,228213,228227,43336,14,185027,false,C-m-0 C-l-1 C-l-1 C-l-0 C-l-0 
job-3701,2,4,7,184815,228213,228241,43398,28,185137,false,L-l-0 L-l-0 L-m-0 L-l-0 L-m-0 L-l-0 L-l-0 
job-3700,3,5,1,184763,228213,228245,43450,32,184850,false,L-s-0 
job-3704,1,8,4,184986,228241,228362,43255,121,185286,false,L-l-0 L-l-0 L-l-0 L-m-0 
job-3703,1,6,4,184941,228241,228480,43300,239,185371,false,L-m-0 L-m-0 L-m-0 L-s-0 
job-3705,4,7,5,185024,228480,228490,43456,10,185263,false,L-m-0 L-l-0 L-l-0 L-l-0 L-m-0 
job-3706,4,5,7,185064,228480,228490,43416,10,185276,false,C-l-0 C-l-1 C-l-0 C-l-1 C-l-1 C-l-0 L-s-0 
job-3707,5,4,7,185123,228490,228542,43367,52,185285,false,C-m-1 L-l-0 C-l-2 L-m-0 C-l-2 L-l-0 C-m-0 
job-3708,4,5,8,185170,228490,228621,43320,131,185319,false,L-s-0 C-l-1 C-l-0 C-l-1 C-l-0 C-l-1 C-l-0 C-s-1 
job-3709,4,12,8,185218,228621,228660,43403,39,185500,false,L-m-0 L-m-0 L-l-0 L-l-0 C-m-1 L-s-0 L-l-0 C-m-1 
job-3710,5,9,6,185261,228621,228733,43360,112,185622,false,C-l-2 C-l-0 C-l-0 C-l-2 C-l-1 C-l-1 
job-3711,3,11,7,185314,228733,228745,43419,12,185422,false,L-s-0 L-l-0 L-l-0 L-m-0 L-l-0 L-l-0 L-m-0 
job-3712,3,8,2,185367,228733,228799,43366,66,185712,false,C-m-0 C-m-0 
job-3713,4,7,2,185425,228799,228809,43374,10,185714,false,L-m-0 L-m-0 
job-3714,1,4,4,185470,228799,228815,43329,16,185748,false,L-s-0 L-s-0 L-s-0 L-s-0 
job-3716,4,5,8,185565,228799,228818,43234,19,185768,false,C-l-1 C-l-1 C-l-2 C-l-2 C-l-1 C-m-0 C-l-2 C-m-0 
job-3715,3,9,6,185519,228799,228842,43280,43,185667,false,C-s-2 L-l-0 L-l-0 C-s-0 L-l-0 L-l-0 
job-3717,6,8,6,185618,228818,228854,43200,36,185824,false,C-m-0 C-l-1 C-l-0 L-m-0 C-l-1 C-l-0 
job-3718,2,12,2,185675,228854,229069,43179,215,185935,false,L-m-0 L-m-0 
job-3719,1,8,1,185732,229069,229112,43337,43,186059,false,L-s-0 
job-3720,6,8,1,185778,229069,229124,43291,55,186057,false,L-m-0 
job-3721,3,10,8,185826,229069,229149,43243,80,185946,false,L-l-0 C-l-1 L-l-0 C-l-1 C-l-1 L-l-0 L-l-0 C-l-1 
job-3722,3,4,6,185882,229069,229202,43187,133,186056,false,L-s-0 C-l-2 C-l-2 C-s-1 C-l-2 C-l-2 
job-3723,5,7,3,185928,229202,229224,43274,22,186220,false,L-l-0 L-l-0 L-m-0 
job-3724,4,8,3,185967,229202,229229,43235,27,186287,false,L-s-0 C-m-0 C-m-0 
job-3725,5,11,8,186004,229202,229275,43198,73,186172,false,C-m-2 C-l-1 C-l-0 C-l-1 C-l-0 C-l-2 C-m-1 C-l-2 
job-3726,3,9,7,186043,229224,229425,43181,201,186395,false,L-m-0 L-l-0 L-l-0 C-m-2 L-l-0 L-l-0 C-m-1 
job-3727,6,8,3,186087,229275,229624,43188,349,186595,false,C-m-0 C-l-0 C-l-0 
job-3729,1,9,7,186211,229624,229637,43413,13,186486,false,L-l-0 L-s-0 L-l-0 L-l-0 L-l-0 L-l-0 L-m-0 
job-3728,1,5,1,186151,229624,229654,43473,30,186191,false,L-s-0 
job-3730,6,4,4,186261,229624,229678,43363,54,186533,false,C-m-0 C-l-2 C-l-2 L-m-0 
job-3731,3,5,7,186302,229624,229730,43322,106,186584,false,C-l-0 C-l-0 C-l-1 C-l-1 C-l-1 C-l-0 C-l-0 
job-3732,1,8,2,186349,229730,229763,43381,33,186664,false,L-s-0 L-s-0 
job-3733,2,11,6,186391,229730,230056,43339,326,186975,false,L-m-0 L-l-0 L-l-0 L-m-0 L-l-0 L-l-0 
job-3734,2,5,8,186448,230056,230120,43608,64,186676,false,L-l-0 L-s-0 L-l-0 L-l-0 L-l-0 L-s-0 L-l-0 L-l-0 
job-3735,5,10,2,186500,230056,230235,43556,179,186959,false,L-m-0 C-m-0 
job-3737,5,10,6,186592,230235,230263,43643,28,186723,false,C-l-2 C-l-0 C-l-1 C-l-2 C-l-1 C-l-0 
job-3736,5,11,3,186544,230235,230281,43691,46,186868,false,L-l-0 L-l-0 L-m-0 
job-3739,4,4,8,186684,230263,230417,43579,154,186932,false,C-s-2 C-l-1 C-l-2 C-l-2 C-l-1 C-l-2 C-s-1 C-l-1 
job-3738,4,5,7,186640,230235,230495,43595,260,187113,false,L-s-0 C-m-2 C-m-0 C-m-0 C-m-2 C-m-1 C-m-1 
job-3740,3,7,2,186722,230495,230532,43773,37,186941,false,L-m-0 L-m-0 
job-3742,2,12,8,186841,230495,230542,43654,47,186958,false,C-l-0 L-m-0 C-l-1 C-l-0 C-l-1 C-l-0 C-l-1 C-l-1 
job-3743,4,12,7,186887,230532,230559,43645,27,187131,false,L-m-0 C-l-2 C-l-2 C-m-0 C-l-2 C-m-0 C-l-0 
job-3744,6,7,6,186939,230559,230575,43620,16,187174,false,L-m-0 C-l-0 C-l-0 C-m-0 C-l-1 C-l-1 
job-3745,6,5,6,186990,230575,230612,43585,37,187208,false,L-m-0 C-l-2 C-l-0 C-m-0 C-l-0 C-l-2 
job-3741,3,9,5,186776,230495,230621,43719,126,186977,false,L-s-0 L-l-0 L-l-0 L-l-0 L-l-0 
job-3746,5,11,5,187041,230612,230685,43571,73,187169,false,L-m-0 C-l-1 C-l-0 C-l-0 C-l-1 
job-3748,4,11,7,187151,230685,230700,43534,15,187403,false,C-s-0 L-m-0 L-l-0 L-l-0 L-m-0 L-l-0 C-s-1 
job-3747,2,7,2,187091,230685,230707,43594,22,187171,false,L-s-0 L-s-0 
job-3749,4,5,2,187201,230685,230710,43484,25,187464,false,C-m-0 C-m-0 
job-3750,4,10,7,187234,230685,230954,43451,269,187760,false,C-l-0 C-l-2 C-l-2 C-l-2 C-s-2 C-l-0 C-l-0 
job-3751,1,6,7,187277,230954,230985,43677,31,187556,false,L-l-0 L-l-0 L-l-0 L-l-0 L-l-0 L-l-0 L-l-0 
job-3752,4,9,7,187323,230954,231176,43631,222,187591,false,L-m-0 C-l-1 C-l-1 L-m-0 C-l-1 C-s-1 L-s-0 
job-3753,4,10,4,187385,231176,231260,43791,84,187475,false,L-l-0 L-l-0 L-s-0 L-l-0 
job-3754,3,5,6,187428,231176,231318,43748,142,187857,false,L-m-0 C-l-0 C-l-0 L-m-0 C-l-0 C-l-0 
job-3756,6,10,1,187539,231318,231347,43779,29,187620,false,L-l-0 
job-3755,1,6,4,187484,231318,231355,43834,37,187579,false,L-m-0 L-m-0 L-m-0 L-m-0 
job-3758,4,9,2,187646,231318,231375,43672,57,187739,false,C-m-0 C-m-0 
job-3757,4,9,3,187604,231318,231396,43714,78,187925,false,L-s-0 C-s-1 L-l-0 
job-3759,1,7,1,187681,231396,231436,43715,40,187864,false,L-s-0 
job-3760,6,12,1,187745,231396,231491,43651,95,188014,false,L-m-0 
job-3761,5,7,2,187795,231396,231503,43601,107,188073,false,L-l-0 L-l-0 
job-3762,2,7,7,187838,231396,231643,43558,247,188103,false,L-s-0 C-s-2 C-s-2 C-s-1 C-s-1 L-m-0 L-l-0 
job-3763,3,7,4,187888,231643,231663,43755,20,188128,false,L-l-0 L-l-0 L-l-0 L-l-0 
job-3764,6,12,3,187934,231643,231675,43709,32,188204,false,L-m-0 C-l-0 C-l-0 
job-3766,6,4,6,188033,231675,231819,43642,144,188328,false,L-m-0 C-m-2 L-l-0 C-l-0 C-l-0 L-l-0 
job-3765,6,4,5,187978,231643,231891,43665,248,188383,false,C-l-2 C-l-1 C-l-2 C-m-0 C-l-1 
job-3769,4,4,8,188185,231891,231921,43706,30,188251,false,C-l-2 C-l-0 C-l-0 C-l-2 C-l-0 C-m-0 C-l-2 C-m-0 
job-3768,4,5,4,188128,231891,231937,43763,46,188318,false,C-l-1 C-l-1 C-l-1 C-s-1 
job-3770,5,9,1,188251,231891,231953,43640,62,188444,false,C-m-1 
job-3767,3,10,7,188082,231819,231968,43737,149,188475,false,L-s-0 L-l-0 L-l-0 L-m-0 L-l-0 L-l-0 L-m-0 
job-3771,2,4,2,188303,231953,231974,43650,21,188362,false,C-s-1 L-m-0 
job-3772,3,8,5,188353,231953,231988,43600,35,188524,false,C-s-2 C-l-0 C-l-0 C-l-0 C-l-0 
job-3774,5,10,2,188439,231953,232010,43514,57,188735,false,C-l-1 C-l-1 
job-3773,5,12,1,188400,231953,232062,43553,109,188623,false,C-m-0 
job-3775,1,5,3,188498,232062,232158,43564,96,188814,false,L-s-0 L-s-0 L-s-0 
job-3776,2,10,4,188548,232158,232175,43610,17,188675,false,L-l-0 L-l-0 L-l-0 L-l-0 
job-3777,2,9,5,188603,232158,232502,43555,344,189200,false,L-m-0 L-m-0 L-s-0 L-m-0 C-s-0 
job-3780,5,11,3,188746,232502,232541,43756,39,188942,false,C-m-0 C-l-0 C-l-0 
job-3779,2,12,5,188698,232502,232584,43804,82,188993,false,L-s-0 L-m-0 L-m-0 C-m-2 C-m-2 
job-3781,1,6,7,188806,232541,232625,43735,84,189122,false,C-m-0 C-m-2 C-m-0 C-m-0 C-m-0 L-m-0 C-m-0 
job-3778,4,7,3,188654,232502,232639,43848,137,189005,false,L-l-0 L-l-0 L-l-0 
job-3782,1,7,6,188866,232541,232643,43675,102,189007,false,C-l-0 C-l-0 C-l-0 C-l-0 C-l-0 C-l-0 
job-3783,2,10,8,188916,232541,232684,43625,143,189338,false,C-s-1 C-l-1 C-l-1 C-l-1 C-m-1 C-l-1 C-m-1 C-m-1 
job-3784,5,9,3,188963,232625,232687,43662,62,189144,false,C-l-2 L-m-0 C-l-2 
job-3785,1,10,6,189018,232625,232755,43607,130,189186,false,L-m-0 C-l-2 L-s-0 L-m-0 C-l-2 C-s-2 
job-3786,3,5,5,189061,232755,232804,43694,49,189214,false,L-s-0 L-l-0 L-l-0 L-l-0 L-l-0 
job-3787,6,10,7,189098,232755,232814,43657,59,189198,false,L-m-0 C-l-2 C-l-0 C-l-1 C-l-0 C-l-1 C-l-2 
job-3788,4,4,6,189142,232804,232830,43662,26,189254,false,L-s-0 L-l-0 C-m-0 C-m-0 L-l-0 L-l-0 
job-3789,6,11,7,189199,232814,233020,43615,206,189590,false,L-m-0 C-l-0 C-l-1 C-l-2 C-l-0 C-l-1 C-l-2 
job-3792,4,5,3,189363,233020,233084,43657,64,189636,false,C-l-0 C-l-0 C-l-0 
job-3790,2,8,5,189258,233020,233113,43762,93,189398,false,L-l-0 L-l-0 L-l-0 L-l-0 L-l-0 
job-3793,3,12,6,189403,233020,233131,43617,111,189797,false,C-m-0 C-l-2 C-l-2 C-m-0 C-l-2 C-l-2 
job-3791,4,10,4,189310,233020,233174,43710,154,189509,false,L-m-0 C-s-1 L-s-0 L-m-0 
job-3794,5,10,5,189449,233084,233208,43635,124,189833,false,C-m-1 C-l-1 C-l-0 C-l-0 C-l-1 
job-3795,5,10,6,189486,233131,233257,43645,126,189854,false,C-m-2 L-l-0 L-l-0 C-m-0 C-l-2 C-l-2 
job-3796,4,5,7,189535,233208,233437,43673,229,189966,false,L-m-0 C-l-1 C-l-1 L-m-0 C-l-1 C-s-1 L-s-0 
job-3797,5,10,3,189589,233437,233486,43848,49,189821,false,L-l-0 L-l-0 L-m-0 
job-3801,5,4,6,189796,233486,233532,43690,46,189965,false,C-l-0 C-l-2 C-l-0 C-l-1 C-l-2 C-l-1 
job-3800,5,5,1,189743,233486,233557,43743,71,189814,false,L-m-0 
job-3799,2,8,6,189689,233486,233572,43797,86,189977,false,L-l-0 L-l-0 L-l-0 L-l-0 L-l-0 L-l-0 
job-3798,2,8,2,189645,233486,233588,43841,102,189823,false,L-s-0 L-s-0 
job-3802,3,12,6,189844,233486,233602,43642,116,190154,false,C-s-1 C-s-2 C-m-0 C-s-0 C-m-0 L-m-0 
job-3804,6,9,5,189942,233532,233638,43590,106,190313,false,C-l-0 C-l-1 C-l-1 C-m-2 C-l-0 
job-3805,5,7,8,189982,233638,233702,43656,64,190297,false,C-m-0 L-l-0 C-l-0 C-l-1 C-l-1 L-l-0 C-l-0 L-m-0 
job-3803,5,9,1,189899,233486,233734,43587,248,190150,false,C-m-1 
job-3806,3,8,1,190042,233734,233771,43692,37,190228,false,L-s-0 
job-3807,5,10,3,190095,233734,233935,43639,201,190385,false,L-l-0 L-l-0 L-m-0 
job-3808,6,12,1,190148,233734,234050,43586,316,190608,false,C-m-0 
job-3810,1,6,2,190244,234050,234131,43806,81,190596,false,L-l-0 L-m-0 
job-3811,6,4,3,190318,234050,234139,43732,89,190429,false,L-l-0 C-l-0 C-l-0 
job-3809,2,12,3,190197,234050,234144,43853,94,190371,false,L-m-0 L-m-0 L-s-0 
job-3812,3,8,1,190355,234144,234155,43789,11,190490,false,L-s-0 
job-3813,4,10,6,190412,234144,234468,43732,324,190925,false,L-m-0 L-l-0 L-m-0 C-s-1 L-l-0 L-l-0 
job-3814,3,12,3,190468,234468,234479,44000,11,190738,false,L-m-0 L-m-0 L-s-0 
job-3816,2,9,5,190578,234468,234558,43890,90,190946,false,L-l-0 L-l-0 L-l-0 C-s-1 L-l-0 
job-3815,1,11,1,190516,234468,234640,43952,172,190972,false,L-l-0 
job-3817,5,11,1,190633,234468,234701,43835,233,190899,false,C-m-0 
job-3818,1,5,4,190678,234640,235086,43962,446,191367,false,C-m-0 C-m-0 L-s-0 C-m-0 
job-3820,5,9,2,190787,235086,235110,44299,24,191041,false,C-m-0 L-m-0 
job-3819,2,8,5,190738,235086,235199,44348,113,191093,false,L-l-0 L-l-0 L-l-0 L-l-0 L-l-0 
job-3821,6,10,8,190840,235086,235324,44246,238,191327,false,C-l-0 C-l-1 C-l-2 C-l-2 C-l-1 C-l-0 C-m-2 C-m-1 
job-3822,6,10,8,190889,235324,235598,44435,274,191416,false,L-l-0 C-l-0 C-l-0 C-l-1 C-l-1 L-l-0 C-m-0 L-m-0 
job-3823,5,6,1,190940,235598,235620,44658,22,191128,false,L-m-0 
job-3825,6,7,2,191041,235598,235695,44557,97,191375,false,L-l-0 C-m-0 
job-3824,1,7,8,190993,235598,235755,44605,157,191335,false,L-m-0 L-m-0 L-l-0 L-m-0 L-l-0 L-l-0 L-l-0 L-l-0 
job-3829,6,9,6,191225,235755,235772,44530,17,191409,false,C-l-0 C-l-2 C-l-0 C-l-2 C-l-1 C-l-1 
job-3828,3,12,5,191177,235755,235860,44578,105,191369,false,L-m-0 L-l-0 L-l-0 L-m-0 L-l-0 
job-3830,6,11,3,191267,235755,235881,44488,126,191437,false,C-m-1 C-m-2 C-m-0 
job-3831,3,5,8,191321,235881,235893,44560,12,191359,false,L-m-0 L-l-0 L-l-0 L-l-0 L-l-0 L-m-0 C-m-0 C-m-0 
job-3832,4,8,7,191377,235881,235907,44504,26,191449,false,C-l-1 C-l-0 C-l-1 C-s-1 C-l-0 C-l-1 C-l-0 
job-3827,1,4,3,191125,235755,235914,44630,159,191522,false,L-s-0 L-m-0 L-s-0 
job-3826,1,5,1,191085,235755,235946,44670,191,191413,false,L-s-0 
job-3833,3,8,5,191422,235881,235973,44459,92,191651,false,C-l-2 C-l-2 C-l-2 C-s-2 C-l-2 
job-3835,3,11,3,191507,235907,236077,44400,170,191901,false,C-m-2 C-m-2 C-s-0 
job-3834,6,11,8,191458,235907,236084,44449,177,191880,false,C-l-0 L-l-0 C-l-0 C-l-1 C-l-1 C-m-0 L-l-0 L-m-0 
job-3836,1,12,6,191552,236077,236103,44525,26,191670,false,L-m-0 C-m-0 C-l-2 C-l-2 C-l-2 C-l-2 
job-3837,1,4,8,191608,236077,236139,44469,62,191777,false,C-s-1 C-s-1 C-s-1 C-m-0 L-m-0 L-s-0 C-s-1 L-s-0 
job-3839,5,11,1,191706,236077,236195,44371,118,192038,false,C-m-2 
job-3838,1,12,2,191655,236077,236196,44422,119,191813,false,C-m-1 C-m-1 
job-3840,6,5,4,191755,236195,236214,44440,19,191846,false,L-m-0 C-m-1 L-l-0 L-l-0 
job-3842,1,12,3,191855,236214,236347,44359,133,192032,false,L-l-0 L-l-0 L-l-0 
job-3843,3,6,5,191895,236347,236412,44452,65,192038,false,L-l-0 L-m-0 L-m-0 L-l-0 L-l-0 
job-3844,1,8,3,191956,236412,236458,44456,46,192015,false,L-m-0 L-m-0 L-m-0 
job-3841,1,8,2,191805,236214,236544,44409,330,192221,false,L-s-0 L-s-0 
job-3845,4,7,1,192011,236458,236570,44447,112,192123,false,L-m-0 
job-3846,1,5,4,192056,236570,236580,44514,10,192212,false,L-m-0 L-m-0 L-m-0 L-m-0 
job-3847,4,7,2,192111,236570,236696,44459,126,192357,false,L-s-0 L-m-0 
job-3849,1,11,7,192223,236570,236733,44347,163,192464,false,C-l-1 L-l-0 L-l-0 C-s-1 C-l-1 C-l-1 C-l-1 
job-3850,2,10,7,192274,236696,236767,44422,71,192498,false,L-s-0 L-m-0 C-m-0 C-m-0 C-m-0 L-m-0 L-m-0 
job-3848,5,9,2,192164,236570,236958,44406,388,192552,false,L-l-0 L-l-0 
job-3851,6,8,7,192320,236958,236969,44638,11,192480,false,L-m-0 C-l-0 C-l-1 L-l-0 C-l-0 C-l-1 L-l-0 
job-3852,4,8,5,192362,236958,237099,44596,141,192527,false,L-s-0 C-l-2 C-l-2 C-s-1 C-l-2 
job-3853,5,8,8,192412,236969,237159,44557,190,192710,false,L-l-0 C-l-1 C-l-0 C-l-0 C-l-1 L-m-0 C-m-2 L-l-0 
job-3854,2,12,3,192466,237159,237227,44693,68,192632,false,L-m-0 L-m-0 L-s-0 
job-3855,3,9,6,192508,237159,237778,44651,619,193228,false,C-m-0 L-l-0 L-l-0 C-m-0 L-l-0 L-l-0 
job-3856,3,4,4,192548,237778,237810,45230,32,192621,false,L-l-0 L-l-0 L-l-0 L-l-0 
job-3857,5,7,7,192610,237778,237830,45168,52,192688,false,C-l-0 C-l-1 C-l-0 C-l-2 C-l-1 C-l-2 L-m-0 
job-3859,6,11,6,192712,237830,237862,45118,32,192941,false,L-m-0 L-l-0 C-l-1 C-m-0 C-l-1 L-l-0 
job-3861,2,6,5,192810,237830,237882,45020,52,192991,false,C-s-1 C-m-2 C-m-2 C-m-2 C-m-2 
job-3858,3,12,1,192659,237830,237882,45171,52,192927,false,L-s-0 
job-3862,1,11,6,192859,237882,237897,45023,15,193072,false,L-m-0 L-l-0 L-m-0 C-m-0 C-m-0 L-l-0 
job-3860,2,6,8,192763,237830,237898,45067,68,192995,false,C-l-2 C-l-2 C-l-2 C-m-0 L-m-0 C-l-2 C-l-2 C-l-2 
job-3863,6,5,6,192918,237882,238072,44964,190,193141,false,C-l-0 C-l-1 C-l-1 C-m-1 C-l-0 L-l-0 
job-3864,6,6,4,192977,238072,238099,45095,27,193247,false,L-m-0 L-l-0 L-l-0 C-m-0 
job-3865,1,8,3,193027,238099,238164,45072,65,193270,false,L-m-0 L-m-0 L-m-0 
job-3867,3,11,2,193142,238099,238169,44957,70,193307,false,C-m-1 C-m-1 
job-3866,1,11,6,193080,238099,238218,45019,119,193397,false,L-s-0 L-l-0 L-l-0 C-s-1 L-l-0 L-l-0 
job-3868,4,9,3,193183,238099,238394,44916,295,193776,false,C-l-0 C-l-0 C-l-0 
job-3869,6,4,6,193238,238394,238438,45156,44,193551,false,C-m-0 C-l-0 L-l-0 L-m-0 C-l-0 L-l-0 
job-3870,2,9,6,193287,238394,238480,45107,86,193527,false,C-m-0 C-m-1 L-s-0 C-m-1 C-m-1 L-m-0 
job-3872,3,5,6,193395,238480,238497,45085,17,193539,false,L-s-0 L-l-0 L-l-0 C-s-1 L-l-0 L-l-0 
job-3871,6,10,1,193347,238480,238526,45133,46,193617,false,L-m-0 
job-3873,5,7,4,193460,238480,238652,45020,172,193654,false,C-l-0 C-l-0 C-l-1 C-l-1 
job-3874,6,10,6,193520,238652,238690,45132,38,193728,false,C-m-0 C-l-0 L-l-0 L-m-0 C-l-0 L-l-0 
job-3875,3,11,3,193567,238652,238714,45085,62,193785,false,L-s-0 C-m-2 C-m-2 
job-3876,6,9,1,193612,238652,238825,45040,173,193801,false,C-m-1 
job-3877,2,9,3,193661,238690,238830,45029,140,193867,false,L-m-0 C-m-1 C-m-2 
job-3878,1,12,6,193708,238825,238858,45117,33,193852,false,C-m-2 L-l-0 L-m-0 C-m-1 L-l-0 L-l-0 
job-3881,5,12,6,193842,238830,238870,44988,40,193943,false,L-m-0 C-l-1 C-m-0 C-m-2 C-l-1 C-m-1 
job-3879,2,8,8,193745,238825,238872,45080,47,193982,false,L-s-0 L-l-0 L-s-0 C-s-1 C-m-2 C-m-1 C-s-1 L-m-0 
job-3880,2,11,8,193791,238825,238891,45034,66,194129,false,C-l-0 C-l-2 C-l-0 C-l-2 C-l-0 C-l-2 C-l-2 C-l-0 
job-3883,4,7,5,193946,238870,239018,44924,148,194309,false,L-m-0 C-s-0 L-l-0 C-m-2 C-m-1 
job-3882,4,4,4,193899,238830,239019,44931,189,194369,false,C-s-2 L-l-0 C-l-0 C-l-2 
job-3885,4,7,5,194036,239019,239040,44983,21,194334,false,C-s-1 L-l-0 L-l-0 L-s-0 L-l-0 
job-3884,2,10,3,193984,239019,239052,45035,33,194291,false,L-m-0 L-m-0 L-m-0 
job-3886,1,11,1,194081,239019,239096,44938,77,194183,false,C-s-2 
job-3887,6,8,3,194139,239019,239464,44880,445,194723,false,C-m-0 C-l-1 C-l-1 
job-3888,1,4,7,194176,239464,239522,45288,58,194245,false,L-m-0 L-m-0 L-m-0 L-m-0 L-m-0 L-m-0 L-m-0 
job-3889,1,6,8,194221,239464,239673,45243,209,194631,false,L-l-0 L-l-0 L-l-0 L-l-0 L-l-0 L-l-0 L-l-0 L-l-0 
job-3890,1,9,1,194259,239673,239684,45414,11,194540,false,L-s-0 
job-3891,6,5,7,194311,239673,239834,45362,161,194663,false,L-l-0 C-l-1 C-l-0 L-m-0 C-l-0 L-l-0 C-l-1 
job-3892,5,10,8,194362,239834,239877,45472,43,194627,false,L-l-0 C-l-0 C-l-1 C-l-1 C-l-0 L-l-0 C-m-0 L-m-0 
job-3893,6,9,7,194416,239877,239932,45461,55,194634,false,L-m-0 C-l-0 C-l-1 L-l-0 C-l-0 C-l-1 L-l-0 
job-3894,3,12,3,194476,239932,239960,45456,28,194711,false,L-m-0 L-m-0 L-s-0 
job-3896,6,6,7,194569,239932,240147,45363,215,194895,false,C-l-0 C-l-2 C-l-1 C-m-1 C-l-1 C-l-2 C-l-0 
job-3895,3,12,6,194524,239932,240261,45408,329,194884,false,C-m-0 L-l-0 L-l-0 C-m-0 L-l-0 L-l-0 
job-3897,6,12,8,194628,240261,240278,45633,17,194798,false,L-l-0 C-l-0 C-l-0 C-l-1 C-l-1 L-l-0 C-m-0 L-m-0 
job-3898,3,7,5,194676,240261,240316,45585,55,194836,false,L-s-0 C-l-2 C-l-2 C-l-2 C-l-2 
job-3899,4,7,2,194726,240261,240761,45535,500,195294,false,C-m-1 C-m-1 
job-3901,6,8,3,194831,240761,240801,45930,40,195013,false,L-l-0 L-l-0 C-m-0 
job-3900,6,9,1,194782,240761,240910,45979,149,195126,false,L-m-0 
job-3902,3,4,6,194897,240761,240990,45864,229,195303,false,L-s-0 C-l-0 C-l-0 C-s-1 C-l-0 C-l-0 
job-3903,3,8,4,194929,240990,241008,46061,18,195184,false,L-l-0 L-l-0 L-l-0 L-l-0 
job-3904,1,5,2,194977,240990,241052,46013,62,195231,false,L-s-0 L-s-0 
job-3905,1,7,2,195014,240990,241057,45976,67,195105,false,L-m-0 L-m-0 
job-3907,1,4,3,195118,240990,241145,45872,155,195546,false,C-s-1 C-s-1 C-s-1 
job-3908,3,4,6,195173,241145,241183,45972,38,195417,false,C-m-1 L-l-0 L-l-0 C-m-1 L-l-0 L-l-0 
job-3906,2,6,8,195054,240990,241202,45936,212,195433,false,L-m-0 L-m-0 L-s-0 C-m-0 C-m-0 L-m-0 C-m-0 C-m-0 
job-3910,5,11,4,195285,241145,241229,45860,84,195380,false,C-l-0 C-l-1 C-l-1 C-l-0 
job-3909,4,11,2,195226,241145,241361,45919,216,195733,false,C-m-2 C-m-2 
job-3911,6,11,3,195342,241361,241395,46019,34,195455,false,L-l-0 L-l-0 L-m-0 
job-3912,4,7,7,195388,241361,241497,45973,136,195735,false,L-s-0 C-l-2 C-l-1 C-l-2 C-l-1 C-l-2 C-l-1 
job-3914,6,5,5,195512,241497,241529,45985,32,195747,false,C-m-0 C-l-2 C-l-2 C-l-0 C-l-0 
job-3913,3,7,8,195449,241497,241540,46048,43,195751,false,L-m-0 L-s-0 C-s-1 L-l-0 L-l-0 L-l-0 L-l-0 L-m-0 
job-3915,3,8,2,195554,241497,241586,45943,89,195687,false,C-m-1 C-m-1 
job-3916,2,6,4,195610,241529,241586,45919,57,195888,false,L-m-0 C-s-2 C-s-2 C-m-1 
job-3917,4,5,6,195660,241529,241605,45869,76,195897,false,C-l-0 C-l-1 C-l-0 C-l-1 C-l-1 C-l-0 
job-3918,5,12,1,195696,241529,241618,45833,89,196031,false,C-m-0 
job-3919,6,8,2,195750,241529,241648,45779,119,196072,false,C-l-2 C-l-2 
job-3920,6,11,6,195795,241605,241858,45810,253,196127,false,C-m-1 C-l-0 L-l-0 L-m-0 C-l-0 L-l-0 
job-3921,6,6,7,195845,241858,242093,46013,235,196195,false,L-m-0 C-l-0 C-l-1 L-l-0 C-l-0 C-l-1 L-l-0 
job-3923,4,12,2,195961,242093,242115,46132,22,196202,false,L-m-0 L-m-0 
job-3924,4,12,8,196010,242093,242119,46083,26,196236,false,C-s-0 L-l-0 C-l-2 C-l-2 C-l-2 L-l-0 C-s-2 L-l-0 
job-3922,3,8,1,195896,242093,242151,46197,58,196188,false,L-s-0 
job-3925,1,6,1,196065,242151,242230,46086,79,196286,false,L-s-0 
job-3926,2,9,1,196120,242230,242246,46110,16,196398,false,L-s-0 
job-3927,5,5,8,196168,242230,242301,46062,71,196250,false,C-m-0 L-l-0 C-l-0 L-l-0 C-l-1 L-m-0 C-l-0 C-l-1 
job-3928,5,11,5,196232,242301,242401,46069,100,196449,false,L-l-0 L-l-0 C-l-0 L-m-0 C-l-0 
job-3929,4,6,5,196279,242401,242448,46122,47,196416,false,L-m-0 L-l-0 L-l-0 L-l-0 L-m-0 
job-3931,3,9,3,196383,242401,242618,46018,217,196804,false,L-s-0 C-m-0 C-m-0 
job-3932,3,12,8,196440,242618,242684,46178,66,196547,false,C-s-0 L-l-0 C-s-2 L-l-0 L-l-0 L-l-0 L-m-0 L-m-0 
job-3930,1,7,3,196328,242401,242768,46073,367,196882,false,L-s-0 C-s-1 C-s-1 
job-3933,4,12,2,196494,242618,242824,46124,206,196993,false,C-m-0 C-m-0 
job-3934,3,4,2,196555,242768,242864,46213,96,196736,false,L-m-0 L-m-0 
job-3936,3,5,2,196654,242768,243025,46114,257,196983,false,L-s-0 C-s-1 
job-3935,1,11,6,196605,242768,243100,46163,332,197098,false,L-l-0 L-m-0 L-m-0 L-l-0 L-l-0 L-l-0 
job-3937,3,5,4,196698,243100,243119,46402,19,196914,false,L-l-0 L-l-0 L-l-0 L-l-0 
job-3938,2,12,3,196754,243100,243365,46346,265,197082,false,L-s-0 L-m-0 L-m-0 
job-3939,3,7,4,196810,243365,243407,46555,42,197017,false,L-l-0 L-l-0 L-l-0 L-l-0 
job-3940,6,5,2,196873,243365,243568,46492,203,197187,false,C-m-0 L-m-0 
job-3944,2,10,4,197082,243568,243592,46486,24,197342,false,C-l-0 C-l-0 C-l-0 C-l-0 
job-3942,4,4,4,196982,243568,243602,46586,34,197290,false,L-m-0 L-l-0 L-l-0 L-l-0 
job-3945,2,11,5,197131,243592,243604,46461,12,197371,false,C-s-1 C-l-1 C-l-1 C-l-1 C-l-1 
job-3941,1,9,3,196917,243568,243618,46651,50,197244,false,L-m-0 L-m-0 L-m-0 
job-3947,5,11,3,197236,243604,243668,46368,64,197595,false,C-m-2 C-l-1 C-l-1 
job-3943,3,8,1,197039,243568,243695,46529,127,197424,false,L-s-0 
job-3946,6,12,8,197180,243602,243695,46422,93,197470,false,C-m-1 C-l-0 L-l-0 C-l-2 C-l-0 L-l-0 C-l-2 C-m-0 
job-3949,4,7,4,197325,243695,243724,46370,29,197454,false,L-m-0 C-l-1 C-l-1 C-l-1 
job-3948,1,6,6,197282,243668,243727,46386,59,197364,false,L-s-0 C-m-0 C-m-0 C-m-1 C-m-1 L-m-0 
job-3950,1,12,5,197374,243695,243901,46321,206,197586,false,L-m-0 C-m-2 C-s-2 C-m-2 C-s-1 
job-3951,6,11,4,197410,243901,243976,46491,75,197587,false,L-m-0 L-l-0 L-l-0 C-m-0 
job-3952,1,11,7,197455,243901,243992,46446,91,197568,false,L-m-0 C-l-0 C-l-0 L-s-0 C-l-0 C-l-0 C-m-0 
job-3953,2,10,4,197515,243901,244001,46386,100,197726,false,C-l-1 C-l-1 C-l-1 C-l-1 
job-3955,3,4,3,197618,243992,244156,46374,164,197888,false,L-s-0 C-s-2 C-l-1 
job-3954,6,9,7,197567,243976,244159,46409,183,197939,false,L-m-0 L-l-0 C-l-2 C-m-0 C-l-2 L-l-0 C-m-1 
job-3956,2,6,4,197666,244156,244271,46490,115,197976,false,C-m-0 L-m-0 L-s-0 C-m-1 
job-3958,3,8,8,197746,244271,244318,46525,47,197860,false,L-l-0 C-l-0 C-l-0 C-l-0 C-l-0 L-l-0 L-l-0 L-l-0 
job-3959,2,5,7,197790,244271,244326,46481,55,197994,false,C-m-0 L-m-0 L-s-0 C-m-0 C-m-0 L-s-0 C-m-0 
job-3957,3,5,2,197708,244271,244341,46563,70,197886,false,L-m-0 L-m-0 
job-3960,3,7,5,197849,244271,244347,46422,76,198110,false,C-s-1 C-l-2 C-l-2 C-l-2 C-l-2 
job-3961,4,9,1,197899,244271,244392,46372,121,198290,false,C-s-2 
job-3962,6,12,1,197963,244392,244413,46429,21,198224,false,L-m-0 
job-3963,3,7,2,198012,244392,244644,46380,252,198422,false,L-l-0 L-l-0 
job-3964,6,10,2,198071,244644,244655,46573,11,198249,false,L-l-0 L-l-0 
job-3965,2,8,5,198108,244644,244925,46536,281,198535,false,L-m-0 L-s-0 L-s-0 L-m-0 L-m-0 
job-3966,3,7,5,198144,244925,244939,46781,14,198247,false,L-l-0 L-s-0 L-l-0 L-l-0 L-l-0 
job-3968,2,11,5,198267,244925,245030,46658,105,198430,false,C-l-1 C-l-1 L-m-0 C-l-1 C-l-1 
job-3967,3,7,7,198206,244925,245087,46719,162,198443,false,L-m-0 C-l-0 C-l-0 C-s-1 C-l-0 L-m-0 C-l-0 
job-3969,4,5,8,198330,244925,245216,46595,291,198738,false,C-s-2 C-l-2 C-l-2 C-l-2 C-m-0 C-m-1 C-m-1 C-m-0 
job-3970,4,6,4,198369,245087,245236,46718,149,198675,false,L-l-0 L-l-0 L-l-0 L-s-0 
job-3971,4,11,5,198416,245216,245255,46800,39,198550,false,C-s-0 L-m-0 L-m-0 C-m-2 C-m-2 
job-3972,5,9,8,198466,245216,245257,46750,41,198793,false,C-m-0 C-l-1 C-l-0 C-l-0 C-l-1 C-l-2 C-l-2 C-m-1 
job-3973,3,7,4,198516,245216,245485,46700,269,199004,false,C-s-1 C-s-2 C-m-0 C-m-1 
job-3974,1,11,2,198573,245485,245588,46912,103,198743,false,L-m-0 L-m-0 
job-3975,1,4,8,198622,245485,245590,46863,105,198807,false,L-m-0 L-m-0 L-l-0 L-l-0 L-l-0 L-l-0 L-l-0 L-l-0 
job-3976,1,10,3,198667,245590,245636,46923,46,198797,false,L-m-0 L-m-0 L-m-0 
job-3977,4,8,2,198718,245590,245641,46872,51,198980,false,L-l-0 L-l-0 
job-3978,3,6,1,198759,245641,245690,46882,49,199060,false,L-s-0 
job-3979,5,4,8,198810,245641,245691,46831,50,199132,false,L-l-0 C-l-2 C-l-0 C-l-2 C-l-0 L-l-0 C-m-0 L-m-0 
job-3980,6,4,5,198864,245691,245713,46827,22,198950,false,L-m-0 C-l-0 L-l-0 L-l-0 C-l-0 
job-3981,5,12,6,198912,245691,246090,46779,399,199324,false,C-m-1 C-l-1 C-l-1 C-m-0 C-l-2 C-l-2 
job-3983,4,7,5,199014,246090,246122,47076,32,199317,false,C-l-0 L-m-0 C-l-0 L-m-0 C-l-0 
job-3984,2,11,2,199074,246090,246179,47016,89,199322,false,C-m-0 C-m-0 
job-3982,3,11,5,198956,246090,246197,47134,107,199324,false,L-l-0 L-s-0 L-l-0 L-l-0 L-l-0 
job-3985,6,11,2,199121,246179,246200,47058,21,199324,false,L-m-0 C-m-0 
job-3986,4,11,1,199172,246179,246295,47007,116,199510,false,C-s-1 
job-3987,4,9,5,199222,246179,246355,46957,176,199549,false,C-m-1 C-l-1 C-l-1 C-m-1 C-l-1 
job-3989,3,12,5,199326,246355,246365,47029,10,199405,false,L-s-0 L-m-0 L-m-0 C-m-0 C-m-0 
job-3988,2,8,6,199272,246355,246386,47083,31,199548,false,L-l-0 L-l-0 L-l-0 L-l-0 L-l-0 L-l-0 
job-3990,5,10,5,199376,246355,246498,46979,143,199670,false,C-l-0 C-l-1 C-l-0 C-m-1 C-l-1 
job-3991,2,7,4,199413,246498,246538,47085,40,199647,false,L-m-0 L-m-0 L-m-0 L-m-0 
job-3993,2,12,6,199511,246498,246569,46987,71,199606,false,C-m-0 C-l-1 C-l-1 C-m-0 C-l-1 C-l-1 
job-3994,3,12,5,199555,246498,246655,46943,157,199979,false,C-l-0 C-l-0 C-l-0 C-s-1 C-l-0 
job-3992,3,12,5,199453,246498,246779,47045,281,199958,false,L-l-0 L-s-0 L-l-0 L-l-0 L-l-0 
job-3995,1,10,2,199603,246779,246790,47176,11,199697,false,L-m-0 L-m-0 
job-3996,1,6,6,199659,246779,246799,47120,20,199870,false,L-l-0 L-m-0 L-m-0 L-l-0 L-l-0 L-l-0 
job-3997,5,5,7,199713,246779,246860,47066,81,199969,false,C-l-2 C-l-1 C-l-1 C-l-2 C-l-0 L-l-0 C-l-0 
job-3998,2,9,6,199774,246779,246888,47005,109,199965,false,L-s-0 C-l-1 C-l-0 C-s-1 C-l-2 L-l-0 
job-3999,2,7,3,199816,246779,246959,46963,180,200187,false,L-s-0 C-s-1 C-s-2 
job-4000,3,9,6,199867,246959,246979,47092,20,200146,false,L-m-0 L-l-0 L-l-0 L-l-0 L-m-0 L-l-0 
job-4002,4,12,8,199972,246959,247001,46987,42,200207,false,L-s-0 C-l-1 C-l-1 C-s-0 C-l-2 C-l-2 C-l-2 C-l-1 
job-4001,6,6,1,199910,246959,247018,47049,59,200040,false,C-m-0 
job-4003,5,10,7,200027,246979,247102,46952,123,200393,false,C-m-1 L-l-0 C-l-0 L-m-0 C-l-0 L-l-0 C-m-2 
job-4004,1,10,5,200071,247102,247241,47031,139,200237,false,L-s-0 L-l-0 L-l-0 L-l-0 L-l-0 
job-4006,1,4,5,200178,247241,247335,47063,94,200342,false,L-s-0 L-m-0 L-s-0 L-s-0 L-m-0 
job-4005,3,6,2,200133,247241,247336,47108,95,200274,false,L-m-0 L-m-0 
job-4007,5,8,3,200232,247335,247349,47103,14,200514,false,L-l-0 L-l-0 C-m-0 
job-4008,3,6,8,200285,247335,247359,47050,24,200347,false,C-m-1 C-l-0 C-l-0 C-l-0 C-l-0 C-m-0 L-s-0 C-m-1 
job-4009,3,7,3,200332,247335,247391,47003,56,200409,false,C-l-1 C-l-1 C-l-1 
job-4010,6,12,3,200389,247335,247426,46946,91,200579,false,C-m-2 C-l-2 C-l-2 
job-4011,1,9,7,200442,247391,247427,46949,36,200750,false,L-l-0 L-l-0 C-m-2 L-l-0 C-m-2 L-l-0 L-l-0 
job-4012,2,5,5,200488,247391,247455,46903,64,200731,false,L-m-0 L-m-0 L-s-0 L-s-0 L-m-0 
job-4013,4,5,8,200538,247391,247588,46853,197,200775,false,C-l-0 C-l-1 C-l-1 C-l-0 C-l-1 C-m-0 C-l-0 C-m-0 
job-4014,4,12,8,200586,247588,247661,47002,73,200901,false,L-m-0 L-m-0 L-l-0 L-l-0 C-m-1 L-s-0 L-l-0 C-m-1 
job-4016,5,8,4,200690,247661,247672,46971,11,200888,false,C-m-0 C-l-2 C-l-2 C-m-1 
job-4015,5,8,7,200645,247661,247676,47016,15,200727,false,C-l-1 L-l-0 C-l-0 C-l-1 C-l-0 L-l-0 L-m-0 
job-4017,4,9,1,200733,247661,247754,46928,93,200977,false,L-s-0 
job-4018,1,7,4,200787,247676,247760,46889,84,201073,false,L-m-0 L-m-0 L-m-0 L-m-0 
job-4019,3,4,1,200831,247760,247885,46929,125,201175,false,L-s-0 
job-4022,1,7,8,200973,247885,247897,46912,12,201019,false,L-s-0 C-l-0 C-l-0 C-l-0 C-l-0 C-l-0 C-l-0 C-s-2 
job-4020,1,9,8,200873,247885,247904,47012,19,200986,false,L-m-0 L-l-0 L-l-0 L-l-0 L-l-0 L-m-0 L-l-0 L-m-0 
job-4021,1,7,3,200921,247885,247916,46964,31,201044,false,L-s-0 C-s-1 C-s-1 
job-4023,6,5,6,201027,247885,247996,46858,111,201255,false,C-l-2 C-l-2 C-l-1 C-m-0 C-l-0 C-l-1 
job-4025,3,6,3,201120,247996,248042,46876,46,201355,false,L-l-0 L-l-0 L-l-0 
job-4026,3,6,4,201164,247996,248053,46832,57,201265,false,C-s-1 L-m-0 L-l-0 L-m-0 
job-4024,1,7,2,201069,247996,248065,46927,69,201180,false,L-s-0 L-s-0 
job-4027,4,10,6,201210,247996,248383,46786,387,201767,false,C-l-0 C-l-1 C-l-1 C-l-0 C-l-1 C-l-0 
job-4028,3,12,8,201273,248383,248403,47110,20,201486,false,L-m-0 L-l-0 C-s-1 L-l-0 L-l-0 L-l-0 L-m-0 L-s-0 
job-4029,3,11,7,201328,248383,248477,47055,94,201623,false,C-s-0 C-l-0 C-l-0 C-m-0 C-l-0 C-l-0 C-m-0 
job-4030,5,11,7,201372,248403,248490,47031,87,201586,false,C-l-2 L-l-0 C-l-1 C-l-2 C-l-1 L-l-0 L-m-0 
job-4031,5,12,4,201404,248477,248524,47073,47,201642,false,C-m-0 C-l-0 C-l-0 C-m-1 
job-4032,6,10,1,201449,248477,248579,47028,102,201661,false,C-m-2 
job-4033,2,9,7,201501,248490,248652,46989,162,201770,false,C-m-2 C-l-0 L-m-0 C-m-1 C-m-0 L-m-0 L-m-0 
job-4034,5,10,3,201561,248652,248682,47091,30,201623,false,L-l-0 L-l-0 L-m-0 
job-4035,3,12,7,201600,248652,249290,47052,638,202344,false,L-m-0 C-l-2 C-l-2 C-s-1 C-l-2 C-l-2 L-s-0 
job-4038,2,4,6,201764,249290,249403,47526,113,201921,false,C-s-1 L-m-0 L-m-0 C-s-1 L-m-0 L-m-0 
job-4037,4,11,1,201709,249290,249413,47581,123,202061,false,L-s-0 
job-4036,6,5,2,201657,249290,249416,47633,126,201834,false,L-l-0 L-l-0 
job-4039,3,6,6,201814,249290,249444,47476,154,202031,false,C-m-0 C-l-1 C-l-1 C-m-0 C-l-1 C-l-1 
job-4041,4,5,5,201922,249403,249509,47481,106,202121,false,L-m-0 C-l-0 C-l-0 L-m-0 C-l-0 
job-4040,4,5,4,201876,249290,249553,47414,263,202426,false,C-s-2 C-l-2 C-l-2 C-l-2 
job-4042,4,6,5,201971,249553,249586,47582,33,202031,false,L-m-0 L-l-0 L-l-0 L-l-0 L-m-0 
job-4043,6,12,2,202027,249553,249663,47526,110,202168,false,C-l-0 C-l-0 
job-4044,2,12,1,202081,249553,249771,47472,218,202524,false,L-s-0 
job-4045,6,11,8,202126,249586,249914,47460,328,202500,false,L-l-0 C-l-1 L-l-0 C-l-2 C-l-1 L-m-0 C-l-2 C-m-0 
job-4048,3,11,8,202295,249914,250012,47619,98,202635,false,L-s-0 C-l-0 C-l-0 C-l-0 C-l-0 L-l-0 C-s-1 L-l-0 
job-4049,6,5,6,202359,249914,250042,47555,128,202514,false,C-m-0 C-l-1 C-l-2 C-m-1 C-l-2 C-l-1 
job-4047,3,6,3,202228,249914,250097,47686,183,202577,false,L-l-0 L-m-0 L-l-0 
job-4050,2,11,4,202403,249914,250147,47511,233,202888,false,C-m-0 C-m-2 C-m-1 C-m-2 
job-4051,4,9,6,202450,250012,250163,47562,151,202730,false,L-s-0 C-l-0 C-l-0 C-l-0 C-m-2 L-l-0 
job-4046,2,9,2,202178,249914,250296,47736,382,202593,false,L-m-0 L-m-0 
job-4052,4,9,5,202498,250042,250505,47544,463,203114,false,C-l-1 C-l-1 C-l-1 C-m-1 C-m-0 
job-4053,2,11,5,202538,250505,250555,47967,50,202593,false,L-s-0 L-l-0 L-l-0 L-l-0 L-l-0 
job-4054,6,12,3,202584,250505,250597,47921,92,202931,false,L-m-0 C-l-0 C-l-0 
job-4055,3,9,3,202630,250505,250620,47875,115,202952,false,C-l-1 C-l-1 C-l-1 
job-4056,6,11,6,202676,250555,250702,47879,147,202893,false,C-m-0 L-l-0 C-l-2 C-m-1 C-l-2 L-l-0 
job-4058,5,10,5,202768,250702,250770,47934,68,202876,false,L-l-0 L-l-0 C-l-0 C-m-0 C-l-0 
job-4057,1,4,7,202724,250702,250779,47978,77,203037,false,L-m-0 L-m-0 L-m-0 L-m-0 L-m-0 L-m-0 L-m-0 
job-4059,1,11,7,202807,250702,250843,47895,141,203092,false,L-s-0 C-l-0 C-l-0 C-m-0 L-l-0 L-l-0 C-m-0 
job-4061,5,10,3,202880,250843,250863,47963,20,203190,false,C-l-1 C-m-1 C-l-1 
job-4060,6,5,8,202849,250843,250868,47994,25,203060,false,L-l-0 C-l-0 C-l-2 C-l-2 C-l-0 L-l-0 C-m-0 L-m-0 
job-4063,5,11,4,202984,250863,250935,47879,72,203320,false,C-m-2 C-l-1 C-l-1 C-m-1 
job-4062,1,9,6,202940,250863,251030,47923,167,203272,false,L-s-0 L-m-0 L-m-0 C-m-0 C-m-0 C-s-1 
job-4064,2,7,3,203041,251030,251064,47989,34,203126,false,L-m-0 L-m-0 L-m-0 
job-4065,3,9,3,203098,251030,251192,47932,162,203490,false,L-l-0 L-l-0 L-l-0 
job-4066,6,7,7,203153,251030,251214,47877,184,203411,false,C-l-0 C-l-2 C-l-0 C-l-2 C-l-1 C-l-1 C-m-0 
job-4067,5,5,4,203196,251192,251358,47996,166,203645,false,L-m-0 L-l-0 L-l-0 C-m-1 
job-4068,2,10,2,203260,251358,251372,48098,14,203479,false,L-m-0 L-m-0 
job-4070,5,8,4,203349,251358,251407,48009,49,203694,false,C-l-0 C-l-0 C-l-1 C-l-1 
job-4069,3,5,5,203302,251358,251600,48056,242,203606,false,L-l-0 L-l-0 L-m-0 L-l-0 L-l-0 
job-4074,3,7,2,203566,251600,251630,48034,30,203650,false,C-s-0 C-s-2 
job-4071,4,6,1,203395,251600,251636,48205,36,203507,false,L-s-0 
job-4073,2,6,6,203516,251600,251647,48084,47,203643,false,L-l-0 L-l-0 L-l-0 L-l-0 L-l-0 L-l-0 
job-4072,1,7,4,203454,251600,251671,48146,71,203735,false,L-m-0 L-m-0 L-m-0 L-m-0 
job-4077,4,8,1,203719,251600,251741,47881,141,203922,false,C-s-1 
job-4076,5,7,6,203669,251600,251742,47931,142,204104,false,C-m-2 C-l-2 C-l-0 C-m-0 C-l-0 C-l-2 
job-4075,2,9,8,203615,251600,251754,47985,154,203785,false,C-m-1 C-l-1 C-l-1 C-l-1 C-m-1 C-l-1 C-l-1 C-m-1 
job-4078,4,7,8,203768,251741,251762,47973,21,203820,false,L-s-0 L-l-0 C-s-2 L-l-0 L-l-0 L-m-0 C-s-1 L-m-0 
job-4079,1,5,5,203826,251742,251920,47916,178,204258,false,C-m-0 C-m-0 C-m-0 C-m-0 C-m-1 
job-4080,1,8,5,203864,251920,251951,48056,31,203914,false,L-l-0 L-l-0 L-l-0 L-l-0 L-l-0 
job-4081,1,11,8,203920,251920,252036,48000,116,204077,false,C-s-1 C-l-0 L-s-0 C-l-0 C-l-0 L-m-0 C-l-0 L-m-0 
job-4082,5,5,2,203976,252036,252070,48060,34,204223,false,L-l-0 L-l-0 
job-4085,3,4,8,204115,252036,252138,47921,102,204502,false,C-l-0 C-l-0 C-l-0 C-l-0 C-l-1 C-l-1 C-l-1 L-m-0 
job-4083,4,4,1,204015,252036,252249,48021,213,204445,false,L-s-0 
job-4084,2,9,6,204066,252036,252291,47970,255,204460,false,L-l-0 C-m-2 L-m-0 C-m-2 C-m-2 L-m-0 
job-4086,1,4,1,204167,252291,252669,48124,378,204736,false,L-s-0 
job-4087,2,6,7,204223,252669,252682,48446,13,204404,false,L-l-0 L-l-0 L-s-0 L-l-0 L-l-0 L-s-0 L-l-0 
job-4089,5,8,8,204331,252682,252828,48351,146,204707,false,C-m-2 L-l-0 C-l-2 C-l-1 C-l-2 L-l-0 C-m-1 C-l-1 
job-4088,5,10,4,204274,252669,252906,48395,237,204643,false,L-m-0 C-l-0 C-l-0 C-m-0 
job-4090,6,5,3,204396,252828,252910,48432,82,204516,false,L-l-0 L-l-0 C-m-1 
job-4091,3,11,8,204453,252828,252938,48375,110,204775,false,C-s-1 C-l-2 C-l-2 C-l-2 C-l-2 L-m-0 L-s-0 C-m-0 
job-4092,3,5,1,204502,252938,252969,48436,31,204562,false,L-s-0 
job-4093,1,7,1,204557,252969,253113,48412,144,204899,false,L-s-0 
job-4094,1,9,1,204606,253113,253136,48507,23,204728,false,L-s-0 
job-4096,5,8,7,204714,253113,253393,48399,280,205290,false,C-l-2 C-l-1 C-l-1 L-m-0 C-l-0 C-l-0 C-l-2 
job-4095,3,12,4,204662,253113,253400,48451,287,205021,false,L-l-0 L-l-0 L-l-0 L-l-0 
job-4097,6,4,5,204765,253393,253426,48628,33,204937,false,C-l-0 C-l-1 C-l-1 L-m-0 C-l-0 
job-4098,4,7,1,204816,253393,253746,48577,353,205339,false,L-s-0 
job-4099,2,11,2,204853,253746,253783,48893,37,205125,false,L-m-0 L-m-0 
job-4100,6,11,2,204895,253746,253801,48851,55,205196,false,L-l-0 L-l-0 
job-4101,1,12,8,204940,253746,253861,48806,115,205216,false,C-l-0 C-l-1 C-l-0 C-l-0 C-l-1 C-l-1 C-l-0 C-l-1 
job-4102,2,8,6,204992,253861,253891,48869,30,205133,false,L-l-0 L-l-0 L-l-0 L-l-0 L-l-0 L-l-0 
job-4104,3,4,7,205097,253861,253989,48764,128,205453,false,C-m-0 C-l-1 C-l-1 C-m-0 C-l-1 C-l-1 L-s-0 
job-4106,4,6,4,205176,253989,254024,48813,35,205307,false,L-s-0 C-l-0 C-l-0 C-l-0 
job-4105,6,5,3,205134,253989,254028,48855,39,205366,false,L-l-0 L-l-0 C-m-0 
job-4107,3,8,3,205232,254024,254043,48792,19,205322,false,L-s-0 C-m-1 C-m-1 
job-4108,6,7,3,205291,254024,254124,48733,100,205586,false,C-l-0 C-m-2 C-l-0 
job-4103,3,11,2,205047,253861,254138,48814,277,205348,false,L-m-0 L-m-0 
job-4109,5,4,1,205340,254124,254170,48784,46,205559,false,L-l-0 
job-4110,4,6,8,205388,254124,254361,48736,237,205753,false,L-s-0 C-l-1 C-l-0 L-l-0 C-l-0 C-l-1 C-l-0 C-l-1 
job-4111,1,10,4,205438,254361,254400,48923,39,205659,false,L-l-0 L-l-0 L-l-0 L-l-0 
job-4112,6,9,2,205478,254361,254459,48883,98,205674,false,L-m-0 C-m-0 
job-4113,6,12,8,205539,254361,254524,48822,163,205804,false,C-l-0 C-l-0 C-l-1 C-l-1 C-l-2 C-m-2 C-l-2 C-m-1 
job-4114,6,6,1,205589,254524,254550,48935,26,205680,false,L-m-0 
job-4115,5,6,4,205640,254524,254638,48884,114,205867,false,L-l-0 L-l-0 C-l-0 C-l-0 
job-4116,3,6,6,205698,254524,255052,48826,528,206505,false,L-s-0 C-l-1 C-l-1 C-s-1 C-l-1 C-l-1 
job-4117,1,8,6,205751,255052,255074,49301,22,205977,false,L-l-0 L-l-0 L-l-0 L-l-0 L-l-0 L-l-0 
job-4118,6,4,2,205799,255052,255075,49253,23,205943,false,C-m-0 L-m-0 
job-4119,6,4,2,205843,255052,255115,49209,63,206109,false,C-l-0 C-l-0 
job-4120,3,9,1,205884,255115,255144,49231,29,206174,false,L-s-0 
job-4121,1,10,2,205931,255115,255180,49184,65,206067,false,L-m-0 L-m-0 
job-4122,5,5,8,205979,255115,255206,49136,91,206325,false,C-m-0 L-l-0 C-l-1 C-l-0 C-l-1 L-l-0 C-l-0 L-m-0 
job-4123,5,10,4,206034,255180,255210,49146,30,206323,false,C-m-1 C-l-2 C-l-2 C-m-2 
job-4124,4,6,3,206089,255206,255224,49117,18,206262,false,L-l-0 L-l-0 L-l-0 
job-4125,2,7,2,206138,255210,255225,49072,15,206361,false,L-s-0 L-s-0 
job-4126,6,8,2,206189,255210,255332,49021,122,206609,false,L-m-0 C-m-0 
job-4127,2,8,3,206237,255332,255349,49095,17,206329,false,L-m-0 L-m-0 L-m-0 
job-4128,4,8,6,206283,255332,255443,49049,111,206640,false,L-s-0 L-l-0 C-m-0 C-m-0 L-l-0 L-l-0 
job-4129,1,12,4,206335,255332,255594,48997,262,206832,false,C-l-2 C-l-2 C-l-2 C-l-2 
job-4130,4,5,7,206384,255332,255602,48948,270,206703,false,C-l-1 C-l-1 C-l-0 C-s-1 C-l-1 C-l-0 C-l-0 
job-4135,3,7,5,206623,255602,255637,48979,35,206936,false,C-l-0 C-l-0 C-l-0 C-s-0 C-l-0 
job-4134,4,10,8,206563,255594,255644,49031,50,206873,false,L-s-0 C-m-2 C-m-0 C-s-2 C-m-0 C-m-1 C-m-1 C-m-2 
job-4132,1,7,7,206472,255594,255648,49122,54,206632,false,L-m-0 L-l-0 L-l-0 L-l-0 L-l-0 L-l-0 L-l-0 
job-4133,5,9,2,206515,255594,255649,49079,55,206841,false,C-l-2 C-l-2 
job-4131,1,4,5,206424,255594,255655,49170,61,206503,false,L-m-0 L-m-0 L-m-0 L-m-0 L-m-0 
job-4136,3,8,5,206678,255602,255659,48924,57,206831,false,C-s-1 C-l-1 C-l-1 C-l-1 C-l-1 
job-4137,5,8,8,206737,255649,255669,48912,20,207009,false,L-l-0 C-l-2 C-l-0 C-l-2 C-l-0 L-l-0 C-m-0 C-m-1 
job-4138,3,12,7,206781,255649,255673,48868,24,207041,false,L-s-0 C-m-0 C-s-2 C-m-2 C-m-2 L-m-0 C-m-1 
job-4139,2,8,2,206837,255673,255868,48836,195,207298,false,L-s-0 L-s-0 
job-4140,2,10,3,206876,255868,255911,48992,43,207187,false,L-m-0 L-m-0 L-m-0 
job-4141,6,4,1,206922,255911,255921,48989,10,207159,false,L-m-0 
job-4142,3,7,1,206976,255911,255976,48935,65,207308,false,L-s-0 
job-4143,2,9,4,207022,255911,256193,48889,282,207404,false,L-l-0 L-m-0 L-l-0 L-l-0 
job-4144,5,6,6,207074,255911,256236,48837,325,207615,false,C-m-0 C-l-1 C-l-1 C-l-0 C-l-0 L-l-0 
job-4145,2,7,4,207117,256236,256274,49119,38,207340,false,L-m-0 L-m-0 L-m-0 L-m-0 
job-4146,4,10,5,207171,256236,256287,49065,51,207428,false,C-s-1 L-s-0 L-l-0 L-l-0 L-l-0 
job-4147,3,9,3,207212,256236,256447,49024,211,207721,false,C-l-0 C-l-0 C-l-0 
job-4148,6,12,5,207264,256236,256890,48972,654,208208,false,C-l-1 C-l-1 C-l-2 C-m-0 C-l-2 
job-4149,3,7,5,207313,256890,256905,49577,15,207557,false,L-l-0 L-s-0 L-l-0 L-l-0 L-l-0 
job-4150,4,4,4,207359,256890,256971,49531,81,207646,false,L-m-0 C-m-0 L-m-0 C-m-0 
job-4151,2,4,2,207401,256890,257136,49489,246,207775,false,C-s-1 C-s-1 
job-4152,4,4,3,207436,257136,257173,49700,37,207602,false,L-l-0 L-l-0 L-l-0 
job-4153,2,9,6,207491,257136,257325,49645,189,207813,false,C-m-0 L-m-0 L-m-0 C-m-0 C-m-0 L-m-0 
job-4156,6,6,7,207640,257325,257348,49685,23,207906,false,C-m-1 C-l-1 C-l-0 C-l-0 C-l-1 C-l-2 C-l-2 
job-4154,1,10,5,207531,257325,257350,49794,25,207819,false,L-s-0 L-l-0 L-l-0 L-l-0 L-l-0 
job-4155,6,4,3,207583,257325,257357,49742,32,207851,false,L-l-0 L-m-0 C-m-0 
job-4157,6,10,4,207693,257348,257476,49655,128,207858,false,C-l-2 C-l-0 C-l-0 C-l-2 
job-4159,6,9,7,207794,257357,257498,49563,141,208123,false,L-m-0 C-l-1 L-l-0 C-m-2 L-l-0 C-l-1 C-m-0 
job-4158,3,6,3,207748,257348,257515,49600,167,208044,false,L-s-0 C-m-1 C-m-1 
job-4161,5,10,3,207912,257515,257632,49603,117,208031,false,L-l-0 L-l-0 L-m-0 
job-4160,3,5,7,207848,257476,257647,49628,171,208038,false,C-l-2 C-l-2 C-l-0 C-l-2 C-l-0 C-l-0 C-l-2 
job-4162,3,6,8,207954,257632,257669,49678,37,208133,false,L-s-0 L-l-0 L-l-0 C-l-0 L-l-0 L-m-0 L-l-0 L-m-0 
job-4163,5,11,1,208007,257632,257860,49625,228,208270,false,C-m-0 
job-4165,3,6,7,208109,257860,257961,49751,101,208453,false,L-m-0 L-l-0 L-l-0 C-s-1 L-l-0 L-l-0 L-m-0 
job-4164,4,8,1,208058,257860,257974,49802,114,208436,false,L-s-0 
job-4166,6,5,4,208170,257961,257985,49791,24,208374,false,L-m-0 L-l-0 L-l-0 C-m-0 
job-4167,4,10,2,208212,257961,258248,49749,287,208513,false,C-m-1 C-m-1 
job-4168,2,12,2,208258,258248,258269,49990,21,208330,false,L-m-0 L-m-0 
job-4169,4,5,8,208310,258248,258331,49938,83,208419,false,L-l-0 L-m-0 C-l-0 C-l-0 C-l-0 L-l-0 L-l-0 L-s-0 
job-4170,5,10,3,208360,258331,258344,49971,13,208376,false,L-l-0 L-l-0 L-m-0 
job-4171,3,10,5,208408,258331,258374,49923,43,208689,false,C-l-0 C-l-0 C-l-0 L-m-0 C-l-0 
job-4173,6,7,8,208520,258344,258419,49824,75,208862,false,C-l-1 C-l-2 C-l-1 L-l-0 C-l-2 L-l-0 C-m-2 C-m-1 
job-4174,5,8,6,208574,258419,258541,49845,122,208728,false,L-m-0 L-l-0 C-l-0 C-m-1 C-l-0 L-l-0 
job-4175,2,6,6,208618,258419,258603,49801,184,208862,false,L-m-0 C-m-0 L-s-0 C-m-1 C-l-0 L-l-0 
job-4176,3,11,6,208674,258603,258617,49929,14,208964,false,L-m-0 L-l-0 L-l-0 L-m-0 L-l-0 L-l-0 
job-4172,6,11,1,208461,258331,258618,49870,287,208952,false,C-m-0 
job-4177,2,12,2,208720,258603,258692,49883,89,208936,false,L-s-0 C-m-0 
job-4178,1,9,1,208773,258692,258706,49919,14,208950,false,L-s-0 
job-4179,5,4,2,208817,258692,258796,49875,104,209067,false,L-l-0 L-l-0 
job-4180,1,11,3,208860,258796,258819,49936,23,209074,false,L-l-0 L-l-0 L-l-0 
job-4181,2,5,8,208914,258819,258829,49905,10,209137,false,L-l-0 L-s-0 L-l-0 L-l-0 L-l-0 L-s-0 L-l-0 L-l-0 
job-4182,1,10,8,208963,258819,258854,49856,35,209047,false,C-s-1 C-l-0 C-l-0 C-l-0 C-l-0 L-m-0 L-m-0 L-m-0 
job-4183,2,8,1,209013,258854,258910,49841,56,209069,false,L-s-0 
job-4184,5,9,3,209064,258854,258916,49790,62,209381,false,L-l-0 L-l-0 L-m-0 
job-4185,1,9,4,209118,258916,258926,49798,10,209147,false,L-l-0 L-l-0 L-l-0 L-l-0 
job-4186,5,5,5,209181,258916,258979,49735,63,209349,false,L-m-0 L-l-0 C-l-0 C-m-0 C-l-0 
job-4188,5,10,7,209289,258979,259011,49690,32,209595,false,C-l-2 C-l-0 C-l-0 L-m-0 C-l-1 C-l-1 C-l-2 
job-4187,1,6,7,209244,258979,259066,49735,87,209495,false,L-l-0 L-l-0 L-l-0 L-l-0 L-l-0 L-l-0 L-l-0 
job-4191,5,9,3,209442,259011,259146,49569,135,209700,false,L-m-0 C-l-0 C-l-0 
job-4189,4,10,5,209333,258979,259157,49646,178,209583,false,L-s-0 C-m-1 C-m-0 C-m-0 C-m-1 
job-4190,3,4,2,209391,259011,259413,49620,402,210066,false,L-m-0 L-l-0 
job-4192,5,8,2,209493,259413,259424,49920,11,209771,false,L-l-0 L-l-0 
job-4193,4,8,7,209553,259413,259433,49860,20,209692,false,L-m-0 C-l-1 C-l-1 L-m-0 C-l-1 C-s-1 L-s-0 
job-4194,2,8,1,209607,259424,259649,49817,225,210121,false,L-l-0 
job-4195,6,8,1,209664,259649,259676,49985,27,209765,false,L-m-0 
job-4196,3,6,7,209709,259649,259695,49940,46,209971,false,C-m-0 L-l-0 L-l-0 C-m-0 L-l-0 L-l-0 L-s-0 
job-4197,4,5,5,209750,259649,259822,49899,173,210013,false,C-m-1 C-l-1 C-l-1 C-m-1 C-l-1 
job-4198,3,10,8,209796,259649,259966,49853,317,210152,false,C-l-0 C-l-2 C-l-0 C-l-0 C-l-2 C-l-2 C-l-0 C-l-2 
job-4199,6,12,4,209843,259966,260032,50123,66,210059,false,L-m-0 L-l-0 L-l-0 C-m-0 
job-4200,3,5,8,209884,260032,260047,50148,15,209904,false,L-m-0 L-l-0 L-s-0 L-l-0 L-l-0 L-l-0 C-s-1 L-m-0 
job-4201,6,10,7,209938,260032,260116,50094,84,210309,false,C-l-2 C-l-1 C-l-0 C-m-0 C-l-1 C-l-0 C-l-2 
job-4202,4,10,4,209992,260116,260127,50124,11,210179,false,L-l-0 L-l-0 L-s-0 L-l-0 
job-4203,6,7,7,210030,260116,260233,50086,117,210184,false,C-l-0 C-l-2 C-l-1 C-l-0 C-l-1 C-l-2 L-m-0 
job-4204,5,8,1,210077,260116,260310,50039,194,210385,false,C-m-0 
job-4205,6,5,6,210107,260233,260638,50126,405,210601,false,L-m-0 C-l-0 L-l-0 C-m-1 C-l-0 L-l-0 
job-4206,1,9,5,210163,260638,260656,50475,18,210377,false,L-l-0 L-l-0 L-l-0 L-l-0 L-l-0 
job-4208,1,12,5,210258,260638,260705,50380,67,210356,false,L-m-0 C-l-0 C-l-0 C-l-0 C-l-0 
job-4209,5,9,3,210311,260638,260731,50327,93,210627,false,L-m-0 C-l-1 C-l-1 
job-4210,5,11,5,210366,260705,260734,50339,29,210509,false,C-m-1 L-l-0 C-l-2 C-l-2 L-l-0 
job-4207,4,8,1,210205,260638,260735,50433,97,210409,false,L-s-0 
job-4211,3,7,7,210416,260705,260776,50289,71,210752,false,C-s-1 C-l-0 C-l-0 C-m-1 C-l-0 C-l-0 L-m-0 
job-4213,6,9,5,210519,260776,260963,50257,187,210749,false,L-l-0 C-l-1 L-l-0 C-m-0 C-l-1 
job-4215,6,8,6,210631,260963,260979,50332,16,210722,false,C-l-0 C-l-2 C-l-1 C-l-2 C-l-1 C-l-0 
job-4212,1,5,6,210465,260776,260983,50311,207,210959,false,L-m-0 L-m-0 L-m-0 L-m-0 L-m-0 L-m-0 
job-4216,2,7,7,210692,260979,261010,50287,31,210807,false,C-l-1 C-s-1 C-l-1 C-l-1 C-l-1 C-l-1 L-s-0 
job-4214,2,9,7,210570,260963,261047,50393,84,210676,false,L-s-0 L-l-0 L-l-0 L-l-0 L-l-0 L-l-0 C-s-1 
job-4218,2,10,4,210823,261047,261090,50224,43,211091,false,L-l-0 L-l-0 L-l-0 L-l-0 
job-4217,3,5,8,210759,260979,261093,50220,114,211172,false,C-l-0 C-l-2 C-l-0 C-l-2 C-l-0 C-l-2 C-l-0 C-l-2 
job-4219,3,9,6,210887,261090,261106,50203,16,210929,false,L-m-0 L-l-0 L-l-0 L-m-0 L-l-0 L-l-0 
job-4220,6,12,3,210920,261090,261291,50170,201,211340,false,C-m-0 C-l-1 C-l-1 
job-4221,2,9,3,210966,261291,261319,50325,28,211116,false,L-m-0 L-m-0 L-m-0 
job-4222,1,5,8,211026,261291,261336,50265,45,211220,false,L-l-0 L-m-0 L-l-0 L-l-0 L-l-0 L-l-0 L-l-0 L-l-0 
job-4225,1,9,8,211157,261291,261357,50134,66,211509,false,C-l-1 C-l-1 C-l-1 C-l-1 C-l-1 C-m-1 C-m-1 C-m-1 
job-4223,2,11,8,211069,261291,261362,50222,71,211326,false,L-s-0 C-l-0 C-l-0 C-l-0 C-l-0 L-l-0 C-m-0 C-m-0 
job-4224,2,4,6,211110,261291,261408,50181,117,211468,false,C-m-0 C-s-1 C-s-1 C-m-0 C-l-0 L-s-0 
job-4226,6,5,4,211215,261319,261484,50104,165,211555,false,L-m-0 C-l-2 C-l-2 C-m-2 
job-4227,4,9,4,211267,261336,261597,50069,261,211696,false,C-s-0 L-l-0 L-l-0 C-s-2 
job-4228,1,5,7,211312,261484,261610,50172,126,211681,false,L-l-0 L-l-0 L-l-0 L-s-0 L-l-0 L-s-0 L-s-0 
job-4230,6,9,3,211411,261610,261638,50199,28,211647,false,L-l-0 L-l-0 C-m-0 
job-4229,2,11,2,211355,261610,261641,50255,31,211421,false,L-m-0 L-m-0 
job-4231,4,12,4,211454,261610,261725,50156,115,211868,false,L-s-0 C-s-1 C-m-1 C-m-1 
job-4232,1,4,5,211492,261610,262024,50118,414,212046,false,L-m-0 C-s-2 C-m-0 L-m-0 C-m-0 
job-4234,5,12,7,211598,262024,262119,50426,95,211917,false,C-m-0 C-l-2 C-l-1 C-l-2 C-l-0 C-l-1 C-l-0 
job-4235,4,5,6,211643,262024,262189,50381,165,211835,false,C-m-2 C-s-2 C-m-1 C-m-2 C-m-1 L-s-0 
job-4233,6,8,3,211551,262024,262191,50473,167,212012,false,L-l-0 L-l-0 L-m-0 
job-4236,6,11,3,211706,262189,262206,50483,17,211726,false,C-l-0 C-l-0 C-m-0 
job-4237,1,12,7,211764,262189,262268,50425,79,212117,false,C-m-0 L-m-0 L-m-0 C-l-2 C-l-2 C-l-2 C-l-2 
job-4238,5,4,7,211811,262268,262287,50457,19,212089,false,C-l-1 L-l-0 C-l-0 C-l-1 C-l-0 L-l-0 L-m-0 
job-4239,6,12,4,211855,262268,262372,50413,104,211987,false,C-m-0 C-l-2 C-l-2 C-m-1 
job-4240,6,5,5,211893,262287,262506,50394,219,212153,false,L-l-0 C-l-0 L-l-0 L-m-0 C-l-0 
job-4241,6,11,2,211932,262506,262552,50574,46,212204,false,L-l-0 L-l-0 
job-4242,3,12,5,211986,262506,263117,50520,611,212756,false,L-s-0 L-m-0 L-m-0 C-m-0 C-m-0 
job-4243,3,9,3,212046,263117,263249,51071,132,212328,false,L-m-0 L-m-0 L-s-0 
job-4244,1,5,4,212096,263117,263345,51021,228,212493,false,L-s-0 L-m-0 L-l-0 L-m-0 
job-4245,6,4,5,212142,263117,263398,50975,281,212654,false,L-l-0 C-l-1 C-l-1 C-l-0 C-l-0 
job-4246,6,5,1,212201,263398,263568,51197,170,212561,false,L-m-0 
job-4248,4,6,6,212298,263398,263626,51100,228,212629,false,L-s-0 C-l-2 C-l-2 C-s-2 C-l-2 C-s-1 
job-4247,5,5,2,212246,263398,263648,51152,250,212588,false,L-l-0 L-l-0 
job-4250,3,4,8,212396,263626,263718,51230,92,212568,false,L-s-0 C-l-2 C-l-2 C-l-2 C-l-2 L-m-0 C-s-1 L-m-0 
job-4249,4,10,8,212348,263398,263765,51050,367,212924,false,C-l-1 C-l-0 C-l-0 C-m-1 C-l-1 C-l-0 C-l-1 C-m-1 
job-4251,1,8,3,212465,263718,263794,51253,76,212600,false,L-m-0 L-m-0 L-m-0 
job-4253,3,5,3,212560,263794,263874,51234,80,212850,false,L-l-0 L-l-0 L-l-0 
job-4252,3,4,1,212511,263794,263877,51283,83,212645,false,L-s-0 
job-4254,6,5,6,212622,263794,264028,51172,234,212982,false,L-m-0 C-l-1 C-l-0 C-m-0 C-l-0 C-l-1 
job-4256,1,10,6,212715,264028,264089,51313,61,212950,false,L-m-0 L-l-0 L-l-0 L-m-0 L-l-0 L-l-0 
job-4258,3,6,3,212822,264089,264143,51267,54,212916,false,L-l-0 L-l-0 L-l-0 
job-4257,3,6,2,212768,264089,264180,51321,91,212995,false,L-m-0 L-m-0 
job-4255,2,6,2,212673,264028,264181,51355,153,213040,false,L-s-0 L-s-0 
job-4259,6,6,2,212876,264089,264271,51213,182,213130,false,C-l-0 C-l-0 
job-4260,4,9,4,212928,264089,264422,51161,333,213450,false,C-s-1 C-l-1 C-l-1 C-l-1 
job-4262,2,12,3,213019,264422,264473,51403,51,213349,false,L-m-0 L-m-0 L-s-0 
job-4261,6,5,2,212973,264422,264490,51449,68,213088,false,L-l-0 L-l-0 
job-4263,6,4,6,213078,264422,264544,51344,122,213456,false,C-l-0 C-l-2 C-l-1 C-l-0 C-l-2 C-l-1 
job-4264,5,7,7,213123,264544,264649,51421,105,213483,false,C-l-1 L-l-0 C-l-0 C-l-1 C-l-0 L-l-0 L-m-0 
job-4265,5,9,1,213182,264544,264843,51362,299,213573,false,C-m-0 
job-4266,6,9,3,213237,264843,264889,51606,46,213445,false,L-l-0 L-l-0 L-m-0 
job-4267,5,5,3,213293,264843,264907,51550,64,213528,false,C-l-0 C-l-0 C-m-0 
job-4268,6,10,7,213335,264889,265102,51554,213,213738,false,L-m-0 C-l-1 C-l-2 L-l-0 C-l-1 C-l-2 L-l-0 
job-4269,4,9,1,213381,265102,265167,51721,65,213544,false,L-s-0 
job-4270,6,7,3,213430,265102,265220,51672,118,213608,false,L-l-0 L-m-0 L-l-0 
job-4271,1,7,4,213489,265220,265230,51731,10,213743,false,L-m-0 L-m-0 L-m-0 L-m-0 
job-4274,1,5,7,213622,265220,265235,51598,15,213936,false,C-l-0 C-l-0 C-l-0 C-l-0 C-l-0 C-l-0 C-l-0 
job-4272,3,6,4,213534,265220,265250,51686,30,213769,false,L-l-0 L-l-0 L-l-0 L-l-0 
job-4275,4,10,3,213672,265220,265253,51548,33,213979,false,C-m-0 C-m-0 C-l-0 
job-4276,2,9,3,213722,265220,265295,51498,75,213851,false,C-m-1 C-m-1 C-m-1 
job-4273,2,5,2,213586,265220,265302,51634,82,213951,false,L-s-0 L-s-0 
job-4277,2,6,7,213762,265220,265303,51458,83,214115,false,C-l-1 C-l-1 C-l-1 C-s-1 C-l-1 C-l-1 C-l-1 
job-4278,4,4,5,213810,265295,265315,51485,20,213899,false,L-m-0 L-l-0 L-l-0 L-m-0 L-l-0 
job-4280,5,12,1,213911,265295,265406,51384,111,214190,false,C-m-1 
job-4279,5,12,3,213866,265295,265442,51429,147,214292,false,C-m-0 C-l-2 C-l-2 
job-4281,1,4,4,213971,265442,265500,51471,58,214275,false,L-s-0 L-s-0 L-s-0 L-s-0 
job-4282,5,7,5,214025,265442,265502,51417,60,214095,false,L-m-0 L-l-0 C-l-0 L-l-0 C-l-0 
job-4283,2,11,1,214066,265502,265574,51436,72,214144,false,L-s-0 
job-4285,1,11,3,214175,265502,265600,51327,98,214290,false,C-l-0 C-l-0 C-l-0 
job-4286,6,11,6,214224,265502,265671,51278,169,214396,false,C-m-0 C-l-2 C-l-1 C-l-0 C-l-1 C-l-2 
job-4284,3,12,7,214128,265502,265696,51374,194,214436,false,L-m-0 L-l-0 L-l-0 L-m-0 L-l-0 L-l-0 C-s-1 
job-4287,6,5,4,214282,265671,265781,51389,110,214577,false,C-l-0 C-l-0 C-l-1 C-l-1 
job-4290,5,8,7,214432,265781,265827,51349,46,214629,false,C-l-0 C-l-2 C-l-1 L-m-0 C-l-0 C-l-1 C-l-2 
job-4288,3,9,5,214336,265781,265832,51445,51,214668,false,L-l-0 L-s-0 L-l-0 L-l-0 L-l-0 
job-4289,1,12,1,214384,265781,265981,51397,200,214809,false,L-m-0 
job-4291,6,11,6,214494,265827,266121,51333,294,214811,false,C-m-0 C-l-2 C-l-2 L-m-0 C-l-0 C-l-0 
job-4294,5,7,7,214646,266121,266157,51475,36,214771,false,C-l-0 C-l-2 L-m-0 C-l-1 C-l-1 C-l-2 C-l-0 
job-4295,6,11,8,214688,266157,266245,51469,88,214826,false,C-l-0 C-l-1 C-l-0 C-l-2 C-l-1 C-l-2 L-m-0 C-m-0 
job-4293,1,12,5,214600,266121,266253,51521,132,215025,false,L-m-0 L-l-0 L-l-0 L-l-0 L-l-0 
job-4296,3,7,4,214740,266245,266256,51505,11,214814,false,L-m-0 C-m-0 L-m-0 C-m-0 
job-4292,1,6,2,214545,266121,266305,51576,184,214850,false,L-s-0 L-s-0 
job-4297,6,7,7,214784,266245,266428,51461,183,215083,false,C-l-0 C-l-1 C-l-0 C-m-1 C-l-1 C-l-2 C-l-2 
job-4298,4,8,5,214827,266428,266442,51601,14,214868,false,L-m-0 L-l-0 L-l-0 L-l-0 L-m-0 
job-4299,4,4,3,214875,266428,266450,51553,22,214982,false,L-s-0 C-m-0 C-m-0 
job-4300,6,7,8,214923,266428,266639,51505,211,215357,false,C-l-1 C-l-2 C-l-0 C-m-2 C-l-2 C-l-0 C-l-1 C-m-1 
job-4301,2,5,4,214973,266639,266727,51666,88,215124,false,L-m-0 L-m-0 L-m-0 L-m-0 
job-4302,2,6,2,215011,266639,266772,51628,133,215191,false,L-s-0 L-s-0 
job-4303,1,9,1,215062,266727,266772,51665,45,215165,false,L-m-0 
job-4304,3,12,5,215112,266772,266786,51660,14,215249,false,L-l-0 L-l-0 L-m-0 L-l-0 L-l-0 
job-4305,4,4,4,215155,266772,267154,51617,382,215576,false,C-m-0 L-m-0 L-s-0 C-m-0 
job-4306,5,11,2,215202,267154,267233,51952,79,215370,false,L-l-0 L-l-0 
job-4308,3,4,5,215274,267154,267282,51880,128,215499,false,C-l-1 C-l-1 C-l-1 C-s-0 C-l-1 
job-4307,4,8,6,215240,267154,267283,51914,129,215549,false,L-s-0 C-l-0 C-l-0 L-m-0 C-l-0 L-m-0 
job-4309,5,10,8,215324,267282,267545,51958,263,215799,false,C-m-0 L-l-0 C-l-1 C-l-2 C-l-1 C-l-2 C-m-1 L-l-0 
job-4310,3,10,7,215366,267545,267661,52179,116,215588,false,L-s-0 L-l-0 L-l-0 L-m-0 L-l-0 L-l-0 L-m-0 
job-4311,4,11,1,215410,267545,267825,52135,280,215831,false,C-s-1 
job-4313,4,10,3,215524,267825,267845,52301,20,215557,false,C-l-1 C-l-1 C-l-1 
job-4312,3,4,7,215461,267825,267862,52364,37,215662,false,L-s-0 L-l-0 L-l-0 L-m-0 L-l-0 L-l-0 L-m-0 
job-4315,3,10,8,215621,267825,267918,52204,93,215866,false,C-s-1 C-m-0 C-l-0 C-l-0 C-l-0 C-m-1 C-l-0 C-m-1 
job-4314,1,7,6,215578,267825,268071,52247,246,216038,false,C-m-0 L-m-0 L-m-0 C-m-0 C-m-0 L-s-0 
job-4318,3,6,6,215770,268071,268129,52301,58,215902,false,L-s-0 C-l-0 C-l-0 C-l-0 C-l-0 L-l-0 
job-4316,4,9,2,215664,267825,268146,52161,321,216228,false,C-m-2 C-m-2 
job-4319,3,8,4,215814,268129,268147,52315,18,216083,false,L-s-0 L-l-0 C-s-0 C-s-2 
job-4317,1,10,7,215725,268071,268149,52346,78,215933,false,L-m-0 L-l-0 L-l-0 L-m-0 L-l-0 L-l-0 L-m-0 
job-4320,5,5,4,215871,268129,268545,52258,416,216442,false,C-l-0 C-l-0 C-l-1 C-l-1 
job-4321,3,8,3,215919,268129,268558,52210,429,216568,false,C-l-2 C-l-2 C-l-2 
job-4322,3,11,8,215969,268545,268563,52576,18,216264,false,L-l-0 L-s-0 L-l-0 L-l-0 L-l-0 L-m-0 L-m-0 C-l-2 
job-4323,6,9,8,216011,268558,268717,52547,159,216295,false,C-l-0 C-l-1 C-l-2 C-l-0 C-l-1 C-m-0 C-m-2 C-m-1 
job-4324,3,12,7,216064,268717,268786,52653,69,216288,false,L-s-0 L-l-0 L-l-0 L-m-0 L-l-0 L-l-0 L-m-0 
job-4325,2,10,7,216110,268717,268827,52607,110,216502,false,C-m-1 C-l-0 C-l-0 C-m-1 C-l-0 C-l-0 C-m-1 
job-4327,3,9,4,216190,268827,268840,52637,13,216342,false,C-l-0 C-l-0 C-l-0 C-l-0 
job-4326,4,9,7,216148,268827,268854,52679,27,216316,false,L-l-0 L-m-0 L-s-0 L-l-0 L-m-0 L-l-0 C-s-1 
job-4328,1,10,6,216229,268827,268965,52598,138,216646,false,C-m-0 C-m-1 C-m-0 C-m-1 C-m-0 C-m-1 
job-4329,2,4,2,216279,268965,268979,52686,14,216367,false,L-s-0 L-s-0 
job-4331,5,10,3,216378,268965,269102,52587,137,216545,false,C-l-1 C-m-1 C-l-1 
job-4330,5,6,6,216332,268965,269129,52633,164,216690,false,L-m-0 C-l-0 C-l-0 C-m-0 L-l-0 L-l-0 
job-4333,6,8,6,216482,269129,269171,52647,42,216524,false,L-m-0 C-l-1 L-l-0 C-m-0 C-l-1 L-l-0 
job-4334,6,4,7,216538,269171,269188,52633,17,216704,false,L-l-0 C-l-1 C-l-0 L-m-0 C-l-0 L-l-0 C-l-1 
job-4335,5,4,5,216582,269171,269240,52589,69,216946,false,C-m-1 C-l-2 C-m-2 C-m-0 C-l-2 
job-4332,1,6,1,216440,269129,269474,52689,345,216844,false,L-s-0 
job-4336,3,5,2,216642,269240,269486,52598,246,217112,false,L-s-0 L-m-0 
job-4338,6,11,1,216745,269486,269623,52741,137,217004,false,L-l-0 
job-4340,5,10,3,216856,269623,269744,52767,121,217184,false,L-l-0 L-l-0 C-m-0 
job-4341,4,8,7,216901,269744,269777,52843,33,217066,false,L-l-0 C-l-1 C-l-1 L-l-0 C-l-1 L-l-0 C-s-1 
job-4337,1,4,5,216694,269486,269822,52792,336,217307,false,L-m-0 L-m-0 L-m-0 L-m-0 L-m-0 
job-4339,1,4,4,216814,269623,269842,52809,219,217070,false,L-m-0 L-m-0 L-s-0 L-m-0 
job-4342,2,8,2,216959,269744,269857,52785,113,217222,false,L-s-0 C-s-2 
job-4343,3,8,4,217011,269744,269887,52733,143,217411,false,C-l-0 C-l-0 C-l-0 C-l-0 
job-4344,3,6,2,217065,269744,269914,52679,170,217270,false,C-m-0 C-m-0 
job-4345,6,5,8,217116,269777,270039,52661,262,217441,false,C-l-1 C-l-1 C-l-2 C-l-2 L-l-0 L-l-0 C-m-2 C-m-1 
job-4346,5,9,8,217164,270039,270128,52875,89,217269,false,L-l-0 C-l-0 C-l-1 C-l-1 C-l-0 L-l-0 C-m-0 L-m-0 
job-4347,3,6,1,217219,270128,270156,52909,28,217379,false,L-s-0 
job-4348,3,10,1,217261,270128,270223,52867,95,217494,false,L-m-0 
job-4349,5,9,1,217312,270223,270300,52911,77,217479,false,L-m-0 
job-4350,4,7,8,217364,270223,270393,52859,170,217581,false,C-s-1 C-l-1 L-s-0 C-l-1 C-l-1 L-l-0 L-l-0 L-l-0 
job-4351,2,8,4,217402,270300,270417,52898,117,217658,false,L-m-0 L-m-0 L-m-0 L-m-0 
job-4352,3,11,6,217467,270393,270424,52926,31,217561,false,L-s-0 L-l-0 L-l-0 C-s-1 L-l-0 L-l-0 
job-4353,4,7,2,217510,270417,270431,52907,14,217677,false,L-m-0 L-m-0 
job-4354,3,8,4,217561,270417,270503,52856,86,217848,false,C-l-2 C-l-2 C-l-2 C-l-2 
job-4355,1,5,7,217604,270503,270522,52899,19,217775,false,L-l-0 L-l-0 L-l-0 L-l-0 L-l-0 L-l-0 L-l-0 
job-4356,5,9,7,217656,270503,270522,52847,19,217903,false,C-m-0 C-l-0 C-l-1 L-m-0 C-l-1 C-l-0 L-l-0 
job-4357,2,5,5,217711,270503,270669,52792,166,218134,false,L-m-0 C-l-1 L-s-0 C-m-0 C-l-0 
job-4358,3,6,6,217766,270669,270695,52903,26,217908,false,L-m-0 L-l-0 L-l-0 L-m-0 L-l-0 L-l-0 
job-4359,5,10,4,217812,270669,271045,52857,376,218287,false,C-l-0 C-l-1 C-l-0 C-l-1 
job-4360,4,4,5,217862,271045,271075,53183,30,218172,false,L-m-0 L-l-0 L-l-0 L-l-0 L-m-0 
job-4362,3,8,4,217976,271045,271099,53069,54,218034,false,C-l-1 C-l-1 C-l-1 C-l-1 
job-4363,5,9,2,218027,271045,271105,53018,60,218293,false,C-l-2 C-l-2 
job-4364,6,11,5,218084,271099,271112,53015,13,218323,false,C-l-1 C-l-1 L-l-0 L-m-0 L-l-0 
job-4361,4,12,6,217914,271045,271113,53131,68,218234,false,L-s-0 C-m-2 C-l-0 C-m-2 C-l-0 C-l-0 
job-4365,1,4,7,218135,271099,271167,52964,68,218370,false,L-m-0 C-s-0 C-l-2 C-s-0 C-l-2 L-m-0 C-s-0 
job-4366,6,12,8,218191,271112,271191,52921,79,218272,false,L-l-0 C-l-1 L-l-0 C-m-1 C-l-1 C-l-2 L-m-0 C-m-0 
job-4367,4,12,1,218244,271191,271671,52947,480,218878,false,L-s-0 
job-4368,2,5,6,218278,271671,271722,53393,51,218456,false,L-l-0 L-l-0 L-l-0 L-l-0 L-l-0 L-l-0 
job-4369,4,4,1,218344,271671,271748,53327,77,218435,false,L-s-0 
job-4370,2,10,6,218395,271671,271759,53276,88,218728,false,C-m-0 L-m-0 L-m-0 C-m-0 C-m-0 L-m-0 
job-4371,2,8,2,218443,271748,271775,53305,27,218742,false,L-s-0 L-s-0 
job-4372,6,6,6,218488,271748,271791,53260,43,218554,false,L-l-0 C-l-0 C-l-1 C-l-1 C-l-0 L-l-0 
job-4373,6,4,2,218526,271748,271840,53222,92,218776,false,C-l-2 C-l-2 
job-4374,3,5,3,218580,271748,271858,53168,110,218902,false,C-m-1 C-m-1 C-s-1 
job-4375,5,5,4,218637,271791,271878,53154,87,218856,false,L-m-0 L-l-0 L-l-0 C-m-0 
job-4376,3,12,2,218692,271878,271911,53186,33,218921,false,L-m-0 L-m-0 
job-4377,6,9,3,218733,271878,271957,53145,79,218908,false,L-l-0 L-l-0 C-m-0 
job-4379,3,7,8,218835,271911,271979,53076,68,219118,false,C-m-2 C-m-2 C-s-1 C-m-1 C-m-1 L-m-0 L-s-0 L-m-0 
job-4378,5,7,6,218788,271878,272003,53090,125,218950,false,C-l-1 C-l-0 C-l-0 C-l-2 C-l-1 C-l-2 
job-4380,4,8,4,218885,271957,272116,53072,159,219132,false,L-l-0 L-l-0 L-l-0 C-s-2 
job-4382,4,4,8,218979,272116,272156,53137,40,219138,false,L-m-0 L-m-0 L-s-0 L-l-0 L-l-0 C-m-1 L-l-0 C-m-1 
job-4381,4,11,2,218937,271957,272165,53020,208,219373,false,C-m-0 C-m-0 
job-4384,4,6,4,219076,272165,272286,53089,121,219279,false,L-s-0 L-l-0 L-l-0 L-l-0 
job-4383,5,12,7,219019,272116,272288,53097,172,219284,false,C-l-0 C-l-1 C-l-0 C-m-2 C-l-1 C-l-2 C-l-2 
job-4385,4,4,4,219118,272165,272298,53047,133,219320,false,L-m-0 C-m-0 C-m-0 L-m-0 
job-4386,1,8,6,219156,272288,272749,53132,461,219764,false,L-l-0 L-l-0 L-l-0 L-l-0 L-l-0 L-l-0 
job-4387,4,8,5,219206,272749,272775,53543,26,219271,false,L-m-0 L-l-0 L-l-0 L-l-0 L-m-0 
job-4389,2,9,4,219295,272749,272832,53454,83,219677,false,C-l-1 C-l-1 C-l-1 C-l-1 
job-4388,1,8,5,219239,272749,272881,53510,132,219487,false,C-m-0 C-m-0 L-s-0 C-m-0 C-m-0 
job-4390,3,6,5,219347,272881,272898,53534,17,219569,false,L-s-0 L-l-0 L-l-0 L-l-0 L-l-0 
job-4391,2,7,6,219399,272881,272958,53482,77,219705,false,L-m-0 L-m-0 L-m-0 C-s-1 L-m-0 C-s-1 
job-4393,4,6,5,219500,272881,272990,53381,109,219656,false,C-m-0 C-l-1 C-l-1 C-s-2 C-l-1 
job-4392,2,12,2,219458,272881,272996,53423,115,219798,false,C-m-0 C-m-0 
job-4394,1,7,4,219549,272881,273004,53332,123,219748,false,C-m-1 C-m-1 L-s-0 C-m-1 
job-4395,4,9,4,219604,272881,273009,53277,128,219936,false,C-m-1 C-l-0 C-l-0 C-l-0 
job-4396,2,5,3,219663,272958,273021,53295,63,219769,false,L-s-0 L-m-0 L-m-0 
job-4397,2,12,5,219711,272990,273035,53279,45,219840,false,L-l-0 L-l-0 L-m-0 L-l-0 L-l-0 
job-4398,5,10,4,219756,272990,273055,53234,65,219978,false,C-l-2 C-l-1 C-l-1 C-l-2 
job-4399,5,9,6,219807,273021,273107,53214,86,219897,false,L-m-0 C-l-0 C-m-2 C-m-0 C-l-0 C-m-1 
job-4400,3,9,8,219853,273035,273482,53182,447,220569,false,L-m-0 L-l-0 L-l-0 L-l-0 L-l-0 C-m-0 C-m-2 C-m-1 
job-4401,2,12,1,219894,273482,273498,53588,16,220007,false,L-s-0 
job-4402,1,4,4,219947,273482,273565,53535,83,220057,false,L-m-0 L-m-0 L-m-0 L-s-0 
job-4403,6,8,3,219994,273482,273575,53488,93,220160,false,L-l-0 L-l-0 C-m-0 
job-4404,6,8,8,220038,273482,273584,53444,102,220226,false,C-l-2 C-l-0 C-l-0 C-l-2 C-l-1 C-m-2 C-l-1 C-m-1 
job-4405,2,6,4,220092,273565,273629,53473,64,220183,false,C-m-1 C-m-2 L-s-0 C-m-0 
job-4406,6,12,6,220141,273584,273666,53443,82,220424,false,L-m-0 C-m-2 L-l-0 L-l-0 C-m-0 C-m-1 
job-4407,5,6,5,220191,273584,273667,53393,83,220452,false,C-l-0 C-l-1 C-l-0 C-l-2 C-l-1 
job-4408,1,8,6,220236,273667,273683,53431,16,220411,false,L-l-0 L-l-0 L-l-0 L-l-0 L-l-0 L-l-0 
job-4409,5,10,4,220293,273667,273771,53374,104,220647,false,C-m-0 C-l-0 C-l-0 L-m-0 
job-4410,2,6,7,220346,273667,273796,53321,129,220639,false,L-s-0 C-s-1 C-l-0 C-m-0 C-s-1 L-m-0 L-s-0 
job-4411,6,9,6,220408,273771,273800,53363,29,220693,false,L-m-0 L-l-0 C-l-0 C-m-1 C-m-0 L-l-0 
job-4412,6,11,4,220445,273771,273914,53326,143,220716,false,C-l-1 C-l-2 C-l-1 C-l-2 
job-4415,6,5,7,220595,273914,273936,53319,22,220892,false,C-m-1 C-l-2 C-l-1 C-m-0 C-l-1 C-l-2 L-m-0 
job-4413,4,4,2,220503,273771,273942,53268,171,220842,false,C-l-0 C-s-2 
job-4414,6,4,3,220554,273914,273986,53360,72,220771,false,L-l-0 L-l-0 C-l-0 
job-4416,4,6,6,220645,273986,274000,53341,14,220774,false,L-m-0 L-s-0 L-l-0 L-l-0 L-m-0 L-l-0 
job-4417,4,6,2,220681,273986,274144,53305,158,220995,false,C-m-0 C-m-0 
job-4418,6,4,6,220729,273986,274217,53257,231,221212,false,C-l-2 C-l-0 C-l-0 C-l-1 C-l-1 C-l-2 
job-4419,2,7,4,220786,274217,274272,53431,55,220869,false,L-m-0 L-m-0 L-m-0 L-m-0 
job-4421,6,11,5,220891,274272,274290,53381,18,221168,false,C-m-2 L-m-0 C-l-2 C-m-1 C-l-2 
job-4420,5,7,7,220836,274217,274292,53381,75,221161,false,L-l-0 C-l-1 C-l-0 C-l-0 C-l-1 L-l-0 C-m-0 
job-4422,5,6,3,220943,274290,274391,53347,101,221265,false,C-l-2 L-m-0 C-l-2 
job-4424,3,6,7,221050,274391,274412,53341,21,221155,false,L-s-0 C-l-0 C-l-0 L-m-0 C-l-0 C-l-0 L-m-0 
job-4423,5,7,2,220997,274391,274421,53394,30,221213,false,L-l-0 L-l-0 
job-4425,4,5,2,221099,274391,274534,53292,143,221423,false,C-m-0 C-m-0 
job-4426,1,12,4,221157,274534,274587,53377,53,221493,false,L-l-0 L-l-0 L-l-0 L-l-0 
job-4429,6,8,5,221268,274534,274599,53266,65,221625,false,C-m-0 C-l-2 C-l-0 C-l-2 C-l-0 
job-4428,2,7,6,221229,274534,274606,53305,72,221500,false,C-m-2 C-m-2 L-m-0 C-m-2 C-m-2 L-s-0 
job-4430,3,6,2,221316,274534,274659,53218,125,221651,false,C-m-1 C-m-1 
job-4427,3,11,2,221189,274534,274764,53345,230,221655,false,L-m-0 L-m-0 
job-4431,4,12,2,221370,274534,274777,53164,243,221834,false,C-s-2 C-s-1 
job-4432,1,12,5,221433,274764,274820,53331,56,221611,false,L-s-0 L-l-0 L-l-0 L-l-0 L-l-0 
job-4433,5,7,7,221488,274764,274902,53276,138,221781,false,L-m-0 C-l-2 C-l-1 C-l-2 C-l-0 C-l-1 C-l-0 
job-4436,4,8,2,221648,274902,274939,53254,37,221688,false,L-s-0 C-s-1 
job-4434,6,8,1,221545,274902,274951,53357,49,221829,false,L-m-0 
job-4435,4,6,3,221601,274902,274994,53301,92,221783,false,L-l-0 L-l-0 L-l-0 
job-4437,1,8,7,221694,274902,275090,53208,188,221905,false,C-l-2 L-m-0 L-m-0 C-l-2 C-l-2 C-l-2 C-l-2 
job-4438,4,10,4,221737,274902,275273,53165,371,222336,false,C-s-2 C-l-1 C-l-1 C-l-1 
job-4440,2,12,5,221845,275273,275291,53428,18,221916,false,L-m-0 C-l-0 C-l-0 C-l-0 C-l-0 
job-4439,2,12,5,221791,275273,275343,53482,70,221983,false,L-l-0 L-s-0 L-l-0 L-l-0 L-l-0 
job-4441,3,4,5,221883,275273,275348,53390,75,222218,false,C-l-1 L-m-0 L-m-0 C-l-1 C-l-1 
job-4442,3,10,4,221937,275273,275527,53336,254,222365,false,C-s-1 C-l-1 C-s-0 C-s-2 
job-4443,1,9,2,221992,275273,275810,53281,537,222713,false,C-m-0 C-m-0 
job-4445,6,5,4,222084,275810,275825,53726,15,222375,false,L-l-0 C-l-0 L-l-0 C-l-0 
job-4444,3,10,2,222038,275810,275958,53772,148,222209,false,L-m-0 L-m-0 
job-4446,5,9,2,222131,275810,275971,53679,161,222398,false,C-l-1 C-l-1 
job-4447,2,7,5,222182,275810,276066,53628,256,222440,false,C-s-2 L-m-0 C-l-1 C-s-2 L-s-0 
job-4448,6,7,3,222245,276066,276133,53821,67,222370,false,L-l-0 L-l-0 L-m-0 
job-4449,2,11,6,222296,276066,276240,53770,174,222679,false,L-s-0 C-l-0 L-m-0 C-l-0 C-l-0 C-l-0 
job-4451,2,7,8,222389,276240,276267,53851,27,222479,false,C-s-2 L-m-0 L-s-0 L-m-0 L-m-0 L-s-0 C-s-2 L-m-0 
job-4450,3,5,4,222349,276240,276297,53891,57,222638,false,L-l-0 L-l-0 L-l-0 L-l-0 
job-4453,5,6,5,222498,276240,276326,53742,86,222802,false,C-m-0 C-l-2 C-l-0 C-l-2 C-l-0 
job-4454,6,8,4,222545,276297,276432,53752,135,222752,false,L-m-0 L-l-0 L-l-0 C-m-1 
job-4455,6,7,5,222587,276432,276501,53845,69,222745,false,L-m-0 C-l-0 L-l-0 L-l-0 C-l-0 
job-4452,2,9,4,222440,276240,276555,53800,315,222797,false,C-l-1 C-l-1 C-l-1 C-l-1 
job-4456,2,4,4,222636,276432,276572,53796,140,222977,false,L-m-0 C-l-1 C-l-1 L-s-0 
job-4458,1,9,8,222735,276432,276603,53697,171,223078,false,C-m-0 C-l-2 C-l-2 C-l-2 C-l-2 C-l-2 C-m-1 C-m-1 
job-4457,1,11,3,222685,276432,276918,53747,486,223349,false,L-s-0 C-m-0 C-m-0 
job-4459,6,12,5,222782,276918,276983,54136,65,222950,false,L-m-0 C-l-0 L-l-0 L-l-0 C-l-0 
job-4462,5,10,6,222954,276983,277088,54029,105,223329,false,L-l-0 C-l-1 C-l-0 L-l-0 C-l-0 C-l-1 
job-4460,1,7,1,222851,276983,277108,54132,125,223189,false,L-s-0 
job-4461,6,5,1,222893,276983,277402,54090,419,223447,false,L-m-0 
job-4463,2,8,4,223007,277402,277470,54395,68,223362,false,L-m-0 L-m-0 L-m-0 L-m-0 
job-4465,5,9,3,223113,277402,277475,54289,73,223217,false,C-l-0 C-l-0 C-m-0 
job-4466,1,4,8,223172,277402,277568,54230,166,223340,false,L-s-0 C-l-0 C-l-0 L-s-0 C-m-0 C-m-0 C-m-0 L-s-0 
job-4464,4,11,3,223063,277402,277584,54339,182,223310,false,L-l-0 L-l-0 L-l-0 
job-4467,6,9,1,223234,277568,277627,54334,59,223453,false,L-m-0 
job-4470,3,10,8,223389,277627,277667,54238,40,223666,false,L-m-0 L-l-0 C-s-2 C-s-0 L-l-0 L-l-0 C-s-1 L-l-0 
job-4469,1,11,2,223321,277627,277669,54306,42,223492,false,L-m-0 L-m-0 
job-4468,4,11,3,223268,277568,277672,54300,104,223447,false,L-s-0 C-m-1 C-m-1 
job-4471,5,9,7,223440,277627,277688,54187,61,223697,false,C-m-0 C-l-1 C-l-0 C-l-2 C-l-1 C-l-2 C-l-0 
job-4472,6,7,5,223482,277672,277756,54190,84,223856,false,L-m-0 L-l-0 L-l-0 C-m-1 C-m-2 
job-4473,1,8,5,223536,277756,277780,54220,24,223792,false,L-l-0 L-l-0 L-l-0 L-l-0 L-l-0 
job-4474,5,12,1,223596,277756,277861,54160,105,224000,false,L-m-0 
job-4475,5,4,1,223643,277861,277880,54218,19,223868,false,L-m-0 
job-4478,4,5,7,223793,277861,278013,54068,152,224174,false,C-l-0 C-l-1 C-l-0 C-s-0 C-l-1 C-l-0 C-l-1 
job-4476,2,9,8,223692,277861,278053,54169,192,224016,false,C-s-1 L-l-0 L-s-0 L-l-0 L-l-0 L-l-0 L-l-0 L-m-0 
job-4479,2,8,3,223844,277861,278210,54017,349,224441,false,C-m-0 C-m-0 C-m-0 
job-4480,2,4,8,223888,278210,278266,54322,56,224169,false,L-s-0 L-l-0 L-l-0 L-l-0 L-l-0 L-s-0 L-l-0 L-l-0 
job-4477,4,10,1,223742,277861,278269,54119,408,224239,false,C-s-2 
job-4481,4,9,8,223942,278210,278318,54268,108,224310,false,L-m-0 C-l-0 C-l-1 C-l-1 C-l-0 C-l-1 L-m-0 C-l-0 
job-4482,5,5,8,223991,278318,278364,54327,46,224183,false,L-l-0 C-l-0 C-l-1 C-l-1 C-l-0 L-l-0 C-m-0 L-m-0 
job-4483,5,4,4,224046,278318,278371,54272,53,224188,false,C-m-1 C-l-2 C-l-2 C-m-2 
job-4484,6,12,3,224095,278364,278567,54269,203,224407,false,L-m-0 L-l-0 L-l-0 
job-4485,1,8,6,224144,278567,278601,54423,34,224245,false,L-l-0 L-l-0 L-l-0 L-l-0 L-l-0 L-l-0 
job-4487,5,7,8,224245,278567,278775,54322,208,224612,false,C-l-0 C-l-1 C-l-1 C-l-2 C-l-0 C-m-1 C-l-2 C-m-2 
job-4486,4,6,5,224202,278567,278861,54365,294,224525,false,C-m-0 L-m-0 L-s-0 C-m-0 L-m-0 
job-4488,2,7,7,224302,278861,278883,54559,22,224385,false,L-l-0 L-l-0 L-s-0 L-l-0 L-l-0 L-s-0 L-l-0 
job-4489,3,7,3,224360,278861,278883,54501,22,224651,false,C-s-1 L-m-0 L-m-0 
job-4490,4,10,7,224412,278861,278953,54449,92,224731,false,C-l-0 C-l-1 C-l-1 C-s-2 C-l-1 C-l-0 C-l-0 
job-4491,2,12,4,224453,278953,278988,54500,35,224609,false,L-l-0 L-l-0 L-l-0 L-l-0 
job-4492,6,5,8,224496,278953,279016,54457,63,224568,false,C-l-0 C-l-1 C-l-2 C-l-2 C-l-0 C-m-0 C-l-1 L-m-0 
job-4493,5,4,6,224541,279016,279128,54475,112,224917,false,L-m-0 C-l-0 C-l-0 C-m-0 L-l-0 L-l-0 
job-4494,1,4,1,224596,279128,279139,54532,11,224684,false,L-s-0 
job-4495,5,12,4,224642,279128,279180,54486,52,224887,false,L-m-0 L-l-0 L-l-0 C-m-0 
job-4499,5,7,3,224846,279180,279273,54334,93,225116,false,C-m-0 C-l-1 C-l-1 
job-4500,6,10,3,224882,279180,279282,54298,102,225189,false,C-l-2 C-m-2 C-l-2 
job-4498,5,12,4,224795,279180,279289,54385,109,225191,false,L-l-0 L-l-0 C-l-0 C-l-0 
job-4496,6,11,1,224699,279128,279292,54429,164,224913,false,C-m-1 
job-4497,1,5,8,224736,279180,279390,54444,210,225032,false,C-m-1 C-m-1 L-m-0 L-m-0 L-m-0 L-m-0 L-m-0 L-m-0 
job-4501,3,11,1,224930,279390,279402,54460,12,225156,false,L-s-0 
job-4502,3,10,7,224980,279390,279626,54410,236,225241,false,L-m-0 L-l-0 L-l-0 L-m-0 L-l-0 L-l-0 C-s-1 
job-4503,3,8,8,225020,279626,279645,54606,19,225276,false,L-l-0 L-s-0 L-l-0 C-s-2 L-l-0 L-l-0 L-m-0 L-m-0 
job-4504,5,7,7,225067,279626,279828,54559,202,225562,false,C-l-0 C-l-2 C-l-1 C-m-0 C-l-1 C-l-2 C-l-0 
job-4506,6,11,7,225149,279828,279872,54679,44,225291,false,L-m-0 C-l-0 C-l-1 L-l-0 C-l-1 L-l-0 C-l-0 
job-4507,5,11,7,225193,279872,279918,54679,46,225490,false,L-m-0 L-l-0 C-l-1 C-l-0 C-l-1 L-l-0 C-l-0 
job-4505,1,4,1,225110,279828,279925,54718,97,225361,false,L-s-0 
job-4508,1,11,6,225245,279918,279946,54673,28,225297,false,L-s-0 L-l-0 L-l-0 L-m-0 L-l-0 L-l-0 
job-4509,1,9,6,225301,279918,279971,54617,53,225583,false,L-m-0 C-l-0 L-m-0 C-l-0 C-l-0 C-l-0 
job-4510,6,9,2,225359,279918,280046,54559,128,225598,false,C-m-0 C-l-0 
job-4512,3,9,6,225456,280046,280056,54590,10,225731,false,L-m-0 C-l-0 C-l-0 L-m-0 C-l-0 C-l-0 
job-4511,5,6,2,225399,280046,280088,54647,42,225530,false,L-l-0 L-l-0 
job-4513,5,8,6,225510,280046,280089,54536,43,225739,false,C-m-1 C-l-1 C-l-2 C-m-0 C-l-1 C-l-2 
job-4514,1,9,2,225550,280089,280105,54539,16,225696,false,L-m-0 L-m-0 
job-4515,3,7,4,225600,280089,280124,54489,35,225776,false,L-l-0 L-m-0 L-l-0 L-m-0 
job-4516,1,7,4,225644,280124,280141,54480,17,225892,false,L-m-0 L-m-0 L-m-0 L-m-0 
job-4518,6,8,4,225747,280124,280163,54377,39,226038,false,C-m-2 C-l-2 C-l-2 C-m-1 
job-4517,5,8,7,225702,280124,280184,54422,60,225781,false,C-m-0 L-l-0 C-l-0 C-l-1 C-l-1 L-l-0 C-l-0 
job-4519,1,5,5,225809,280184,280194,54375,10,225986,false,L-m-0 L-m-0 L-m-0 L-m-0 L-m-0 
job-4520,2,11,8,225860,280184,280195,54324,11,226146,false,L-l-0 L-l-0 C-l-1 C-l-1 C-l-1 L-l-0 C-l-1 L-l-0 
job-4521,6,12,6,225905,280184,280309,54279,125,226317,false,C-m-0 C-l-2 C-l-0 C-m-1 C-l-0 C-l-2 
job-4522,6,5,2,225957,280309,280341,54352,32,226143,false,L-l-0 L-l-0 
job-4523,5,10,7,226018,280309,280361,54291,52,226291,false,C-l-0 C-l-1 C-l-0 C-l-2 C-l-1 C-l-2 L-m-0 
job-4524,6,9,4,226060,280341,280642,54281,301,226401,false,C-m-1 L-l-0 L-l-0 C-m-0 
job-4526,4,4,5,226140,280642,280664,54502,22,226188,false,C-m-1 C-l-1 C-l-1 C-m-1 C-l-1 
job-4525,4,4,8,226096,280642,280691,54546,49,226176,false,L-m-0 L-l-0 L-l-0 L-l-0 C-m-0 L-s-0 L-m-0 C-m-0 
job-4528,6,4,4,226252,280642,280709,54390,67,226397,false,C-l-2 C-l-0 C-l-0 C-l-2 
job-4527,2,6,4,226194,280642,280786,54448,144,226611,false,C-m-2 C-m-2 C-m-2 C-m-2 
job-4529,1,6,4,226301,280642,280842,54341,200,226692,false,C-s-1 C-s-2 C-s-2 C-s-1 
job-4530,6,7,2,226347,280842,280858,54495,16,226582,false,L-l-0 L-l-0 
job-4531,5,5,3,226388,280842,280995,54454,153,226666,false,L-m-0 C-l-0 C-l-0 
job-4532,1,9,5,226438,280995,281060,54557,65,226789,false,L-l-0 L-l-0 L-l-0 L-l-0 L-l-0 
job-4533,3,6,8,226490,280995,281265,54505,270,226945,false,L-s-0 C-l-0 C-l-0 C-l-0 C-l-0 L-m-0 C-s-1 L-m-0 
job-4536,6,5,5,226624,281265,281347,54641,82,226960,false,C-m-0 C-l-1 C-l-0 C-l-0 C-l-1 
job-4537,6,8,7,226698,281347,281395,54649,48,226837,false,C-m-0 C-l-2 C-l-0 C-l-0 C-l-1 C-l-2 C-l-1 
job-4534,1,5,7,226533,281265,281410,54732,145,226786,false,L-l-0 L-l-0 L-l-0 L-l-0 L-l-0 L-l-0 L-l-0 
job-4538,2,7,6,226741,281347,281476,54606,129,226901,false,L-m-0 L-s-0 L-s-0 C-s-2 C-m-0 C-s-2 
job-4535,5,11,2,226577,281265,281513,54688,248,227098,false,L-m-0 L-l-0 
job-4540,1,11,3,226842,281513,281542,54671,29,227033,false,L-s-0 L-m-0 L-m-0 
job-4539,6,4,1,226784,281513,281547,54729,34,226824,false,L-m-0 
job-4541,3,7,4,226898,281513,281573,54615,60,227098,false,L-l-0 L-l-0 L-l-0 L-l-0 
job-4542,6,4,8,226952,281513,281632,54561,119,227306,false,C-l-2 C-l-2 C-l-0 C-l-0 C-l-1 C-m-2 C-l-1 C-m-1 
job-4543,6,4,7,226996,281632,281657,54636,25,227313,false,L-m-0 C-l-1 C-l-0 L-l-0 C-l-0 C-l-1 L-l-0 
job-4544,5,5,6,227051,281657,281799,54606,142,227429,false,L-m-0 C-l-0 C-l-0 C-m-0 L-l-0 L-l-0 
job-4545,3,4,1,227088,281799,281812,54711,13,227396,false,L-s-0 
job-4546,2,9,4,227144,281799,282091,54655,292,227450,false,L-l-0 L-l-0 L-l-0 L-l-0 
job-4547,2,6,2,227198,282091,282198,54893,107,227601,false,L-s-0 L-s-0 
job-4549,4,8,7,227298,282198,282212,54900,14,227450,false,C-l-0 C-l-0 L-l-0 L-l-0 C-l-0 L-l-0 L-s-0 
job-4548,6,6,1,227246,282091,282243,54845,152,227681,false,L-m-0 
job-4550,6,7,8,227354,282212,282249,54858,37,227497,false,L-l-0 C-l-0 C-l-0 C-l-2 C-l-1 C-l-1 C-l-2 L-l-0 
job-4551,5,7,1,227404,282212,282285,54808,73,227503,false,C-m-0 
job-4552,3,7,1,227455,282285,282395,54830,110,227797,false,L-s-0 
job-4554,6,12,4,227553,282395,282446,54842,51,227686,false,C-l-2 C-l-0 C-l-0 C-l-2 
job-4553,3,9,8,227504,282285,282535,54781,250,227913,false,C-m-0 L-l-0 L-l-0 L-l-0 L-l-0 L-m-0 C-m-0 L-m-0 
job-4555,6,6,1,227608,282535,282567,54927,32,227891,false,L-m-0 
job-4556,4,11,4,227649,282535,282596,54886,61,227712,false,L-l-0 L-l-0 L-l-0 L-s-0 
job-4558,6,6,5,227741,282535,282600,54794,65,227939,false,C-m-1 C-l-2 C-l-0 C-l-2 C-l-0 
job-4557,2,9,3,227705,282535,282609,54830,74,228008,false,C-m-0 C-m-0 L-m-0 
job-4559,3,5,8,227792,282535,282688,54743,153,228048,false,C-s-1 C-l-1 C-l-1 C-l-1 C-l-1 C-m-2 C-m-2 C-m-0 
job-4560,3,9,8,227853,282596,282730,54743,134,228255,false,L-l-0 L-l-0 L-s-0 L-l-0 L-l-0 L-m-0 C-s-2 L-m-0 
job-4561,1,5,6,227898,282688,282819,54790,131,228060,false,L-s-0 L-m-0 L-m-0 C-s-2 C-s-0 C-s-0 
job-4562,5,8,3,227946,282688,283456,54742,768,228803,false,C-m-0 C-l-1 C-l-1 
job-4563,5,4,1,227989,283456,283472,55467,16,228072,false,L-m-0 
job-4564,6,8,4,228037,283456,283494,55419,38,228228,false,L-l-0 L-l-0 C-l-0 C-l-0 
job-4565,4,5,4,228091,283456,283838,55365,382,228503,false,L-s-0 C-l-1 C-l-1 C-l-1 
job-4568,1,10,5,228247,283838,283902,55591,64,228433,false,L-m-0 C-m-0 L-m-0 C-m-0 C-m-0 
job-4567,3,11,4,228198,283838,283946,55640,108,228333,false,L-l-0 L-l-0 L-l-0 L-l-0 
job-4566,2,5,2,228148,283838,283958,55690,120,228405,false,L-s-0 L-s-0 
job-4573,1,10,2,228496,283946,284033,55450,87,228864,false,C-m-0 C-s-1 
job-4569,4,4,7,228293,283838,284036,55545,198,228609,false,C-l-0 L-m-0 C-l-0 C-l-1 C-l-1 C-l-1 C-l-0 
job-4572,2,7,7,228436,283946,284038,55510,92,228787,false,L-m-0 C-l-2 C-m-0 C-s-0 C-s-0 L-l-0 L-m-0 
job-4570,2,10,7,228350,283838,284038,55488,200,228777,false,C-m-2 C-l-2 C-l-2 C-m-2 C-l-2 C-l-2 C-m-2 
job-4571,5,7,3,228386,283946,284045,55560,99,228709,false,C-m-0 L-l-0 L-l-0 
job-4575,4,7,8,228601,284036,284062,55435,26,228748,false,C-l-0 C-l-1 C-l-1 C-l-0 C-l-1 C-l-0 C-s-2 L-m-0 
job-4574,3,11,4,228556,284033,284070,55477,37,228839,false,L-s-0 C-m-1 C-m-1 C-s-1 
job-4576,1,12,3,228647,284045,284227,55398,182,228899,false,L-l-0 L-m-0 L-m-0 
job-4577,4,4,2,228698,284227,284521,55529,294,229066,false,L-m-0 L-m-0 
job-4578,5,9,1,228744,284521,284588,55777,67,228890,false,L-m-0 
job-4579,5,12,8,228795,284521,284804,55726,283,229188,false,C-l-2 C-l-0 C-l-0 C-l-1 C-l-1 L-l-0 C-l-2 L-l-0 
job-4580,6,7,8,228834,284804,284871,55970,67,229198,false,L-l-0 C-l-0 C-l-0 C-l-1 C-l-1 L-l-0 C-m-0 L-m-0 
job-4582,1,9,8,228927,284871,284901,55944,30,228987,false,C-s-1 L-l-0 L-l-0 L-l-0 L-l-0 L-l-0 L-s-0 L-m-0 
job-4581,1,10,2,228879,284871,284922,55992,51,229176,false,L-m-0 L-m-0 
job-4583,4,4,4,228960,284871,284971,55911,100,229251,false,C-l-0 C-l-0 C-l-0 C-s-2 
job-4585,5,4,4,229049,284971,285010,55922,39,229089,false,L-l-0 L-l-0 C-l-0 C-l-0 
job-4584,2,7,4,229008,284971,285012,55963,41,229132,false,L-m-0 L-m-0 L-m-0 L-m-0 
job-4586,2,10,7,229096,285010,285025,55914,15,229312,false,C-m-0 L-l-0 L-l-0 C-m-0 L-l-0 L-l-0 C-m-0 
job-4587,5,11,3,229158,285010,285264,55852,254,229428,false,C-m-1 C-l-0 C-l-0 
job-4588,2,8,7,229214,285264,285295,56050,31,229351,false,L-l-0 L-l-0 L-s-0 L-l-0 L-l-0 L-s-0 L-l-0 
job-4589,2,12,3,229251,285264,285394,56013,130,229626,false,C-s-1 L-m-0 L-m-0 
job-4590,6,10,1,229305,285264,285474,55959,210,229726,false,C-m-0 
job-4591,3,4,4,229369,285264,285494,55895,230,229651,false,L-m-0 C-l-2 C-l-2 C-l-2 
job-4592,2,12,8,229413,285264,285527,55851,263,229749,false,C-l-0 C-l-0 C-l-0 C-l-2 C-l-0 C-m-1 C-m-1 C-m-0 
job-4593,6,8,3,229463,285474,285535,56011,61,229709,false,L-l-0 L-l-0 C-m-0 
job-4594,5,11,7,229506,285527,285605,56021,78,229626,false,C-l-0 C-l-0 C-l-1 L-m-0 C-l-1 C-l-2 C-l-2 
job-4595,6,8,6,229555,285605,285666,56050,61,229620,false,C-m-0 C-l-0 L-l-0 L-m-0 C-l-0 L-l-0 
job-4596,2,5,8,229604,285666,285701,56062,35,229858,false,L-l-0 L-s-0 L-l-0 L-l-0 L-l-0 L-s-0 L-l-0 L-l-0 
job-4598,1,12,6,229697,285666,285751,55969,85,229967,false,C-m-0 C-l-1 C-l-1 C-m-0 C-l-1 C-l-1 
job-4597,1,8,5,229652,285666,285767,56014,101,229923,false,C-s-1 L-m-0 L-m-0 C-s-1 L-m-0 
job-4599,3,6,5,229753,285666,285856,55913,190,230102,false,L-m-0 C-l-0 C-l-0 C-l-0 C-m-0 
job-4601,2,8,8,229853,285767,285885,55914,118,230151,false,L-m-0 C-l-2 L-l-0 L-l-0 L-l-0 C-m-0 C-m-0 L-m-0 
job-4600,2,8,8,229793,285666,285887,55873,221,230067,false,C-l-2 C-s-2 C-l-2 C-l-2 C-l-0 C-l-2 C-s-2 C-l-2 
job-4603,2,9,5,229945,285887,285926,55942,39,230096,false,L-l-0 L-l-0 L-l-0 L-l-0 L-l-0 
job-4602,3,4,1,229901,285887,285966,55986,79,230078,false,L-s-0 
job-4604,3,6,6,230005,285887,286068,55882,181,230289,false,L-m-0 C-l-0 C-l-0 L-m-0 C-l-0 C-l-0 
job-4606,2,7,7,230103,286068,286185,55965,117,230283,false,L-m-0 L-l-0 C-l-1 L-s-0 L-l-0 L-l-0 L-m-0 
job-4605,1,9,7,230056,285887,286191,55831,304,230585,false,L-m-0 C-l-1 L-m-0 L-s-0 C-l-1 C-l-1 C-l-1 
job-4607,6,10,6,230153,286185,286221,56032,36,230359,false,L-l-0 L-m-0 C-l-0 C-l-0 C-l-1 L-l-0 
job-4608,2,4,6,230196,286185,286228,55989,43,230289,false,C-l-2 C-l-2 C-l-2 L-s-0 C-l-2 C-l-2 
job-4609,1,4,5,230243,286185,286303,55942,118,230496,false,C-s-0 C-l-2 C-s-0 C-s-0 C-l-2 
job-4610,1,9,3,230286,286303,286314,56017,11,230392,false,L-m-0 L-m-0 L-m-0 
job-4611,2,10,8,230347,286303,286316,55956,13,230634,false,C-m-0 L-s-0 L-l-0 L-l-0 L-l-0 L-l-0 C-m-0 C-m-0 
job-4613,5,5,7,230442,286303,286322,55861,19,230627,false,C-m-1 C-l-2 C-l-1 C-m-2 C-l-2 C-l-1 L-m-0 
job-4612,2,7,7,230389,286303,286332,55914,29,230560,false,L-l-0 C-l-0 C-l-0 C-l-0 C-l-0 C-l-0 C-l-0 
job-4614,6,9,3,230490,286322,286449,55832,127,230730,false,L-l-0 L-m-0 C-m-0 
job-4615,4,8,5,230546,286322,286574,55776,252,231001,false,L-l-0 C-l-1 C-l-1 L-s-0 C-l-1 
job-4616,4,10,8,230591,286322,286630,55731,308,231104,false,C-s-1 C-l-2 C-m-2 C-l-2 C-l-2 C-m-2 C-m-1 C-m-1 
job-4617,5,10,7,230641,286574,286696,55933,122,230881,false,L-m-0 L-l-0 C-l-0 C-l-1 C-l-0 L-l-0 C-l-1 
job-4618,5,12,7,230685,286696,286897,56011,201,230957,false,L-m-0 L-l-0 C-l-0 C-l-1 C-l-0 L-l-0 C-l-1 
job-4621,3,11,4,230853,286897,286956,56044,59,231012,false,C-l-0 C-l-0 C-l-0 C-l-0 
job-4620,2,4,7,230793,286897,286973,56104,76,231070,false,L-m-0 L-s-0 L-s-0 C-s-1 L-m-0 L-m-0 C-s-1 
job-4622,6,9,8,230890,286956,286977,56066,21,230995,false,C-l-1 C-l-2 C-l-1 C-l-2 C-l-0 C-m-1 C-l-0 C-m-0 
job-4623,2,6,1,230928,286977,287030,56049,53,231048,false,L-s-0 
job-4619,3,7,4,230729,286897,287034,56168,137,230938,false,L-l-0 L-l-0 L-l-0 L-l-0 
job-4624,3,8,7,230977,286977,287103,56000,126,231108,false,C-l-0 C-l-0 C-l-0 L-m-0 C-l-0 L-m-0 C-s-1 
job-4625,1,5,5,231031,287103,287131,56072,28,231140,false,L-m-0 L-m-0 L-m-0 L-m-0 L-m-0 
job-4626,3,11,4,231080,287103,287166,56023,63,231433,false,L-l-0 L-l-0 L-l-0 L-l-0 
job-4627,1,11,4,231130,287103,287184,55973,81,231422,false,C-l-0 C-l-0 C-l-0 C-l-0 
job-4628,6,10,5,231172,287103,287216,55931,113,231316,false,C-l-1 C-l-2 C-l-1 C-m-0 C-l-2 
job-4629,5,7,3,231212,287216,287232,56004,16,231265,false,L-l-0 L-l-0 L-m-0 
job-4630,3,6,5,231258,287216,287317,55958,101,231406,false,C-l-0 C-l-0 L-m-0 C-l-0 C-l-0 
job-4631,2,4,8,231312,287317,287360,56005,43,231417,false,L-s-0 L-l-0 L-l-0 L-l-0 L-l-0 L-s-0 L-l-0 L-l-0 
job-4632,4,5,7,231367,287317,287438,55950,121,231786,false,L-m-0 C-l-1 C-l-1 C-m-0 C-l-1 L-m-0 C-m-0 
job-4633,4,7,7,231417,287317,287625,55900,308,231853,false,C-m-1 C-m-2 C-l-0 C-m-2 C-l-0 C-l-0 C-m-1 
job-4634,4,10,8,231464,287625,287638,56161,13,231595,false,L-m-0 L-l-0 L-l-0 L-l-0 C-m-0 L-s-0 L-m-0 C-m-0 
job-4635,1,9,3,231528,287625,287867,56097,242,231845,false,C-m-1 C-m-1 C-m-1 
job-4637,2,7,6,231614,287867,287922,56253,55,231720,false,L-m-0 L-l-0 L-l-0 L-l-0 L-l-0 L-l-0 
job-4636,6,9,1,231568,287867,287957,56299,90,231691,false,L-m-0 
job-4638,6,5,4,231644,287867,287982,56223,115,231818,false,C-l-0 C-l-1 C-l-1 C-l-0 
job-4639,1,10,2,231694,287867,288253,56173,386,232296,false,L-s-0 L-l-0 
job-4641,6,11,2,231789,288253,288329,56464,76,231928,false,C-m-1 L-m-0 
job-4642,6,5,6,231836,288253,288331,56417,78,232044,false,C-l-0 C-l-1 C-l-1 C-l-2 C-l-0 C-l-2 
job-4640,1,11,4,231741,288253,288336,56512,83,232045,false,L-l-0 L-l-0 L-l-0 L-l-0 
job-4645,5,8,6,231974,288331,288430,56357,99,232084,false,C-l-2 C-l-1 C-l-0 C-l-2 C-l-1 C-l-0 
job-4643,3,7,6,231887,288253,288444,56366,191,232126,false,C-m-2 C-s-1 C-m-0 C-m-2 C-m-0 L-s-0 
job-4644,2,11,6,231929,288329,288457,56400,128,232291,false,L-m-0 C-m-1 C-m-1 C-m-0 C-m-2 L-m-0 
job-4646,6,11,6,232022,288430,288518,56408,88,232117,false,C-l-0 C-l-2 L-l-0 C-l-2 C-l-0 L-l-0 
job-4647,2,8,1,232068,288518,288546,56450,28,232125,false,L-s-0 
job-4648,4,9,1,232115,288518,288602,56403,84,232320,false,L-m-0 
job-4650,3,8,8,232230,288518,288611,56288,93,232374,false,L-l-0 C-l-1 C-l-1 C-l-1 C-l-1 L-l-0 C-s-1 L-l-0 
job-4649,2,5,4,232167,288518,288822,56351,304,232769,false,L-s-0 L-m-0 L-l-0 L-m-0 
job-4651,5,11,1,232277,288822,288850,56545,28,232531,false,L-m-0 
job-4652,5,12,2,232320,288822,288926,56502,104,232566,false,L-l-0 L-l-0 
job-4653,4,12,6,232370,288926,288936,56556,10,232578,false,L-m-0 L-s-0 L-l-0 L-l-0 L-m-0 L-l-0 
job-4654,4,8,2,232420,288926,288937,56506,11,232494,false,C-m-0 C-m-0 
job-4655,3,8,5,232477,288926,289190,56449,264,232874,false,C-s-1 C-l-1 C-l-1 C-l-1 C-l-1 
job-4656,4,12,8,232525,289190,289215,56665,25,232705,false,L-m-0 L-m-0 L-l-0 L-l-0 C-m-1 L-s-0 L-l-0 C-m-1 
job-4657,1,10,1,232574,289190,289223,56616,33,232704,false,C-s-1 
job-4658,3,6,7,232623,289190,289253,56567,63,232813,false,C-l-1 C-l-1 C-l-1 C-m-0 C-s-1 C-m-0 C-l-1 
job-4659,4,10,4,232691,289190,289331,56499,141,233121,false,C-s-2 C-l-2 C-l-2 C-l-2 
job-4660,1,9,5,232729,289331,289361,56602,30,232865,false,L-l-0 L-l-0 L-l-0 L-l-0 L-l-0 
job-4661,1,8,6,232784,289331,289430,56547,99,233069,false,L-m-0 L-s-0 L-s-0 L-m-0 L-m-0 L-m-0 
job-4662,3,11,8,232845,289331,290000,56486,669,233690,false,C-l-0 C-l-1 C-l-1 C-l-1 C-l-0 C-l-1 C-l-0 C-l-0 
job-4663,4,8,4,232887,290000,290291,57113,291,233334,false,L-l-0 L-l-0 L-s-0 L-l-0 
job-4664,1,5,4,232936,290291,290324,57355,33,232983,false,L-m-0 L-m-0 L-m-0 L-m-0 
job-4665,3,10,4,232990,290291,290385,57301,94,233303,false,L-m-0 L-l-0 L-l-0 L-l-0 
job-4666,2,9,8,233033,290385,290400,57352,15,233346,false,L-l-0 L-l-0 L-l-0 L-l-0 L-l-0 L-m-0 L-m-0 L-m-0 
job-4669,2,7,6,233170,290385,290419,57215,34,233252,false,C-l-1 C-l-1 C-l-1 C-l-1 C-l-1 C-l-1 
job-4670,4,12,5,233213,290400,290421,57187,21,233359,false,L-m-0 L-l-0 L-l-0 L-m-0 L-l-0 
job-4668,6,10,2,233132,290385,290421,57253,36,233217,false,C-l-0 C-l-0 
job-4671,2,11,8,233263,290400,290470,57137,70,233450,false,C-m-1 C-l-2 C-l-2 C-l-2 C-l-2 C-m-0 C-m-1 C-m-0 
job-4667,3,10,1,233078,290385,290514,57307,129,233275,false,L-s-0 
job-4672,2,9,4,233321,290400,290589,57079,189,233680,false,C-m-0 C-m-2 C-m-2 C-m-1 
job-4673,6,4,5,233367,290514,290610,57147,96,233469,false,L-m-0 L-l-0 L-l-0 C-m-1 C-m-0 
job-4674,4,5,2,233405,290514,290738,57109,224,233808,false,L-s-0 C-m-2 
job-4675,1,8,8,233452,290514,290753,57062,239,233808,false,C-l-0 L-m-0 C-l-0 L-m-0 C-l-0 C-l-0 C-l-0 C-l-0 
job-4676,1,10,6,233496,290738,290759,57242,21,233624,false,L-m-0 L-l-0 L-l-0 L-s-0 L-l-0 L-l-0 
job-4678,6,9,3,233591,290738,290827,57147,89,233930,false,C-m-1 C-l-1 C-l-1 
job-4677,1,9,8,233542,290738,290833,57196,95,233925,false,C-m-0 C-l-2 C-l-2 C-l-2 C-l-2 C-l-2 C-m-0 C-m-0 
job-4680,2,10,4,233695,290753,290883,57058,130,233901,false,L-m-0 C-m-2 C-m-2 C-m-2 
job-4679,2,12,7,233641,290753,290897,57112,144,233799,false,C-s-1 C-l-0 C-l-0 C-m-1 C-l-0 C-l-0 L-m-0 
job-4681,1,6,4,233748,290753,291174,57005,421,234269,false,L-s-0 C-s-2 L-l-0 C-s-2 
job-4682,5,9,3,233791,291174,291251,57383,77,233978,false,L-l-0 L-l-0 L-m-0 
job-4683,2,6,7,233844,291174,291273,57330,99,234017,false,L-s-0 L-m-0 C-m-1 C-m-1 C-m-1 C-m-1 L-l-0 
job-4684,6,10,6,233902,291174,291315,57272,141,234300,false,C-l-1 C-l-1 C-l-2 C-l-2 C-l-0 C-l-0 
job-4685,4,10,1,233953,291273,291326,57320,53,234120,false,L-s-0 
job-4686,3,12,3,234007,291315,291354,57308,39,234154,false,L-l-0 L-l-0 L-l-0 
job-4687,4,9,2,234060,291315,291672,57255,357,234466,false,L-m-0 L-m-0 
job-4689,3,7,7,234161,291672,291702,57511,30,234429,false,L-m-0 L-l-0 L-l-0 C-s-1 L-l-0 L-l-0 L-m-0 
job-4688,2,5,2,234115,291672,291727,57557,55,234229,false,L-s-0 L-s-0 
job-4690,6,12,7,234217,291672,291731,57455,59,234436,false,C-l-1 C-l-2 C-l-0 C-m-0 C-l-0 C-l-2 C-l-1 
job-4691,4,5,1,234271,291702,291743,57431,41,234413,false,L-m-0 
job-4692,5,7,4,234312,291702,291969,57390,267,234766,false,C-m-2 L-l-0 L-l-0 C-m-1 
job-4693,4,11,8,234362,291969,292051,57607,82,234629,false,L-l-0 L-m-0 L-l-0 L-m-0 C-m-1 L-s-0 L-l-0 C-m-1 
job-4696,2,4,5,234512,292051,292074,57539,23,234567,false,L-m-0 L-l-0 L-m-0 L-m-0 L-l-0 
job-4694,3,11,1,234414,292051,292078,57637,27,234484,false,L-s-0 
job-4695,1,12,1,234464,292051,292105,57587,54,234750,false,L-m-0 
job-4697,4,6,3,234550,292051,292378,57501,327,235038,false,L-l-0 C-s-1 L-l-0 
job-4698,6,6,1,234599,292378,292396,57779,18,234853,false,L-m-0 
job-4699,5,11,3,234645,292378,292411,57733,33,234762,false,L-l-0 L-l-0 C-m-0 
job-4700,6,6,5,234692,292378,292450,57686,72,234856,false,C-m-1 C-l-1 C-l-0 C-l-1 C-l-0 
job-4701,4,9,6,234750,292378,292549,57628,171,235164,false,L-s-0 C-l-2 C-m-2 C-m-2 C-l-2 C-l-2 
job-4702,1,7,7,234794,292549,292576,57755,27,235011,false,L-s-0 L-l-0 L-l-0 L-l-0 L-l-0 L-l-0 L-l-0 
job-4703,6,11,8,234836,292549,292733,57713,184,235217,false,L-m-0 C-l-2 C-l-1 C-l-2 C-l-1 C-l-0 C-l-0 C-m-0 
job-4705,3,5,7,234942,292733,292822,57791,89,235302,false,L-s-0 L-l-0 L-l-0 C-m-0 C-m-0 L-m-0 L-m-0 
job-4704,6,5,1,234884,292576,292975,57692,399,235377,false,L-l-0 
job-4707,5,10,7,235046,292975,293039,57929,64,235286,false,L-l-0 C-l-1 C-l-0 L-l-0 C-l-0 C-l-1 L-m-0 
job-4708,1,4,2,235100,293039,293071,57939,32,235280,false,L-s-0 L-m-0 
job-4706,2,11,1,234997,292975,293119,57978,144,235263,false,L-s-0 
job-4709,6,8,1,235149,293071,293239,57922,168,235352,false,L-m-0 
job-4710,1,9,2,235201,293239,293316,58038,77,235523,false,L-m-0 L-m-0 
job-4711,1,12,4,235248,293316,293341,58068,25,235498,false,L-l-0 L-l-0 L-l-0 L-l-0 
job-4713,1,10,1,235343,293341,293413,57998,72,235628,false,L-m-0 
job-4714,5,8,4,235398,293413,293431,58015,18,235519,false,L-m-0 L-l-0 L-l-0 C-m-0 
job-4712,4,5,1,235294,293316,293547,58022,231,235574,false,L-s-0 
job-4715,2,11,6,235451,293413,293694,57962,281,235841,false,L-m-0 L-l-0 C-l-0 C-m-0 C-l-0 C-l-0 
job-4716,4,8,4,235493,293694,293803,58201,109,235782,false,L-l-0 L-l-0 L-s-0 L-l-0 
job-4717,6,6,3,235548,293803,293822,58255,19,235767,false,L-l-0 L-l-0 L-m-0 
job-4718,3,9,3,235604,293803,293874,58199,71,235835,false,C-m-0 C-m-0 L-s-0 
job-4719,2,7,1,235657,293874,293890,58217,16,235913,false,L-s-0 
job-4720,4,4,5,235701,293874,294147,58173,273,236100,false,L-m-0 L-l-0 L-m-0 L-l-0 L-l-0 
job-4721,2,9,4,235748,294147,294160,58399,13,235764,false,L-l-0 L-l-0 L-l-0 L-l-0 
job-4722,4,7,3,235787,294147,294219,58360,72,235974,false,L-m-0 L-m-0 L-l-0 
job-4723,3,7,5,235838,294219,294234,58381,15,235980,false,L-l-0 L-s-0 L-l-0 L-l-0 L-l-0 
job-4724,3,10,5,235896,294219,294253,58323,34,236149,false,C-l-0 C-l-0 C-l-0 L-m-0 C-l-0 
job-4725,4,6,2,235958,294219,294358,58261,139,236356,false,C-s-1 L-m-0 
job-4726,2,10,6,236011,294358,294371,58347,13,236088,false,L-m-0 L-l-0 L-l-0 L-m-0 L-l-0 L-l-0 
job-4727,6,6,5,236056,294358,294801,58302,443,236605,false,C-m-0 C-l-2 C-l-0 C-l-0 C-l-2 
job-4728,5,7,5,236105,294801,295069,58696,268,236409,false,L-l-0 L-l-0 C-l-0 L-m-0 C-l-0 
job-4729,2,12,5,236155,295069,295079,58914,10,236414,false,L-l-0 L-s-0 L-l-0 L-l-0 L-l-0 
job-4730,3,5,6,236212,295069,295085,58857,16,236388,false,L-m-0 C-l-0 C-l-0 L-m-0 C-l-0 C-l-0 
job-4731,2,12,4,236272,295069,295177,58797,108,236386,false,C-l-1 L-m-0 C-l-1 C-l-1 
job-4732,1,12,3,236322,295069,295232,58747,163,236546,false,C-m-0 C-m-0 C-l-1 
job-4733,4,7,5,236368,295177,295253,58809,76,236665,false,L-m-0 C-l-1 L-m-0 C-m-0 C-l-1 
job-4734,4,4,2,236420,295177,295322,58757,145,236658,false,L-l-0 L-l-0 
job-4735,6,4,7,236466,295253,295370,58787,117,236734,false,C-l-0 C-l-2 C-l-1 L-m-0 C-l-0 C-l-1 C-l-2 
job-4736,3,5,3,236509,295322,295380,58813,58,236679,false,L-l-0 L-l-0 L-l-0 
job-4737,4,9,6,236554,295370,295395,58816,25,236705,false,L-m-0 C-l-0 C-l-0 L-s-0 C-l-0 L-m-0 
job-4739,6,12,2,236646,295370,295417,58724,47,236931,false,C-l-1 C-l-1 
job-4740,3,9,1,236689,295380,295478,58691,98,236882,false,L-l-0 
job-4738,4,10,1,236599,295370,295483,58771,113,236768,false,C-s-1 
job-4741,6,12,6,236744,295380,295505,58636,125,236945,false,C-m-0 C-m-2 C-l-2 C-m-1 C-l-2 L-l-0 
job-4742,5,5,8,236781,295505,295641,58724,136,237131,false,L-l-0 C-l-0 C-l-1 C-l-1 C-l-0 L-l-0 C-m-0 L-m-0 
job-4744,3,8,6,236883,295641,295773,58758,132,237196,false,L-m-0 L-l-0 L-l-0 L-m-0 L-l-0 L-l-0 
job-4743,2,8,2,236832,295641,295989,58809,348,237375,false,L-s-0 L-s-0 
job-4745,1,12,2,236934,295989,296000,59055,11,237129,false,L-m-0 L-m-0 
job-4748,4,8,5,237085,296000,296059,58915,59,237196,false,L-m-0 C-l-1 C-l-1 L-m-0 C-l-1 
job-4746,6,11,4,236980,295989,296085,59009,96,237315,false,L-l-0 C-l-0 C-l-0 L-l-0 
job-4747,2,6,1,237029,296000,296166,58971,166,237298,false,L-s-0 
job-4749,1,8,6,237131,296166,296177,59035,11,237215,false,L-l-0 L-l-0 L-l-0 L-l-0 L-l-0 L-l-0 
job-4750,4,4,4,237183,296166,296190,58983,24,237262,false,C-s-1 L-m-0 L-s-0 L-m-0 
job-4751,5,9,2,237246,296166,296425,58920,259,237798,false,C-l-0 C-l-0 
job-4752,3,12,7,237281,296425,296475,59144,50,237578,false,L-s-0 L-l-0 L-l-0 L-m-0 L-l-0 L-l-0 L-m-0 
job-4753,1,5,5,237324,296425,296498,59101,73,237558,false,C-s-1 C-s-1 L-m-0 C-s-2 C-s-1 
job-4754,2,6,4,237369,296498,296515,59129,17,237462,false,L-m-0 L-m-0 L-m-0 L-m-0 
job-4756,5,4,2,237455,296498,296572,59043,74,237802,false,C-l-0 C-l-0 
job-4755,2,8,8,237420,296498,296765,59078,267,237692,false,L-l-0 L-l-0 L-s-0 L-l-0 L-l-0 L-s-0 L-l-0 L-l-0 
job-4757,6,10,3,237510,296765,296787,59255,22,237620,false,L-l-0 L-l-0 L-m-0 
job-4759,6,10,4,237595,296787,296853,59192,66,237712,false,L-m-0 L-l-0 L-l-0 C-m-1 
job-4758,6,9,7,237550,296765,296858,59215,93,237712,false,C-l-0 C-l-1 C-l-1 C-m-0 C-l-2 C-l-2 C-l-0 
job-4760,3,4,8,237652,296853,296863,59201,10,237889,false,L-s-0 L-l-0 L-l-0 L-l-0 L-l-0 L-m-0 C-s-1 L-m-0 
job-4761,1,7,4,237702,296863,297000,59161,137,237914,false,L-m-0 L-m-0 L-m-0 L-m-0 
job-4763,5,7,7,237819,297000,297034,59181,34,237948,false,L-m-0 C-l-0 C-l-1 C-l-2 C-l-0 C-l-1 C-l-2 
job-4762,6,9,3,237762,296863,297066,59101,203,238196,false,L-l-0 L-l-0 C-m-0 
job-4765,1,11,1,237910,297066,297081,59156,15,238118,false,L-m-0 
job-4764,1,4,2,237868,297066,297102,59198,36,238133,false,L-s-0 L-s-0 
job-4767,3,10,7,238007,297102,297112,59095,10,238252,false,L-l-0 L-l-0 L-m-0 C-m-1 L-l-0 L-l-0 C-m-1 
job-4768,2,12,8,238058,297102,297112,59044,10,238316,false,C-l-0 C-m-1 C-l-1 C-l-0 C-l-1 C-l-1 C-l-0 C-l-1 
job-4766,1,4,6,237954,297081,297138,59127,57,238218,false,L-m-0 L-s-0 L-s-0 L-m-0 L-m-0 L-m-0 
job-4769,6,12,4,238114,297102,297139,58988,37,238339,false,C-l-2 C-l-2 C-l-0 C-m-0 
job-4770,4,4,1,238155,297102,297155,58947,53,238221,false,C-s-1 
job-4771,3,4,3,238209,297102,297161,58893,59,238431,false,C-s-2 C-m-2 C-m-2 
job-4772,2,9,7,238251,297138,297178,58887,40,238515,false,C-m-2 C-l-0 C-l-0 C-m-0 C-l-0 L-m-0 L-m-0 
job-4773,4,4,8,238305,297138,297179,58833,41,238550,false,C-l-1 L-m-0 C-l-1 L-l-0 C-l-1 L-l-0 L-s-0 L-l-0 
job-4774,5,7,6,238356,297161,297246,58805,85,238622,false,C-m-0 C-l-2 C-l-2 C-m-2 C-l-0 C-m-1 
job-4776,5,5,4,238441,297246,297390,58805,144,238724,false,C-m-0 L-l-0 L-l-0 L-m-0 
job-4775,4,7,3,238401,297161,297490,58760,329,238745,false,C-s-0 C-s-1 C-s-2 
job-4777,4,9,1,238506,297490,297539,58984,49,238737,false,L-s-0 
job-4779,6,12,4,238609,297539,297563,58930,24,238640,false,C-l-0 C-l-0 C-l-1 C-l-1 
job-4778,3,7,8,238563,297490,297609,58927,119,238839,false,L-m-0 L-l-0 L-l-0 L-l-0 L-l-0 C-m-0 C-m-0 L-m-0 
job-4780,5,7,4,238656,297539,297978,58883,439,239254,false,C-m-2 C-l-2 C-l-2 C-m-1 
job-4783,6,11,3,238818,297978,298037,59160,59,239038,false,L-m-0 C-l-0 C-l-0 
job-4781,6,5,2,238706,297978,298081,59272,103,238921,false,L-l-0 L-l-0 
job-4782,3,6,1,238760,297978,298397,59218,419,239219,false,L-s-0 
job-4785,5,6,3,238919,298397,298489,59478,92,239022,false,L-l-0 L-m-0 L-l-0 
job-4784,2,11,1,238864,298397,298501,59533,104,238995,false,L-s-0 
job-4786,3,11,7,238967,298397,298783,59430,386,239441,false,C-s-1 C-l-0 C-l-0 C-s-0 C-l-0 C-l-0 L-m-0 
job-4787,4,7,6,239016,298783,298853,59767,70,239110,false,L-m-0 L-s-0 L-l-0 L-l-0 L-m-0 L-l-0 
job-4788,2,4,3,239062,298783,298890,59721,107,239179,false,C-m-0 C-m-0 C-m-0 
job-4789,2,7,2,239115,298890,298912,59775,22,239432,false,L-s-0 L-s-0 
job-4790,6,8,7,239167,298890,299066,59723,176,239610,false,L-l-0 C-l-1 C-l-0 L-m-0 C-l-1 C-l-0 L-l-0 
job-4791,4,9,8,239223,298890,299082,59667,192,239569,false,C-s-1 C-l-2 C-l-2 C-l-2 C-m-1 C-m-2 C-m-1 C-m-2 
job-4793,6,12,7,239324,299066,299197,59742,131,239471,false,L-l-0 C-l-1 C-l-0 L-m-0 C-l-0 C-l-1 L-l-0 
job-4792,1,6,3,239275,298890,299346,59615,456,240028,false,C-s-2 L-m-0 L-m-0 
job-4795,5,8,6,239445,299346,299473,59901,127,239866,false,C-l-0 C-l-2 L-l-0 C-l-0 C-l-2 L-l-0 
job-4794,2,6,4,239395,299346,299477,59951,131,239603,false,L-m-0 L-m-0 L-m-0 L-m-0 
job-4798,4,12,6,239599,299473,299535,59874,62,239812,false,C-m-1 C-l-0 C-l-0 C-m-1 C-l-0 L-l-0 
job-4797,1,11,3,239537,299473,299586,59936,113,239866,false,L-l-0 L-l-0 L-l-0 
job-4796,1,5,3,239494,299473,299756,59979,283,240044,false,L-s-0 L-s-0 L-s-0 
job-4799,6,8,1,239651,299756,299779,60105,23,239689,false,L-m-0 
job-4801,4,7,4,239752,299756,299815,60004,59,240080,false,L-s-0 C-l-0 C-l-0 C-l-0 
job-4802,5,8,2,239800,299756,299831,59956,75,239999,false,C-l-1 C-l-1 
job-4803,3,6,2,239846,299756,299849,59910,93,240208,false,C-m-0 C-m-0 
job-4804,5,8,5,239906,299779,299911,59873,132,240154,false,L-m-0 C-l-2 C-m-2 C-m-1 C-l-2 
job-4805,1,10,7,239968,299911,300006,59943,95,240101,false,L-m-0 L-l-0 L-m-0 L-m-0 C-s-1 L-l-0 L-s-0 
job-4800,5,8,2,239705,299756,300011,60051,255,240204,false,L-l-0 L-l-0 
job-4806,5,4,8,240013,299911,300165,59898,254,240506,false,C-m-1 C-l-2 C-l-1 C-l-2 C-l-1 C-l-0 C-l-0 C-m-0 
job-4807,1,12,7,240065,300165,300226,60100,61,240164,false,L-s-0 L-l-0 L-l-0 L-m-0 L-l-0 L-l-0 L-m-0 
job-4809,3,10,4,240151,300165,300427,60014,262,240691,false,C-l-0 C-l-0 C-l-0 C-l-0 
job-4808,2,10,3,240113,300165,300446,60052,281,240486,false,C-m-0 C-m-0 C-m-0 
job-4810,1,10,7,240206,300427,300488,60221,61,240405,false,L-m-0 L-m-0 L-l-0 L-l-0 L-l-0 L-l-0 L-m-0 
job-4811,1,7,4,240257,300427,300574,60170,147,240501,false,L-s-0 L-l-0 C-s-1 L-s-0 
job-4812,4,11,1,240296,300574,300602,60278,28,240617,false,L-s-0 
job-4813,2,10,4,240346,300574,300635,60228,61,240461,false,L-l-0 L-l-0 L-l-0 L-l-0 
job-4814,4,10,8,240396,300574,300747,60178,173,240672,false,C-l-1 C-l-0 C-l-0 C-l-0 C-l-1 L-m-0 C-l-1 L-m-0 
job-4815,6,12,7,240447,300747,300787,60300,40,240531,false,L-m-0 C-l-0 C-l-1 L-l-0 C-l-0 C-l-1 L-l-0 
job-4817,3,4,2,240535,300787,300799,60252,12,240565,false,L-m-0 L-m-0 
job-4816,2,5,1,240496,300787,300821,60291,34,240532,false,L-s-0 
job-4818,6,8,6,240591,300787,300851,60196,64,240893,false,L-l-0 C-l-0 C-l-1 L-l-0 C-l-0 C-l-1 
job-4819,2,7,3,240652,300851,300863,60199,12,240886,false,L-m-0 L-m-0 L-m-0 
job-4820,1,11,2,240704,300851,300901,60147,50,240859,false,L-s-0 L-m-0 
job-4821,1,7,4,240755,300851,300908,60096,57,240965,false,L-l-0 L-l-0 L-l-0 L-l-0 
job-4822,1,6,2,240807,300908,301027,60101,119,240950,false,L-s-0 L-s-0 
job-4823,1,5,2,240851,301027,301050,60176,23,241078,false,L-s-0 L-s-0 
job-4824,6,7,1,240906,301027,301203,60121,176,241327,false,L-m-0 
job-4825,1,5,6,240951,301203,301263,60252,60,241238,false,L-m-0 L-m-0 L-m-0 L-m-0 L-m-0 L-m-0 
job-4826,6,4,3,241004,301203,301264,60199,61,241118,false,L-l-0 L-l-0 C-m-0 
job-4827,3,11,8,241054,301203,301293,60149,90,241208,false,C-l-0 C-l-1 C-l-0 C-l-0 C-l-1 C-l-0 C-l-1 C-l-1 
job-4828,1,5,2,241099,301264,301603,60165,339,241658,false,L-s-0 L-s-0 
job-4829,3,12,6,241134,301603,301629,60469,26,241181,false,L-m-0 L-l-0 L-l-0 L-l-0 L-m-0 L-l-0 
job-4831,6,7,3,241231,301603,301658,60372,55,241394,false,C-m-0 C-l-1 C-l-1 
job-4830,4,11,5,241193,301603,301686,60410,83,241446,false,L-s-0 C-l-2 C-l-2 C-s-1 C-l-2 
job-4832,5,9,5,241278,301686,301697,60408,11,241318,false,L-l-0 L-l-0 C-l-0 L-m-0 C-l-0 
job-4833,4,12,7,241338,301686,301740,60348,54,241668,false,L-s-0 C-l-1 C-l-1 C-s-1 C-l-1 C-s-2 C-s-0 
job-4834,6,8,5,241385,301686,301828,60301,142,241621,false,C-m-0 C-l-2 C-m-2 C-m-1 C-l-2 
job-4835,6,8,3,241439,301828,301854,60389,26,241632,false,L-l-0 L-l-0 L-m-0 
job-4836,3,8,8,241490,301828,301892,60338,64,241573,false,C-l-0 C-l-1 C-l-0 C-l-1 C-l-1 C-l-0 C-l-0 C-l-1 
job-4837,6,5,5,241533,301892,301913,60359,21,241769,false,L-m-0 C-l-0 L-l-0 L-l-0 C-l-0 
job-4838,4,11,2,241583,301892,301942,60309,50,241652,false,L-s-0 C-s-2 
job-4839,4,12,8,241623,301892,301985,60269,93,241979,false,C-l-1 C-l-2 C-l-1 C-l-2 C-l-1 C-m-0 C-l-2 C-m-0 
job-4840,3,10,2,241675,301892,302030,60217,138,241888,false,C-m-1 C-m-1 
job-4841,3,6,5,241720,302030,302056,60310,26,241894,false,L-s-0 L-l-0 L-l-0 L-l-0 L-l-0 
job-4842,2,8,3,241783,302030,302065,60247,35,241895,false,L-m-0 L-m-0 L-m-0 
job-4843,5,11,1,241836,302030,302072,60194,42,241900,false,C-m-0 
job-4844,6,8,1,241889,302030,302187,60141,157,242119,false,C-m-1 
job-4845,2,12,4,241932,302030,302259,60098,229,242248,false,C-m-0 C-m-2 C-m-2 C-m-1 
job-4846,2,11,1,241980,302259,302285,60279,26,242287,false,L-s-0 
job-4847,6,12,8,242023,302259,302400,60236,141,242264,false,L-l-0 C-l-1 C-l-2 C-l-2 C-l-1 L-l-0 C-m-0 L-m-0 
job-4848,2,12,6,242068,302259,302461,60191,202,242521,false,C-l-0 C-l-0 C-m-0 C-l-0 C-l-0 L-m-0 
job-4849,2,5,5,242108,302461,302511,60353,50,242275,false,L-l-0 L-l-0 L-l-0 L-l-0 L-l-0 
job-4851,4,11,5,242228,302461,302524,60233,63,242526,false,C-m-0 C-l-1 C-l-1 C-m-0 C-l-1 
job-4850,1,9,6,242163,302461,302632,60298,171,242453,false,L-l-0 L-m-0 L-l-0 L-m-0 L-m-0 L-s-0 
job-4853,4,11,3,242333,302632,302675,60299,43,242397,false,L-l-0 L-l-0 L-l-0 
job-4852,1,6,1,242281,302632,302701,60351,69,242365,false,L-s-0 
job-4854,4,7,1,242384,302632,302791,60248,159,242571,false,L-m-0 
job-4857,3,4,5,242532,302791,302813,60259,22,242847,false,C-l-0 C-l-0 C-l-0 L-m-0 C-l-0 
job-4856,6,11,2,242470,302701,302815,60231,114,242683,false,L-l-0 L-l-0 
job-4855,4,8,6,242426,302632,302822,60206,190,242657,false,C-m-0 L-m-0 C-l-1 C-m-0 C-l-1 C-l-1 
job-4859,2,10,5,242624,302791,302924,60167,133,242845,false,C-s-1 C-l-2 C-l-2 C-l-2 C-l-2 
job-4861,5,4,6,242712,302815,302933,60103,118,242942,false,C-m-2 C-l-0 L-l-0 C-m-1 C-l-0 L-l-0 
job-4860,2,10,1,242672,302791,302938,60119,147,242834,false,C-s-0 
job-4858,1,5,4,242586,302791,302955,60205,164,242865,false,L-s-0 L-m-0 L-s-0 L-s-0 
job-4862,6,12,7,242751,302933,303115,60182,182,242976,false,C-l-0 C-l-1 L-l-0 C-l-1 C-l-0 L-l-0 L-m-0 
job-4863,6,7,8,242815,303115,303406,60300,291,243186,false,L-l-0 C-l-0 C-l-0 C-l-1 C-l-1 L-l-0 C-m-0 L-m-0 
job-4865,3,7,6,242910,303406,303512,60496,106,243165,false,L-m-0 C-l-0 C-l-0 L-m-0 C-l-0 C-l-0 
job-4866,6,11,8,242957,303512,303559,60555,47,243278,false,C-l-1 C-l-0 C-l-2 C-l-1 C-l-0 C-l-2 C-m-1 L-m-0 
job-4864,2,6,5,242858,303406,303563,60548,157,243208,false,L-l-0 L-l-0 L-l-0 L-l-0 L-l-0 
job-4867,2,5,1,243007,303563,303888,60556,325,243491,false,L-s-0 
job-4868,1,12,1,243054,303888,303918,60834,30,243116,false,L-s-0 
job-4871,5,7,3,243195,303888,303920,60693,32,243421,false,C-m-1 C-l-1 C-l-1 
job-4870,5,8,5,243143,303888,303929,60745,41,243242,false,L-l-0 L-l-0 C-l-0 C-m-0 C-l-0 
job-4872,3,8,1,243259,303929,303967,60670,38,243414,false,L-s-0 
job-4873,1,11,1,243304,303929,303967,60625,38,243511,false,L-l-0 
job-4869,2,7,4,243097,303888,303968,60791,80,243255,false,L-m-0 L-m-0 L-m-0 L-m-0 
job-4874,1,8,2,243359,303967,304097,60608,130,243752,false,L-s-0 L-s-0 
job-4875,3,12,2,243420,304097,304115,60677,18,243636,false,L-m-0 L-m-0 
job-4876,4,8,3,243474,304097,304128,60623,31,243673,false,L-l-0 L-l-0 L-l-0 
job-4878,5,5,8,243585,304115,304182,60530,67,243950,false,C-m-2 C-l-2 C-l-0 C-l-2 C-l-0 L-m-0 C-m-1 C-m-0 
job-4879,6,12,3,243644,304182,304285,60538,103,243927,false,L-m-0 L-l-0 L-l-0 
job-4877,3,11,6,243533,304097,304307,60564,210,243993,false,L-s-0 C-l-1 C-l-1 C-s-1 C-l-1 C-l-1 
job-4880,5,12,5,243694,304182,304393,60488,211,243983,false,C-l-2 C-l-2 C-l-0 C-m-0 C-l-0 
job-4881,3,11,7,243749,304393,304410,60644,17,243859,false,L-s-0 L-l-0 L-l-0 L-m-0 L-l-0 L-l-0 L-m-0 
job-4882,5,9,3,243798,304393,304554,60595,161,244161,false,C-l-0 C-l-0 C-m-0 
job-4883,5,7,7,243847,304410,304569,60563,159,244140,false,C-l-2 L-l-0 C-l-1 C-l-2 C-l-1 L-l-0 L-m-0 
job-4884,5,11,6,243900,304569,304652,60669,83,243986,false,L-m-0 L-l-0 C-l-0 C-m-0 C-l-0 L-l-0 
job-4886,4,8,8,243986,304569,304673,60583,104,244104,false,C-l-2 C-l-2 C-l-1 C-l-1 C-l-1 C-m-1 C-l-2 C-m-1 
job-4885,4,6,2,243945,304569,304686,60624,117,244105,false,L-s-0 C-s-1 
job-4887,3,7,5,244038,304673,304690,60635,17,244251,false,L-l-0 L-m-0 L-m-0 L-l-0 L-l-0 
job-4889,6,9,5,244133,304673,304853,60540,180,244478,false,C-m-0 C-l-1 C-l-0 C-l-0 C-l-1 
job-4888,4,4,1,244088,304673,304918,60585,245,244373,false,C-s-2 
job-4892,2,4,8,244284,304853,304920,60569,67,244540,false,L-s-0 C-l-1 C-l-1 C-l-1 C-l-1 C-l-1 C-l-1 C-s-1 
job-4890,2,12,8,244184,304853,304923,60669,70,244498,false,C-s-1 L-l-0 L-l-0 L-s-0 L-l-0 L-m-0 L-l-0 L-m-0 
job-4891,2,6,7,244237,304853,304924,60616,71,244367,false,C-l-0 C-l-0 L-m-0 C-l-0 C-l-0 C-l-0 C-l-0 
job-4893,6,6,7,244336,304920,305329,60584,409,244868,false,C-m-2 C-l-1 C-l-2 C-m-1 C-l-1 C-l-2 C-m-0 
job-4894,5,7,5,244392,305329,305556,60937,227,244690,false,L-l-0 L-l-0 C-l-0 L-m-0 C-l-0 
job-4896,3,11,7,244506,305556,305568,61050,12,244574,false,L-m-0 L-l-0 L-l-0 L-m-0 L-l-0 L-l-0 C-s-1 
job-4897,3,11,5,244550,305556,305639,61006,83,244650,false,C-l-0 C-l-0 C-l-0 C-s-2 C-l-0 
job-4895,1,7,1,244451,305556,305643,61105,87,244633,false,L-s-0 
job-4898,6,5,3,244596,305639,305652,61043,13,244637,false,L-l-0 L-m-0 L-l-0 
job-4899,4,4,7,244654,305639,305660,60985,21,244812,false,C-l-0 C-l-1 C-l-0 C-l-1 C-l-0 C-l-1 C-s-1 
job-4900,1,11,2,244700,305652,305706,60952,54,244765,false,L-m-0 L-m-0 
job-4902,3,10,3,244794,305652,305733,60858,81,245151,false,C-l-2 C-l-2 C-l-2 
job-4901,2,9,8,244747,305652,305787,60905,135,245066,false,L-l-0 L-l-0 L-l-0 L-s-0 L-l-0 L-l-0 C-s-2 L-m-0 
job-4904,1,11,6,244884,305787,305818,60903,31,245120,false,L-l-0 L-m-0 L-m-0 L-l-0 L-l-0 L-l-0 
job-4903,3,5,2,244847,305787,305852,60940,65,245033,false,L-m-0 L-m-0 
job-4905,1,6,6,244930,305787,305875,60857,88,245027,false,L-s-0 C-m-0 C-m-0 C-m-0 C-m-0 C-m-0 
job-4906,2,6,2,244975,305852,305897,60877,45,245203,false,L-s-0 L-m-0 
job-4907,3,9,4,245039,305852,305903,60813,51,245386,false,L-l-0 L-m-0 L-l-0 L-m-0 
job-4908,5,6,7,245088,305852,306055,60764,203,245556,false,L-l-0 C-l-2 C-l-1 C-l-2 C-l-0 C-l-1 C-l-0 
job-4909,6,9,1,245138,306055,306115,60917,60,245269,false,L-m-0 
job-4910,4,9,1,245196,306055,306333,60859,278,245739,false,L-s-0 
job-4912,4,10,3,245291,306333,306355,61042,22,245589,false,L-s-0 L-m-0 L-m-0 
job-4911,1,6,7,245243,306333,306370,61090,37,245306,false,L-l-0 L-l-0 L-l-0 L-l-0 L-l-0 L-l-0 L-l-0 
job-4913,5,5,8,245330,306333,306375,61003,42,245421,false,C-m-0 C-l-1 C-l-0 C-l-2 C-l-1 C-l-2 C-l-0 L-l-0 
job-4916,6,10,8,245476,306375,306446,60899,71,245704,false,L-l-0 C-l-0 C-l-0 C-l-2 C-l-1 C-l-1 C-l-2 L-l-0 
job-4918,2,5,8,245585,306375,306458,60790,83,245943,false,C-m-0 C-m-2 C-m-2 C-m-0 C-m-2 C-s-1 C-m-0 C-m-2 
job-4914,2,6,2,245384,306375,306489,60991,114,245662,false,L-s-0 L-s-0 
job-4919,4,12,6,245638,306489,306511,60851,22,245857,false,L-s-0 L-l-0 L-l-0 C-m-0 C-m-0 L-l-0 
job-4915,3,5,2,245430,306375,306513,60945,138,245644,false,L-m-0 L-m-0 
job-4917,2,5,6,245526,306375,306525,60849,150,245720,false,C-s-1 L-m-0 C-m-1 C-m-1 C-m-1 C-m-1 
job-4920,2,7,4,245687,306489,306707,60802,218,246025,false,C-m-2 C-s-1 C-m-2 C-m-2 
job-4921,2,7,6,245737,306489,306777,60752,288,246241,false,C-l-0 C-l-0 C-m-2 C-l-0 C-l-0 C-l-0 
job-4922,2,9,6,245785,306707,306809,60922,102,245946,false,C-m-2 L-m-0 C-l-0 L-m-0 C-m-2 L-m-0 
job-4923,5,11,7,245845,306707,307047,60862,340,246413,false,C-m-0 L-l-0 C-l-1 C-l-2 C-l-1 L-l-0 C-l-2 
job-4926,6,8,5,246007,307047,307059,61040,12,246096,false,C-l-1 C-l-0 C-l-1 C-m-0 C-l-0 
job-4927,2,9,8,246057,307047,307088,60990,41,246246,false,C-m-0 C-l-2 C-l-2 L-s-0 C-l-2 C-l-2 C-l-2 L-m-0 
job-4925,6,6,1,245952,307047,307092,61095,45,246192,false,L-m-0 
job-4924,6,8,2,245901,307047,307103,61146,56,246219,false,L-l-0 L-l-0 
job-4928,5,10,1,246097,307088,307108,60991,20,246206,false,C-m-0 
job-4929,5,5,4,246152,307088,307225,60936,137,246473,false,C-l-0 C-l-2 C-l-0 C-l-2 
job-4930,1,11,3,246192,307225,307298,61033,73,246418,false,L-l-0 L-l-0 L-l-0 
job-4931,4,12,1,246246,307298,307374,61052,76,246348,false,L-s-0 
job-4932,6,10,6,246295,307298,307406,61003,108,246604,false,L-m-0 C-l-1 L-l-0 C-m-0 C-l-1 L-l-0 
job-4933,6,8,8,246335,307406,307454,61071,48,246467,false,L-l-0 C-l-0 C-l-0 C-l-1 C-l-1 L-l-0 C-m-0 L-m-0 
job-4935,5,12,1,246419,307406,307454,60987,48,246640,false,C-m-1 
job-4934,2,8,3,246383,307406,307484,61023,78,246600,false,L-s-0 C-m-0 L-m-0 
job-4936,2,5,3,246466,307406,307559,60940,153,246627,false,L-s-0 C-s-1 C-m-1 
job-4938,6,6,4,246559,307559,307593,61000,34,246703,false,L-m-0 L-l-0 L-l-0 C-m-0 
job-4937,1,6,1,246514,307559,307662,61045,103,246744,false,L-s-0 
job-4939,6,9,7,246598,307559,307798,60961,239,247034,false,C-l-0 C-l-0 C-l-1 C-m-1 C-l-1 C-l-2 C-l-2 
job-4940,6,11,6,246665,307798,307959,61133,161,247118,false,C-m-0 C-l-0 L-l-0 L-m-0 C-l-0 L-l-0 
job-4944,6,6,6,246863,307959,307974,61096,15,247126,false,C-l-0 C-l-0 C-l-1 C-l-2 C-l-2 C-l-1 
job-4945,4,9,5,246919,307959,307985,61040,26,247171,false,C-m-0 C-s-1 C-m-0 C-m-2 C-m-2 
job-4941,4,9,1,246722,307959,307996,61237,37,246982,false,L-s-0 
job-4943,3,10,6,246825,307959,308021,61134,62,247105,false,L-l-0 L-l-0 L-l-0 L-m-0 L-l-0 L-m-0 
job-4942,1,11,1,246777,307959,308033,61182,74,247017,false,L-m-0 
job-4946,1,7,2,246980,307959,308295,60979,336,247512,false,C-s-2 C-s-2 
job-4947,5,5,1,247037,308295,308349,61258,54,247091,false,L-m-0 
job-4949,5,7,1,247130,308295,308352,61165,57,247407,false,C-m-1 
job-4948,6,7,3,247089,308295,308372,61206,77,247421,false,L-l-0 L-l-0 C-m-0 
job-4950,4,12,1,247183,308295,308407,61112,112,247341,false,L-s-0 
job-4951,6,12,4,247230,308295,308476,61065,181,247664,false,C-l-0 C-l-1 C-l-1 C-l-0 
job-4952,1,6,4,247281,308476,308533,61195,57,247464,false,L-m-0 L-m-0 L-m-0 L-m-0 
job-4953,2,9,4,247333,308476,308564,61143,88,247499,false,L-l-0 L-l-0 L-l-0 L-l-0 
job-4954,6,4,5,247377,308476,308836,61099,360,247934,false,C-m-0 C-l-2 C-l-2 C-l-0 C-l-0 
job-4955,6,5,4,247437,308836,308846,61399,10,247603,false,L-m-0 L-l-0 L-l-0 C-m-0 
job-4956,2,12,7,247503,308836,308883,61333,47,247847,false,C-m-0 C-l-0 C-l-0 L-m-0 C-l-0 C-l-0 L-s-0 
job-4957,6,6,5,247539,308836,308933,61297,97,247670,false,C-l-1 C-l-2 C-l-1 C-m-1 C-l-2 
job-4958,4,6,7,247589,308846,309025,61257,179,247810,false,L-m-0 L-l-0 L-l-0 C-m-0 L-l-0 C-m-2 C-m-2 
job-4959,4,12,5,247637,308883,309033,61246,150,248062,false,C-s-1 L-m-0 L-s-0 C-s-0 C-m-0 
job-4960,5,12,7,247687,308933,309054,61246,121,247893,false,C-l-0 C-l-2 C-l-1 C-m-1 C-l-1 C-l-0 C-l-2 
job-4962,6,12,4,247802,309054,309082,61252,28,247987,false,L-m-0 L-l-0 L-l-0 C-m-0 
job-4963,2,7,2,247854,309082,309148,61228,66,248041,false,L-s-0 L-m-0 
job-4961,1,6,1,247757,309054,309201,61297,147,248029,false,L-s-0 
job-4964,2,7,4,247900,309082,309253,61182,171,248269,false,L-m-0 L-m-0 L-l-0 L-m-0 
job-4966,6,4,2,247998,309253,309275,61255,22,248258,false,L-l-0 L-l-0 
job-4967,2,8,5,248044,309253,309307,61209,54,248167,false,L-m-0 L-m-0 L-m-0 L-m-0 L-s-0 
job-4965,1,5,1,247947,309253,309323,61306,70,248300,false,L-s-0 
job-4968,3,12,6,248103,309253,309329,61150,76,248468,false,C-m-2 C-l-0 C-l-0 C-m-2 C-l-0 C-l-0 
job-4969,6,6,4,248140,309253,309338,61113,85,248489,false,C-l-1 C-l-2 C-l-1 C-l-2 
job-4973,4,10,8,248351,309329,309415,60978,86,248494,false,C-l-0 L-l-0 C-l-0 C-l-0 C-m-0 C-m-1 C-m-1 C-m-0 
job-4970,1,8,1,248199,309329,309441,61130,112,248466,false,L-s-0 
job-4974,5,9,2,248409,309415,309454,61006,39,248666,false,C-l-1 C-l-1 
job-4975,1,9,7,248458,309415,309467,60957,52,248779,false,L-l-0 C-l-1 L-l-0 C-s-1 C-l-1 L-l-0 L-l-0 
job-4972,4,6,2,248281,309329,309489,61048,160,248475,false,L-l-0 L-l-0 
job-4976,6,6,2,248507,309415,309494,60908,79,248665,false,C-l-0 C-l-0 
job-4971,4,12,2,248238,309329,309538,61091,209,248631,false,L-m-0 L-m-0 
job-4977,2,6,3,248553,309415,309552,60862,137,248713,false,C-s-2 C-s-1 L-s-0 
job-4978,1,7,1,248599,309552,309582,60953,30,248808,false,L-s-0 
job-4979,4,10,7,248654,309552,309676,60898,124,248945,false,L-m-0 L-l-0 L-l-0 C-m-0 L-l-0 L-m-0 C-m-0 
job-4980,3,12,2,248717,309676,309702,60959,26,248937,false,L-m-0 L-m-0 
job-4983,3,5,7,248872,309676,309717,60804,41,249069,false,C-l-0 C-l-0 C-l-1 C-l-0 C-l-1 C-l-1 C-l-1 
job-4984,2,5,6,248911,309676,309739,60765,63,249084,false,C-m-1 C-m-1 C-l-0 C-m-1 C-m-1 C-s-1 
job-4982,2,11,5,248820,309676,309739,60856,63,248994,false,C-s-1 L-l-0 L-l-0 L-l-0 L-l-0 
job-4981,1,7,3,248768,309676,309749,60908,73,248883,false,L-s-0 L-m-0 L-s-0 
job-4985,6,8,5,248956,309702,309795,60746,93,249086,false,C-m-0 C-l-2 C-m-2 L-m-0 C-l-2 
job-4986,5,5,8,248995,309795,309872,60800,77,249342,false,L-l-0 C-l-0 C-l-1 C-l-1 C-l-0 L-l-0 C-m-0 L-m-0 
job-4987,4,10,8,249054,309872,309889,60818,17,249217,false,L-m-0 L-l-0 L-l-0 L-l-0 C-m-0 L-s-0 L-m-0 C-m-0 
job-4988,1,11,6,249109,309872,309958,60763,86,249477,false,C-m-1 C-l-1 C-l-1 C-m-1 C-l-1 C-l-1 
job-4989,2,8,3,249157,309872,309959,60715,87,249400,false,C-s-2 C-s-2 C-m-1 
job-4990,6,7,4,249218,309872,310083,60654,211,249498,false,C-l-2 C-l-0 C-l-0 C-l-2 
job-4991,4,9,3,249268,309872,310160,60604,288,249798,false,C-s-1 C-m-2 C-m-2 
job-4992,3,6,5,249305,309889,310391,60584,502,249882,false,L-s-0 L-l-0 L-l-0 L-l-0 L-l-0 
job-4994,6,5,7,249400,310391,310450,60991,59,249722,false,L-m-0 C-l-0 C-l-1 C-l-1 C-l-0 L-l-0 L-l-0 
job-4995,1,7,3,249458,310391,310454,60933,63,249724,false,L-s-0 C-s-1 C-s-1 
job-4993,1,10,2,249355,310391,310458,61036,67,249606,false,L-m-0 L-m-0 
job-4996,2,5,8,249520,310391,310613,60871,222,249819,false,L-s-0 C-l-2 C-l-2 C-l-2 C-l-2 C-l-2 C-s-2 C-l-2 
job-4999,6,9,7,249672,310613,310636,60941,23,249793,false,C-l-0 C-l-1 C-l-2 C-m-0 C-l-1 C-l-2 C-l-0 
job-4998,4,9,6,249614,310613,310704,60999,91,249904,false,L-s-0 C-m-2 L-l-0 C-m-2 L-l-0 L-l-0 
job-4997,5,10,1,249559,310613,310726,61054,113,249952,false,L-m-0 
job-5000,1,10,4,249722,310636,310754,60914,118,249885,false,L-m-0 C-m-0 L-m-0 C-m-0 
job-5001,6,11,3,249768,310636,311000,60868,364,250327,false,C-l-0 C-l-0 C-m-0 
job-5002,6,8,4,249820,311000,311067,61180,67,249889,false,L-m-0 L-l-0 L-l-0 C-m-0 
job-5003,6,7,7,249861,311000,311071,61139,71,249965,false,C-m-1 C-l-2 C-l-1 C-l-1 C-l-0 C-l-0 C-l-2 
job-5004,6,11,8,249905,311071,311208,61166,137,250249,false,L-l-0 C-l-0 C-l-2 C-l-2 C-l-0 L-l-0 C-m-0 L-m-0 
job-5005,1,6,7,249960,311071,311270,61111,199,250217,false,C-m-0 L-s-0 L-s-0 C-s-1 C-m-0 L-m-0 L-m-0 
job-5006,6,9,1,250022,311071,311286,61049,215,250238,false,C-m-1 
job-5008,1,11,8,250129,311270,311309,61141,39,250225,false,C-m-1 C-l-0 C-l-0 C-l-0 C-l-0 L-m-0 C-m-1 L-m-0 
job-5007,3,8,5,250075,311270,311322,61195,52,250197,false,L-s-0 L-l-0 L-l-0 L-l-0 L-l-0 
job-5009,6,10,7,250186,311270,311429,61084,159,250614,false,C-l-1 C-l-2 L-m-0 C-m-0 C-l-1 C-l-2 C-m-2 
job-5010,3,7,4,250250,311286,311520,61036,234,250588,false,C-s-1 C-s-2 C-s-0 C-m-1 
job-5011,5,10,2,250285,311309,311527,61024,218,250615,false,C-l-0 C-m-1 
job-5013,1,11,6,250384,311520,311540,61136,20,250698,false,C-m-1 C-m-1 C-l-0 L-m-0 L-m-0 C-l-0 
job-5012,4,8,2,250327,311520,311541,61193,21,250501,false,C-l-0 L-s-0 
job-5014,5,7,8,250439,311520,311564,61081,44,250567,false,C-m-0 C-l-2 L-l-0 C-l-1 C-l-1 L-l-0 C-l-2 L-m-0 
job-5016,6,10,5,250536,311564,311629,61028,65,250659,false,L-m-0 C-l-1 C-l-0 C-l-0 C-l-1 
job-5015,1,12,5,250489,311564,311799,61075,235,250997,false,L-s-0 L-l-0 L-l-0 L-l-0 L-l-0 
job-5017,4,12,1,250575,311799,311829,61224,30,250797,false,L-s-0 
job-5018,2,9,6,250623,311799,311850,61176,51,250771,false,L-m-0 L-l-0 L-l-0 L-l-0 L-l-0 L-l-0 
job-5020,5,4,3,250700,311799,311868,61099,69,251063,false,C-l-0 C-m-1 C-l-0 
job-5022,5,9,4,250795,311868,311882,61073,14,251008,false,C-l-0 C-l-2 C-l-2 C-l-0 
job-5021,3,4,6,250743,311868,311892,61125,24,251039,false,L-s-0 L-l-0 L-l-0 L-m-0 L-l-0 L-l-0 
job-5019,4,9,6,250662,311799,311893,61137,94,250855,false,L-m-0 C-m-0 C-l-1 C-m-0 C-l-1 C-l-1 
job-5023,5,9,8,250842,311892,311965,61050,73,251001,false,C-m-2 C-l-0 C-l-2 C-l-2 C-l-0 L-l-0 C-m-1 L-l-0 
job-5024,2,11,8,250894,311892,312005,60998,113,251059,false,L-m-0 L-l-0 L-m-0 C-l-2 C-l-0 C-m-2 L-s-0 C-m-1 
job-5025,6,7,3,250940,312005,312033,61065,28,251042,false,L-l-0 L-l-0 L-m-0 
job-5026,6,10,4,250987,312005,312104,61018,99,251134,false,C-l-0 C-l-1 C-l-1 C-l-0 
job-5027,6,7,4,251032,312005,312127,60973,122,251214,false,C-m-1 C-l-2 C-l-2 C-m-0 
job-5028,1,11,1,251084,312127,312146,61043,19,251257,false,L-s-0 
job-5029,1,7,6,251137,312127,312172,60990,45,251438,false,L-l-0 L-l-0 L-l-0 L-l-0 L-l-0 L-l-0 
job-5030,2,10,5,251173,312127,312257,60954,130,251565,false,L-m-0 C-m-0 L-m-0 C-m-0 C-m-0 
job-5031,6,4,8,251231,312127,312264,60896,137,251547,false,C-l-1 C-l-1 C-l-2 C-l-0 C-l-0 L-l-0 C-l-2 C-m-1 
job-5033,5,10,6,251330,312264,312286,60934,22,251568,false,C-l-1 L-l-0 C-l-0 C-l-1 C-l-0 L-l-0 
job-5032,3,4,2,251283,312264,312372,60981,108,251542,false,L-m-0 L-m-0 
job-5034,5,12,5,251384,312264,312513,60880,249,251658,false,C-m-1 C-l-2 C-m-2 C-m-0 C-l-2 
job-5037,2,12,6,251541,312513,312569,60972,56,251679,false,C-m-0 C-l-1 C-l-1 C-m-0 C-l-1 C-l-1 
job-5036,1,9,7,251478,312513,312612,61035,99,251707,false,L-s-0 L-l-0 L-m-0 L-l-0 L-l-0 L-l-0 L-l-0 
job-5035,2,6,3,251430,312513,312654,61083,141,251640,false,L-m-0 L-m-0 L-m-0 
job-5038,3,11,4,251581,312513,312658,60932,145,251744,false,C-l-0 C-l-0 C-l-0 C-l-0 
job-5039,2,9,2,251629,312654,312669,61025,15,251878,false,L-m-0 L-m-0 
job-5040,6,8,1,251676,312654,312688,60978,34,251895,false,L-l-0 
job-5041,6,7,4,251724,312654,312784,60930,130,251893,false,C-m-0 C-l-1 C-l-1 L-l-0 
job-5042,5,11,8,251763,312688,312858,60925,170,252081,false,C-m-1 C-l-2 C-l-0 C-l-2 C-l-0 L-l-0 C-m-2 L-m-0 
job-5044,3,8,3,251854,312858,312890,61004,32,251951,false,L-l-0 L-l-0 L-l-0 
job-5043,2,8,1,251813,312858,312910,61045,52,252000,false,L-s-0 
job-5046,5,8,3,251959,312890,312977,60931,87,252268,false,L-l-0 L-l-0 L-m-0 
job-5045,3,8,1,251898,312890,313064,60992,174,252197,false,L-m-0 
job-5047,3,11,4,252011,312890,313095,60879,205,252460,false,C-l-1 C-l-1 C-l-1 C-l-1 
job-5048,3,8,3,252059,313064,313109,61005,45,252255,false,L-m-0 L-m-0 L-s-0 
job-5049,5,11,3,252102,313064,313187,60962,123,252254,false,L-l-0 L-l-0 C-m-0 
job-5050,1,4,7,252144,313187,313250,61043,63,252377,false,L-m-0 L-m-0 L-m-0 L-m-0 L-m-0 L-m-0 L-m-0 
job-5051,5,5,3,252195,313187,313420,60992,233,252435,false,L-l-0 L-l-0 C-m-0 
job-5052,1,9,4,252245,313420,313459,61175,39,252552,false,L-l-0 L-l-0 L-l-0 L-l-0 
job-5056,4,12,8,252431,313420,313494,60989,74,252596,false,C-m-2 C-l-1 C-l-1 C-s-0 C-l-1 C-m-1 C-m-2 C-m-1 
job-5054,6,12,3,252328,313420,313496,61092,76,252699,false,L-m-0 C-l-0 C-l-0 
job-5057,2,11,3,252487,313420,313526,60933,106,252656,false,C-l-2 C-l-2 C-l-2 
job-5055,2,9,3,252384,313420,313578,61036,158,252759,false,C-s-1 C-s-2 L-m-0 
job-5058,3,5,4,252532,313578,313620,61046,42,252625,false,L-m-0 L-l-0 L-l-0 L-l-0 
job-5053,3,8,2,252291,313420,313621,61129,201,252539,false,L-s-0 L-l-0 
job-5059,6,7,4,252572,313578,313635,61006,57,252676,false,C-l-0 C-l-0 C-l-1 C-l-1 
job-5060,4,6,5,252627,313578,313785,60951,207,253096,false,C-s-1 C-l-2 C-l-2 L-m-0 C-l-2 
job-5061,6,4,4,252668,313785,313803,61117,18,252868,false,L-m-0 L-l-0 L-l-0 C-m-0 
job-5062,2,10,4,252717,313785,313861,61068,76,253037,false,C-m-0 C-s-1 L-s-0 L-m-0 
job-5063,4,11,1,252777,313861,313916,61084,55,252877,false,L-s-0 
job-5064,2,7,4,252835,313861,313916,61026,55,252894,false,L-m-0 L-m-0 L-m-0 L-m-0 
job-5067,1,10,8,252976,313916,313956,60940,40,253164,false,C-m-0 C-l-1 C-l-1 C-l-1 C-l-1 C-m-0 L-s-0 C-m-0 
job-5065,2,9,3,252894,313861,313975,60967,114,253057,false,L-l-0 L-l-0 L-l-0 
job-5066,1,9,3,252930,313861,314046,60931,185,253216,false,C-s-1 L-l-0 L-l-0 
job-5068,6,6,4,253027,314046,314066,61019,20,253235,false,L-m-0 L-l-0 L-l-0 C-m-0 
job-5069,4,10,6,253072,314046,314154,60974,108,253240,false,L-s-0 C-m-1 C-l-1 C-m-1 C-l-1 C-l-1 
job-5070,4,6,7,253121,314046,314168,60925,122,253316,false,C-l-0 C-l-2 C-l-2 C-l-2 C-l-0 C-l-0 C-s-1 
job-5071,2,4,6,253167,314046,314416,60879,370,253725,false,C-m-2 C-m-0 C-m-2 C-m-2 C-m-2 L-m-0 
job-5074,6,12,3,253313,314416,314443,61103,27,253523,false,C-l-1 C-m-2 C-l-1 
job-5072,6,4,4,253220,314416,314457,61196,41,253372,false,L-m-0 L-l-0 L-l-0 C-m-0 
job-5073,4,8,3,253261,314416,314478,61155,62,253357,false,L-s-0 C-m-1 C-m-1 
job-5076,4,9,2,253437,314416,314534,60979,118,253752,false,C-s-2 C-s-1 
job-5075,3,12,3,253370,314416,314590,61046,174,253789,false,C-l-0 C-l-0 C-l-0 
job-5077,4,8,6,253481,314443,314617,60962,174,253938,false,C-l-1 C-l-2 C-l-1 C-l-2 C-l-1 C-l-2 
job-5078,2,6,2,253529,314457,314644,60928,187,253815,false,L-m-0 C-l-0 
job-5080,4,9,7,253633,314644,314657,61011,13,253893,false,L-l-0 C-l-1 L-l-0 C-l-1 C-l-1 L-l-0 C-s-1 
job-5082,4,6,4,253735,314644,314669,60909,25,253986,false,C-s-2 C-l-2 C-l-2 C-l-2 
job-5081,5,6,1,253686,314644,314693,60958,49,253767,false,C-m-0 
job-5083,4,10,3,253784,314644,314701,60860,57,254133,false,C-l-0 C-l-0 C-l-0 
job-5079,4,11,3,253572,314644,314722,61072,78,253676,false,L-m-0 L-m-0 L-s-0 
job-5084,1,6,5,253839,314644,314772,60805,128,254092,false,C-m-0 C-m-0 C-s-0 C-m-0 C-s-0 
job-5085,3,7,5,253892,314772,314783,60880,11,254135,false,L-l-0 L-s-0 L-l-0 L-l-0 L-l-0 
job-5086,4,9,3,253945,314772,314817,60827,45,254136,false,L-m-0 C-s-1 L-m-0 
job-5087,6,9,8,254005,314772,314826,60767,54,254270,false,C-l-0 C-l-2 C-l-1 C-l-1 C-l-2 C-m-1 C-l-0 C-m-0 
job-5088,6,8,5,254055,314826,314898,60771,72,254200,false,L-m-0 C-l-0 L-l-0 L-l-0 C-l-0 
job-5089,5,6,1,254099,314826,315273,60727,447,254620,false,C-m-0 
job-5090,3,7,3,254157,315273,315360,61116,87,254292,false,L-m-0 L-m-0 L-s-0 
job-5091,4,12,5,254205,315273,315407,61068,134,254371,false,C-m-0 L-l-0 L-l-0 C-m-0 L-l-0 
job-5093,1,6,8,254303,315273,315418,60970,145,254703,false,L-m-0 C-l-0 C-l-0 L-s-0 C-m-1 C-m-1 L-m-0 C-m-1 
job-5094,1,8,5,254344,315273,315418,60929,145,254657,false,C-m-2 C-m-2 C-m-2 C-m-2 C-m-1 
job-5092,5,10,2,254260,315273,315431,61013,158,254539,false,C-l-0 C-l-0 
job-5095,5,9,7,254386,315407,315707,61021,300,254984,false,C-l-2 L-l-0 L-l-0 C-l-2 C-l-1 C-l-1 L-m-0 
job-5096,5,7,6,254438,315707,315741,61269,34,254700,false,L-m-0 C-l-0 C-l-0 C-m-0 L-l-0 L-l-0 
job-5097,2,8,8,254493,315707,315741,61214,34,254654,false,L-s-0 C-l-0 C-s-1 C-m-0 L-l-0 C-s-1 L-s-0 L-m-0 
job-5099,5,4,2,254585,315707,315846,61122,139,254785,false,C-l-1 C-l-1 
job-5098,1,5,4,254533,315707,315858,61174,151,254925,false,C-m-0 C-s-2 C-s-2 L-m-0 
job-5100,6,5,7,254629,315741,315874,61112,133,254822,false,L-m-0 C-l-0 L-l-0 C-m-1 C-l-0 L-l-0 C-m-0 
job-5101,4,12,2,254677,315846,315922,61169,76,254833,false,L-s-0 C-s-0 
job-5102,4,12,5,254735,315846,316048,61111,202,255128,false,C-l-1 C-l-1 C-m-2 C-m-2 C-l-1 
job-5103,6,6,2,254784,315846,316097,61062,251,255064,false,C-l-2 C-l-2 
job-5104,2,7,2,254826,316048,316115,61222,67,255045,false,L-s-0 L-s-0 
job-5106,6,9,3,254938,316115,316135,61177,20,254961,false,C-m-0 C-l-0 C-l-0 
job-5105,3,7,7,254883,316048,316176,61165,128,255296,false,L-m-0 L-l-0 L-l-0 L-m-0 L-l-0 L-l-0 C-s-1 
job-5107,1,12,6,254978,316115,316235,61137,120,255308,false,C-l-1 L-m-0 C-m-0 C-l-1 C-l-1 C-l-1 
job-5108,4,9,4,255030,316115,316248,61085,133,255213,false,L-s-0 C-l-2 C-l-2 C-l-2 
job-5110,3,10,7,255127,316235,316279,61108,44,255394,false,L-l-0 L-m-0 L-l-0 L-l-0 C-m-1 L-l-0 C-m-1 
job-5109,3,9,1,255075,316235,316295,61160,60,255210,false,L-m-0 
job-5111,5,5,8,255188,316248,316371,61060,123,255397,false,C-m-2 C-l-0 C-l-1 C-l-2 C-l-0 C-l-2 C-m-0 C-l-1 
job-5113,5,9,6,255297,316371,316511,61074,140,255711,false,L-m-0 C-l-0 C-l-0 C-m-2 L-l-0 L-l-0 
job-5112,1,7,2,255241,316371,316524,61130,153,255588,false,L-s-0 L-s-0 
job-5116,2,11,7,255429,316511,316534,61082,23,255632,false,L-l-0 C-l-1 C-l-1 C-l-1 C-l-1 L-l-0 L-l-0 
job-5117,3,12,1,255486,316511,316569,61025,58,255616,false,C-s-1 
job-5118,6,5,5,255538,316511,316587,60973,76,255761,false,C-m-0 C-l-2 C-l-0 C-l-0 C-l-2 
job-5115,2,4,3,255387,316511,316587,61124,76,255476,false,L-m-0 L-l-0 L-l-0 
job-5114,6,12,1,255348,316511,316604,61163,93,255554,false,L-m-0 
job-5119,5,11,2,255580,316511,316631,60931,120,255855,false,C-m-2 C-m-1 
job-5120,6,11,5,255618,316587,316649,60969,62,255773,false,C-l-1 C-l-0 L-l-0 C-l-1 C-l-0 
job-5121,6,9,6,255676,316631,316693,60955,62,255817,false,L-m-0 L-l-0 C-l-2 C-m-1 C-m-0 C-l-2 
job-5122,6,5,3,255723,316693,316706,60970,13,256008,false,L-l-0 L-l-0 L-m-0 
job-5123,5,7,1,255774,316693,316850,60919,157,256111,false,C-m-0 
job-5124,6,6,4,255835,316693,317017,60858,324,256365,false,C-l-0 C-l-1 C-l-1 C-l-0 
job-5125,1,7,6,255882,317017,317079,61135,62,255990,false,L-l-0 L-l-0 L-l-0 L-l-0 L-l-0 L-l-0 
job-5127,6,8,5,255973,317017,317106,61044,89,256260,false,C-l-0 C-l-0 C-l-1 C-m-0 C-l-1 
job-5128,4,12,2,256016,317017,317226,61001,209,256322,false,C-m-2 C-m-2 
job-5129,6,10,5,256064,317106,317245,61042,139,256347,false,L-l-0 C-l-1 L-l-0 C-m-0 C-l-1 
job-5126,2,10,7,255931,317017,317328,61086,311,256465,false,L-m-0 C-m-1 L-m-0 C-m-1 C-m-1 L-m-0 L-s-0 
job-5132,3,8,8,256225,317328,317345,61103,17,256276,false,C-l-1 C-l-1 C-l-2 C-l-2 C-l-2 C-l-2 C-l-1 C-l-1 
job-5130,6,4,2,256120,317328,317353,61208,25,256443,false,L-l-0 L-l-0 
job-5131,3,9,7,256170,317328,317362,61158,34,256380,false,L-s-0 C-l-0 C-l-0 L-m-0 C-l-0 C-l-0 L-m-0 
job-5134,5,7,3,256327,317345,317413,61018,68,256575,false,C-m-2 C-m-0 C-m-1 
job-5133,5,8,4,256266,317345,317475,61079,130,256495,false,C-l-1 C-l-1 C-l-2 C-l-2 
job-5135,2,10,6,256374,317362,317531,60988,169,256751,false,C-m-1 C-l-2 C-m-0 C-m-2 C-l-1 L-s-0 
job-5136,3,9,5,256431,317531,317553,61100,22,256748,false,L-l-0 L-s-0 L-l-0 L-l-0 L-l-0 
job-5137,2,4,4,256484,317531,317580,61047,49,256726,false,L-m-0 L-m-0 L-m-0 L-m-0 
job-5138,6,8,3,256522,317531,317627,61009,96,256713,false,C-l-1 C-m-0 C-l-1 
job-5140,6,6,2,256627,317580,317655,60953,75,256853,false,L-l-0 L-l-0 
job-5142,1,11,5,256725,317627,317659,60902,32,256870,false,C-l-0 C-l-0 C-l-0 C-m-0 C-l-0 
job-5139,2,12,2,256566,317531,317660,60965,129,256944,false,C-s-1 C-m-0 
job-5141,3,11,7,256668,317580,317678,60912,98,256968,false,L-s-0 C-l-2 C-l-2 L-m-0 C-l-2 C-l-2 L-m-0 
job-5143,1,10,3,256786,317627,317679,60841,52,256991,false,C-m-1 L-m-0 C-m-1 
job-5144,3,7,6,256845,317655,317688,60810,33,257081,false,L-l-0 L-l-0 C-m-1 C-m-0 L-l-0 L-l-0 
job-5145,3,12,4,256901,317655,317797,60754,142,257053,false,C-l-1 C-l-1 C-l-1 C-l-1 
job-5146,2,5,1,256932,317797,317849,60865,52,257094,false,L-s-0 
job-5148,6,8,8,257032,317797,317870,60765,73,257279,false,C-l-0 C-l-2 C-l-0 C-l-2 C-l-1 C-m-1 C-l-1 C-m-0 
job-5149,6,4,8,257100,317870,318115,60770,245,257387,false,C-m-1 C-l-2 C-l-0 C-l-1 C-l-1 C-l-2 C-l-0 C-m-0 
job-5150,3,10,4,257155,318115,318153,60960,38,257212,false,C-m-1 L-m-0 C-s-1 C-m-1 
job-5147,2,5,8,256988,317797,318204,60809,407,257694,false,L-m-0 L-m-0 L-l-0 L-l-0 L-l-0 L-s-0 L-l-0 L-l-0 
job-5151,1,10,5,257205,318204,318361,60999,157,257451,false,L-s-0 L-l-0 L-l-0 L-l-0 L-l-0 
job-5152,1,12,3,257253,318361,318380,61108,19,257519,false,L-l-0 L-l-0 L-l-0 
job-5153,5,8,8,257304,318361,318391,61057,30,257381,false,C-l-0 C-l-1 C-l-0 C-l-2 C-l-1 L-l-0 C-l-2 L-m-0 
job-5154,1,6,6,257359,318391,318605,61032,214,257752,false,L-l-0 L-l-0 L-l-0 L-l-0 L-l-0 L-l-0 
job-5155,2,5,7,257418,318605,318637,61187,32,257512,false,L-l-0 L-l-0 L-s-0 L-l-0 L-l-0 L-s-0 L-l-0 
job-5156,6,8,8,257462,318605,318734,61143,129,257756,false,L-m-0 C-l-1 C-l-0 C-l-2 C-l-2 C-l-1 C-l-0 C-m-1 
job-5159,6,5,4,257613,318734,318775,61121,41,257718,false,L-m-0 C-l-1 C-l-1 C-m-1 
job-5157,5,12,4,257513,318637,318787,61124,150,257811,false,C-m-2 L-l-0 L-l-0 C-m-0 
job-5158,4,11,1,257551,318637,318879,61086,242,258038,false,L-s-0 
job-5160,1,7,8,257682,318775,319062,61093,287,257983,false,L-m-0 L-l-0 L-m-0 C-m-2 L-l-0 C-m-2 C-m-0 C-m-0 
job-5161,1,9,8,257722,318775,319069,61053,294,258172,false,L-m-0 C-l-0 C-l-0 C-l-0 C-l-0 C-l-0 C-s-1 L-m-0 
job-5163,5,6,7,257805,319062,319081,61257,19,258114,false,C-m-1 C-l-1 C-l-2 C-m-0 C-l-1 C-l-2 C-m-2 
job-5162,2,12,5,257763,319062,319102,61299,40,257905,false,L-m-0 L-l-0 L-l-0 L-l-0 L-l-0 
job-5164,3,12,4,257865,319062,319134,61197,72,258168,false,C-m-2 L-s-0 C-m-0 C-m-1 
job-5165,4,8,7,257912,319069,319134,61157,65,258101,false,C-s-2 C-l-0 C-l-0 C-s-1 C-l-0 L-m-0 C-s-0 
job-5166,2,6,6,257959,319134,319153,61175,19,258189,false,L-l-0 L-m-0 L-m-0 L-l-0 L-l-0 L-l-0 
job-5167,5,7,5,258015,319134,319284,61119,150,258251,false,C-m-0 C-l-1 C-l-1 C-l-2 C-l-2 
job-5168,3,7,1,258061,319284,319296,61223,12,258214,false,L-s-0 
job-5171,6,12,5,258227,319284,319300,61057,16,258274,false,C-m-0 C-l-2 C-l-2 C-l-0 C-l-0 
job-5170,1,4,8,258182,319284,319310,61102,26,258317,false,L-m-0 L-m-0 L-m-0 L-m-0 L-m-0 L-m-0 L-l-0 L-s-0 
job-5172,1,5,8,258291,319284,319317,60993,33,258481,false,L-m-0 C-m-1 C-m-0 C-m-1 C-m-0 C-m-1 C-m-1 C-m-1 
job-5169,2,11,4,258127,319284,319318,61157,34,258294,false,L-l-0 L-l-0 L-l-0 L-l-0 
job-5173,3,11,3,258337,319284,319533,60947,249,258589,false,C-s-0 C-s-2 C-s-1 
job-5174,3,4,1,258377,319533,319553,61156,20,258507,false,L-s-0 
job-5176,5,11,6,258502,319533,319610,61031,77,258745,false,L-m-0 C-l-1 C-l-0 C-m-0 C-l-0 C-l-1 
job-5175,3,12,3,258442,319533,319700,61091,167,258712,false,L-l-0 L-l-0 L-l-0 
job-5177,2,11,7,258546,319533,319796,60987,263,259034,false,L-m-0 L-l-0 C-l-1 C-m-0 C-l-0 C-m-1 C-m-1 
job-5178,1,12,1,258582,319796,319952,61214,156,258799,false,L-s-0 
job-5180,2,5,8,258672,319952,319963,61280,11,258821,false,C-s-1 L-l-0 L-l-0 C-s-1 L-l-0 L-l-0 L-l-0 L-m-0 
job-5182,4,7,7,258782,319952,319984,61170,32,258839,false,C-l-1 C-l-2 C-l-2 C-s-0 C-l-1 C-l-1 C-l-2 
job-5179,3,7,3,258625,319952,319988,61327,36,258914,false,L-m-0 L-m-0 L-s-0 
job-5183,5,6,8,258831,319984,319995,61153,11,259057,false,C-m-2 C-l-2 C-l-1 C-l-2 L-l-0 L-l-0 C-l-1 C-m-1 
job-5181,4,10,6,258739,319952,320013,61213,61,259099,false,C-m-0 C-l-0 C-s-2 C-m-0 C-l-0 C-l-0 
job-5184,3,7,6,258879,319988,320018,61109,30,259198,false,L-m-0 C-s-1 L-s-0 C-m-2 C-m-1 L-m-0 
job-5185,1,4,1,258932,320018,320036,61086,18,259088,false,L-s-0 
job-5186,6,10,7,258982,320018,320089,61036,71,259281,false,L-l-0 C-l-1 C-l-0 L-m-0 C-l-1 L-l-0 C-l-0 
job-5187,4,9,8,259027,320018,320158,60991,140,259458,false,C-s-1 C-l-2 C-l-2 C-m-0 C-l-2 C-m-1 C-m-1 C-m-0 
job-5188,5,6,7,259067,320089,320181,61022,92,259210,false,L-m-0 L-l-0 C-l-0 C-l-1 C-l-0 L-l-0 C-l-1 
job-5189,3,6,8,259118,320158,320223,61040,65,259348,false,C-m-0 C-l-2 C-l-2 C-l-2 C-l-2 L-m-0 L-s-0 C-m-0 
job-5191,5,7,8,259212,320223,320234,61011,11,259432,false,C-l-0 C-l-2 C-l-1 C-l-1 C-l-0 C-l-2 C-m-0 L-m-0 
job-5192,5,6,6,259254,320234,320246,60980,12,259286,false,C-m-0 C-l-0 C-l-1 L-m-0 C-l-1 C-l-0 
job-5190,1,6,8,259167,320223,320256,61056,33,259276,false,L-l-0 L-l-0 L-l-0 L-l-0 L-l-0 L-l-0 L-l-0 L-l-0 
job-5193,2,12,4,259309,320246,320369,60937,123,259546,false,L-s-0 L-m-0 C-s-0 L-m-0 
job-5194,4,4,4,259349,320246,320460,60897,214,259780,false,C-l-2 L-m-0 C-l-2 C-l-2 
job-5195,4,7,6,259390,320460,320511,61070,51,259552,false,L-m-0 L-s-0 L-l-0 L-l-0 L-m-0 L-l-0 
job-5196,3,5,2,259436,320511,320523,61075,12,259523,false,L-m-0 L-m-0 
job-5197,6,5,6,259496,320511,320576,61015,65,259829,false,C-l-0 C-l-1 C-l-1 L-l-0 C-l-0 L-l-0 
job-5200,4,7,6,259651,320523,320578,60872,55,259712,false,L-m-0 C-l-2 C-m-0 C-m-0 C-l-2 C-l-2 
job-5199,1,8,6,259597,320523,320608,60926,85,259897,false,L-s-0 L-m-0 C-s-1 L-m-0 C-s-1 L-m-0 
job-5198,1,5,1,259544,320523,320676,60979,153,259781,false,L-s-0 
job-5202,6,10,4,259747,320676,320691,60929,15,259887,false,L-m-0 L-l-0 L-l-0 C-m-0 
job-5203,4,6,3,259791,320676,320722,60885,46,260048,false,L-s-0 C-m-1 C-m-1 
job-5201,4,12,1,259695,320523,320723,60828,200,260177,false,C-s-2 
job-5204,4,9,1,259837,320676,320763,60839,87,260010,false,C-s-1 
job-5205,4,9,6,259892,320763,320780,60871,17,260171,false,L-m-0 L-s-0 L-l-0 L-l-0 L-m-0 L-l-0 
job-5207,3,4,5,259977,320763,320892,60786,129,260221,false,C-s-1 C-l-2 C-l-2 C-l-2 C-l-2 
job-5208,6,12,8,260028,320892,320919,60864,27,260187,false,C-m-0 C-l-2 C-l-1 C-l-2 C-l-1 L-l-0 L-l-0 L-m-0 
job-5206,2,6,5,259937,320763,320955,60826,192,260334,false,C-l-0 C-l-0 C-l-0 C-l-0 C-l-0 
job-5209,3,4,8,260069,320892,321116,60823,224,260324,false,C-s-2 L-s-0 C-s-0 C-m-2 C-m-2 C-m-1 C-s-1 C-m-1 
job-5210,1,9,4,260128,321116,321155,60988,39,260190,false,L-l-0 L-l-0 L-l-0 L-l-0 
job-5211,4,9,8,260184,321116,321244,60932,128,260408,false,L-s-0 C-l-1 L-l-0 C-l-1 C-l-1 L-m-0 C-s-1 L-m-0 
job-5212,6,10,8,260228,321155,321331,60927,176,260469,false,C-l-0 C-l-0 L-l-0 C-l-2 C-l-2 C-m-2 C-m-0 C-m-1 
job-5213,2,11,7,260272,321244,321633,60972,389,260779,false,C-m-0 L-l-0 L-s-0 C-m-1 L-l-0 L-l-0 C-m-2 
job-5214,6,4,5,260320,321633,321684,61313,51,260517,false,L-m-0 C-l-0 L-l-0 L-l-0 C-l-0 
job-5215,2,12,2,260367,321633,321756,61266,123,260756,false,L-s-0 L-m-0 
job-5216,3,11,3,260410,321756,321788,61346,32,260698,false,L-m-0 L-m-0 L-s-0 
job-5218,5,8,5,260512,321788,321846,61276,58,260609,false,L-m-0 C-l-1 C-m-2 C-m-1 C-l-1 
job-5217,6,11,7,260469,321756,321871,61287,115,260779,false,L-l-0 C-l-2 C-l-0 C-l-2 C-l-0 L-l-0 C-m-0 
job-5220,1,7,8,260619,321846,322090,61227,244,260891,false,C-m-0 L-s-0 C-m-0 L-s-0 C-m-1 C-m-1 C-m-1 L-m-0 
job-5219,3,11,2,260563,321846,322122,61283,276,261010,false,L-m-0 L-m-0 
job-5221,6,5,7,260665,322090,322173,61425,83,261011,false,C-m-0 C-l-2 L-l-0 L-l-0 C-l-0 C-l-2 C-l-0 
job-5222,4,10,3,260714,322173,322198,61459,25,260838,false,L-m-0 L-m-0 L-s-0 
job-5224,6,10,8,260804,322173,322271,61369,98,260976,false,C-l-2 C-l-0 C-l-0 L-l-0 C-l-1 C-l-2 C-l-1 C-m-0 
job-5223,2,4,2,260758,322173,322439,61415,266,261320,false,L-l-0 L-l-0 
job-5225,2,5,7,260873,322439,322456,61566,17,260913,false,L-l-0 L-l-0 L-s-0 L-l-0 L-l-0 L-s-0 L-l-0 
job-5226,4,7,8,260914,322439,322474,61525,35,261071,false,L-m-0 C-l-1 C-l-0 C-l-0 C-l-1 L-m-0 C-l-0 C-l-1 
job-5227,5,4,6,260967,322456,322595,61489,139,261172,false,C-m-0 L-l-0 C-l-2 C-m-1 L-l-0 C-l-2 
job-5228,2,7,7,261028,322595,322701,61567,106,261391,false,L-l-0 L-l-0 L-s-0 L-l-0 L-l-0 L-s-0 L-l-0 
job-5230,3,5,7,261129,322701,322750,61572,49,261378,false,L-m-0 L-l-0 L-l-0 C-s-1 L-l-0 L-l-0 L-m-0 
job-5229,4,4,1,261080,322701,322759,61621,58,261377,false,L-s-0 
job-5231,5,11,7,261178,322701,323067,61523,366,261741,false,C-l-1 C-l-2 C-l-0 C-l-1 C-l-0 C-l-2 C-m-0 
job-5232,1,12,1,261233,323067,323085,61834,18,261356,false,L-s-0 
job-5233,5,9,6,261286,323067,323290,61781,223,261644,false,L-m-0 C-l-0 C-l-0 C-m-0 L-l-0 L-l-0 
job-5234,5,4,8,261331,323290,323484,61959,194,261701,false,L-l-0 C-l-0 C-l-1 C-l-1 C-l-0 L-l-0 C-m-0 L-m-0 
job-5235,5,6,1,261384,323484,323533,62100,49,261623,false,L-m-0 
job-5236,4,9,2,261446,323533,323552,62087,19,261547,false,L-m-0 L-m-0 
job-5237,2,12,1,261499,323552,323564,62053,12,261603,false,L-s-0 
job-5239,5,10,7,261597,323552,323584,61955,32,261638,false,L-l-0 C-l-1 C-l-0 C-m-0 C-l-1 L-l-0 C-l-0 
job-5238,3,4,2,261541,323552,323608,62011,56,261751,false,L-m-0 L-m-0 
job-5240,4,11,8,261652,323552,323628,61900,76,261949,false,C-m-2 C-l-2 C-s-1 C-l-2 C-l-2 C-m-1 C-m-2 C-m-1 
job-5241,1,6,6,261705,323584,323640,61879,56,261767,false,L-l-0 L-m-0 L-m-0 L-l-0 L-l-0 L-l-0 
job-5242,6,5,8,261757,323628,323829,61871,201,262213,false,C-l-0 C-l-2 C-l-2 L-m-0 C-l-1 C-l-1 C-l-0 L-l-0 
job-5244,3,11,5,261852,323829,323851,61977,22,261957,false,C-l-0 C-l-0 C-l-0 C-s-1 C-l-0 
job-5245,2,4,8,261908,323851,323864,61943,13,261968,false,C-s-0 C-l-1 C-l-1 C-l-1 C-l-1 C-l-1 C-s-0 C-l-1 
job-5243,4,11,8,261807,323829,323865,62022,36,261902,false,L-l-0 L-m-0 L-l-0 L-m-0 C-m-1 L-s-0 L-l-0 C-m-1 
job-5246,2,6,3,261956,323851,324074,61895,223,262472,false,C-m-0 C-m-0 C-m-0 
job-5247,1,5,7,262011,324074,324153,62063,79,262322,false,L-l-0 L-l-0 L-l-0 L-l-0 L-l-0 L-l-0 L-l-0 
job-5248,1,5,2,262063,324153,324185,62090,32,262137,false,L-s-0 L-s-0 
job-5250,3,7,7,262156,324185,324208,62029,23,262457,false,L-s-0 C-l-2 C-l-2 C-s-1 C-l-2 C-l-2 L-m-0 
job-5249,5,10,7,262098,324153,324210,62055,57,262201,false,L-l-0 C-l-1 L-m-0 C-l-0 C-l-1 L-l-0 C-l-0 
job-5251,1,4,1,262218,324210,324288,61992,78,262484,false,L-s-0 
job-5252,1,5,2,262267,324288,324601,62021,313,262775,false,L-s-0 L-s-0 
job-5253,6,9,2,262319,324601,324618,62282,17,262353,false,L-l-0 L-l-0 
job-5254,5,7,3,262371,324601,324806,62230,205,262768,false,L-m-0 C-l-0 C-l-0 
job-5255,3,12,2,262419,324806,324844,62387,38,262635,false,L-m-0 L-m-0 
job-5256,6,12,4,262464,324806,324900,62342,94,262619,false,L-l-0 C-l-0 L-l-0 C-l-0 
job-5258,1,4,4,262585,324844,324900,62259,56,262859,false,L-m-0 L-m-0 L-m-0 L-m-0 
job-5257,4,7,1,262529,324806,324904,62277,98,262749,false,L-s-0 
job-5260,5,10,7,262683,324900,325059,62217,159,262860,false,C-m-0 C-l-2 L-l-0 C-l-2 C-l-0 L-l-0 C-l-0 
job-5259,5,11,2,262638,324844,325088,62206,244,263169,false,C-l-1 C-l-1 
job-5261,5,8,1,262737,325059,325093,62322,34,262855,false,L-m-0 
job-5263,5,11,7,262826,325059,325287,62233,228,263181,false,C-m-2 C-l-2 C-l-0 C-m-0 C-l-2 C-l-0 C-m-1 
job-5262,4,9,2,262780,325059,325421,62279,362,263273,false,L-l-0 L-l-0 
job-5264,1,10,8,262890,325421,325455,62531,34,263186,false,L-m-0 L-l-0 L-l-0 L-l-0 L-l-0 L-m-0 L-s-0 L-m-0 
job-5266,1,9,6,263019,325421,325462,62402,41,263077,false,C-m-0 C-m-0 C-l-1 C-l-1 C-l-1 C-l-1 
job-5265,6,9,3,262945,325421,325472,62476,51,263185,false,C-m-0 C-l-0 C-l-0 
job-5267,2,9,8,263074,325421,325558,62347,137,263306,false,C-m-2 C-l-1 C-m-2 C-s-0 C-m-1 C-m-2 C-m-1 C-m-1 
job-5268,3,9,1,263118,325558,325594,62440,36,263290,false,L-s-0 
job-5271,2,10,2,263274,325558,325617,62284,59,263531,false,C-s-1 C-s-0 
job-5270,2,7,4,263218,325558,325705,62340,147,263372,false,L-m-0 L-m-0 L-m-0 L-m-0 
job-5272,6,6,3,263322,325558,325711,62236,153,263623,false,C-l-2 C-m-0 C-l-2 
job-5269,6,10,2,263170,325558,325731,62388,173,263380,false,L-l-0 L-l-0 
job-5273,2,12,6,263375,325705,325732,62330,27,263595,false,L-s-0 C-m-1 C-m-0 L-m-0 C-m-1 L-m-0 
job-5274,3,11,5,263420,325705,326427,62285,722,264172,false,C-s-1 C-l-0 C-l-0 C-l-0 C-l-0 
job-5275,4,8,8,263466,326427,326480,62961,53,263694,false,L-l-0 L-m-0 L-l-0 L-l-0 C-m-0 L-s-0 L-m-0 C-m-0 
job-5276,5,10,4,263523,326480,326492,62957,12,263802,false,L-m-0 L-l-0 L-l-0 C-m-0 
job-5277,3,8,3,263578,326480,326542,62902,62,263840,false,L-s-0 C-m-0 L-m-0 
job-5278,5,8,4,263615,326480,326543,62865,63,263813,false,C-l-0 C-l-0 C-l-1 C-l-1 
job-5279,1,9,7,263665,326542,326552,62877,10,263808,false,L-m-0 C-l-0 C-l-0 L-m-0 C-l-1 C-l-1 L-m-0 
job-5282,5,9,4,263814,326552,326655,62738,103,264123,false,L-m-0 C-l-0 C-l-0 C-m-2 
job-5280,5,6,5,263712,326542,326677,62830,135,263858,false,C-m-0 L-l-0 C-l-2 L-l-0 C-l-2 
job-5281,3,11,7,263758,326542,326692,62784,150,263948,false,L-s-0 C-s-2 C-s-1 C-m-1 C-m-1 C-s-0 C-m-0 
job-5284,2,6,7,263924,326655,326822,62731,167,264307,false,C-l-0 C-l-0 C-l-0 C-m-2 C-l-0 C-l-0 C-l-0 
job-5285,6,4,2,263981,326655,326824,62674,169,264246,false,C-l-1 C-m-2 
job-5283,1,10,8,263870,326655,326871,62785,216,264303,false,L-l-0 L-l-0 L-m-0 C-m-1 C-l-2 L-m-0 C-l-2 L-m-0 
job-5286,5,9,2,264035,326871,326902,62836,31,264121,false,L-l-0 L-l-0 
job-5287,1,8,6,264077,326871,327022,62794,151,264422,false,L-l-0 L-m-0 L-l-0 L-m-0 L-m-0 L-m-0 
job-5288,2,6,1,264120,327022,327099,62902,77,264477,false,L-s-0 
job-5289,3,7,1,264169,327099,327111,62930,12,264376,false,L-s-0 
job-5290,3,10,5,264211,327099,327134,62888,35,264262,false,L-l-0 L-l-0 L-l-0 L-m-0 L-l-0 
job-5292,3,4,8,264309,327134,327149,62825,15,264425,false,L-s-0 L-l-0 L-l-0 L-l-0 L-l-0 L-m-0 C-s-1 L-m-0 
job-5291,6,9,2,264274,327099,327157,62825,58,264447,false,C-l-0 C-l-0 
job-5294,5,9,7,264411,327149,327259,62738,110,264805,false,L-m-0 L-l-0 C-l-1 C-m-2 C-l-1 L-l-0 C-m-1 
job-5293,4,5,5,264360,327134,327292,62774,158,264709,false,C-m-0 C-l-2 C-l-2 C-m-0 C-l-2 
job-5296,3,7,4,264527,327259,327334,62732,75,264792,false,L-l-0 L-l-0 L-l-0 L-l-0 
job-5295,1,11,2,264471,327259,327351,62788,92,264638,false,L-m-0 L-m-0 
job-5297,4,6,4,264564,327259,327421,62695,162,264765,false,L-s-0 C-m-1 L-m-0 C-m-1 
job-5300,2,10,4,264713,327421,327444,62708,23,264741,false,C-l-0 C-l-0 C-l-0 C-l-0 
job-5298,4,8,5,264616,327421,327454,62805,33,264698,false,L-m-0 L-l-0 L-l-0 L-l-0 L-m-0 
job-5299,1,11,6,264665,327421,327457,62756,36,264936,false,L-s-0 C-l-1 C-l-1 C-s-1 C-l-1 C-l-1 
job-5301,2,10,3,264752,327421,327593,62669,172,265080,false,C-m-0 C-m-0 C-m-0 
job-5303,4,12,8,264850,327457,327612,62607,155,265127,false,L-s-0 C-l-1 C-l-1 C-s-0 C-m-2 C-l-1 C-s-1 C-m-2 
job-5302,5,11,8,264801,327454,327637,62653,183,265249,false,C-m-1 L-l-0 L-l-0 C-l-0 C-l-0 C-l-2 C-l-2 L-m-0 
job-5304,2,5,6,264904,327593,327687,62689,94,265287,false,L-m-0 C-l-2 C-s-2 C-m-1 C-l-0 L-l-0 
job-5306,3,11,8,265000,327687,327712,62687,25,265233,false,L-m-0 C-l-0 C-l-0 C-s-0 C-l-0 C-l-0 C-s-1 L-m-0 
job-5305,1,12,5,264950,327687,327724,62737,37,265285,false,L-s-0 L-l-0 L-l-0 L-l-0 L-l-0 
job-5307,5,8,5,265045,327687,327773,62642,86,265370,false,C-m-0 C-l-2 C-l-1 C-l-1 C-l-2 
job-5309,5,5,6,265131,327773,327808,62642,35,265364,false,L-m-0 C-l-0 C-l-0 C-m-0 L-l-0 L-l-0 
job-5308,1,5,1,265087,327773,327886,62686,113,265417,false,L-s-0 
job-5310,2,12,5,265180,327773,327894,62593,121,265420,false,L-m-0 L-l-0 C-s-1 C-m-0 C-l-0 
job-5311,3,6,6,265231,327894,327931,62663,37,265392,false,L-m-0 L-l-0 L-l-0 L-m-0 L-l-0 L-l-0 
job-5312,2,6,5,265271,327894,327997,62623,103,265648,false,C-s-2 L-s-0 L-m-0 C-s-2 L-s-0 
job-5313,5,4,2,265324,327894,328127,62570,233,265662,false,C-l-0 C-l-0 
job-5314,6,5,5,265384,328127,328182,62743,55,265664,false,L-m-0 C-l-0 L-l-0 L-l-0 C-l-0 
job-5315,5,9,7,265436,328127,328205,62691,78,265614,false,C-m-2 C-l-2 C-l-1 C-m-0 C-l-1 C-l-2 C-m-1 
job-5316,5,10,4,265491,328205,328220,62714,15,265682,false,L-m-0 L-l-0 L-l-0 C-m-0 
job-5317,5,6,3,265538,328205,328295,62667,90,265751,false,C-l-0 C-l-0 C-m-1 
job-5318,5,6,6,265586,328220,328347,62634,127,265854,false,L-m-0 L-l-0 C-l-1 C-m-0 C-l-1 L-l-0 
job-5319,3,12,1,265644,328347,328357,62703,10,265823,false,L-s-0 
job-5320,5,8,6,265700,328347,328384,62647,37,265782,false,L-m-0 C-l-0 L-l-0 C-m-0 C-l-0 L-l-0 
job-5321,4,9,4,265752,328384,328396,62632,12,265871,false,L-l-0 L-l-0 L-s-0 L-l-0 
job-5322,3,11,6,265792,328384,328549,62592,165,266050,false,C-l-2 C-l-2 C-l-2 L-m-0 C-l-2 L-m-0 
job-5323,1,12,8,265842,328549,328560,62707,11,265895,false,L-m-0 L-l-0 L-s-0 L-l-0 L-l-0 L-l-0 C-s-1 L-m-0 
job-5325,6,9,8,265931,328549,328583,62618,34,266042,false,C-l-0 C-l-2 C-l-0 C-l-1 C-l-1 C-m-1 C-l-2 C-m-2 
job-5324,1,6,4,265885,328549,328722,62664,173,266352,false,C-m-0 L-m-0 C-m-0 C-m-0 
job-5327,4,10,5,266025,328722,328777,62697,55,266081,false,C-s-0 C-m-1 L-s-0 C-m-1 C-s-2 
job-5326,6,5,4,265972,328722,328780,62750,58,266061,false,L-m-0 L-l-0 L-l-0 C-m-0 
job-5328,1,8,4,266087,328780,328898,62693,118,266405,false,L-m-0 L-m-0 L-m-0 L-m-0 
job-5330,5,9,3,266201,328898,328924,62697,26,266258,false,L-l-0 L-l-0 L-m-0 
job-5329,4,11,1,266144,328898,328956,62754,58,266224,false,L-s-0 
job-5331,1,4,2,266261,328924,328965,62663,41,266447,false,L-m-0 L-m-0 
job-5332,3,4,7,266314,328924,329014,62610,90,266492,false,L-m-0 L-l-0 L-l-0 C-s-1 L-l-0 L-l-0 L-m-0 
job-5333,5,9,8,266371,328924,329053,62553,129,266589,false,C-m-0 C-l-1 C-l-0 C-l-2 C-l-2 C-l-1 C-l-0 C-m-1 
job-5335,3,4,8,266465,329053,329077,62588,24,266693,false,L-l-0 C-l-0 C-l-0 C-l-0 C-l-0 L-l-0 L-l-0 L-l-0 
job-5334,3,8,2,266421,329053,329116,62632,63,266594,false,L-m-0 L-m-0 
job-5336,5,6,4,266524,329053,329194,62529,141,266774,false,C-l-1 C-l-1 C-l-2 C-l-2 
job-5337,2,4,7,266574,329194,329214,62620,20,266827,false,L-s-0 L-s-0 L-l-0 L-l-0 L-l-0 L-l-0 L-l-0 
job-5339,2,4,8,266677,329214,329279,62537,65,266878,false,L-m-0 L-l-0 C-l-0 C-l-2 L-l-0 L-l-0 C-m-0 C-l-1 
job-5338,5,11,8,266614,329194,329280,62580,86,266748,false,C-m-0 C-l-1 C-l-0 C-l-2 C-l-1 C-l-2 C-l-0 L-m-0 
job-5340,3,12,7,266720,329214,329282,62494,68,266870,false,L-s-0 C-m-1 L-l-0 C-m-2 C-m-2 L-l-0 C-m-1 
job-5342,4,9,6,266819,329280,329290,62461,10,266915,false,C-l-1 C-l-0 C-l-0 C-l-1 C-l-0 C-l-1 
job-5341,3,7,4,266767,329280,329295,62513,15,266850,false,L-m-0 L-l-0 L-l-0 L-m-0 
job-5343,4,10,7,266874,329280,329310,62406,30,267141,false,C-m-0 C-l-2 C-s-2 C-m-0 C-l-2 C-l-2 C-s-1 
job-5344,6,4,3,266917,329282,329386,62365,104,267277,false,L-l-0 C-m-1 C-m-2 
job-5345,1,12,5,266965,329386,329839,62421,453,267546,false,L-s-0 L-l-0 L-l-0 L-l-0 L-l-0 
job-5347,3,11,1,267058,329839,329982,62781,143,267258,false,L-l-0 
job-5346,3,7,3,267016,329839,329984,62823,145,267292,false,L-m-0 L-m-0 L-s-0 
job-5349,4,7,8,267145,329982,330029,62837,47,267396,false,C-l-2 C-l-1 C-l-2 C-l-1 C-l-1 C-m-0 C-l-2 C-m-0 
job-5348,2,8,6,267103,329982,330059,62879,77,267242,false,L-l-0 L-m-0 L-l-0 L-l-0 L-l-0 L-l-0 
job-5350,4,4,2,267193,329982,330223,62789,241,267439,false,C-m-1 C-m-1 
job-5352,6,11,1,267297,330223,330262,62926,39,267356,false,L-m-0 
job-5351,4,11,4,267247,330223,330278,62976,55,267352,false,L-l-0 L-l-0 L-s-0 L-l-0 
job-5353,2,8,3,267344,330262,330288,62918,26,267472,false,L-m-0 L-m-0 L-m-0 
job-5354,5,7,6,267394,330262,330316,62868,54,267612,false,C-l-0 C-l-1 C-l-0 C-l-2 C-l-2 C-l-1 
job-5355,6,7,1,267438,330262,330406,62824,144,267781,false,C-m-0 
job-5356,2,4,6,267488,330262,330578,62774,316,267987,false,L-m-0 C-l-2 C-l-0 C-m-0 C-s-1 C-l-1 
job-5358,4,7,5,267603,330578,330601,62975,23,267755,false,C-m-0 L-s-0 L-m-0 C-m-0 L-m-0 
job-5357,2,12,4,267548,330578,330641,63030,63,267901,false,L-l-0 L-l-0 L-l-0 L-l-0 
job-5359,2,6,3,267648,330578,330810,62930,232,268170,false,C-m-1 C-m-1 C-m-1 
job-5362,3,7,3,267799,330810,330852,63011,42,268105,false,L-l-0 L-l-0 L-l-0 
job-5360,3,5,4,267698,330578,330858,62880,280,268263,false,C-l-2 C-l-2 C-l-2 C-l-2 
job-5361,1,11,1,267755,330810,330884,63055,74,267897,false,L-s-0 
job-5363,6,4,3,267859,330810,330901,62951,91,268223,false,C-l-0 C-l-0 L-m-0 
job-5364,3,9,2,267906,330852,330912,62946,60,268008,false,L-l-0 L-l-0 
job-5365,6,6,4,267945,330852,330954,62907,102,268228,false,C-l-1 C-l-1 L-l-0 C-m-0 
job-5366,2,9,8,267991,330954,330981,62963,27,268044,false,L-l-0 L-l-0 L-l-0 L-l-0 L-l-0 L-m-0 L-m-0 L-m-0 
job-5367,2,5,4,268042,330954,330998,62912,44,268230,false,L-s-0 C-s-1 C-s-1 L-m-0 
job-5368,2,8,8,268107,330954,331037,62847,83,268314,false,C-m-2 L-s-0 C-s-2 C-s-0 C-m-2 C-s-2 C-s-0 C-m-2 
job-5369,4,4,5,268156,330954,331038,62798,84,268447,false,C-m-0 C-l-1 C-l-1 C-m-0 C-l-1 
job-5370,6,10,1,268206,330954,331042,62748,88,268340,false,C-m-1 
job-5371,4,4,6,268251,330954,331219,62703,265,268813,false,C-l-0 C-l-2 C-l-0 C-l-2 C-l-2 C-l-0 
job-5372,2,7,3,268296,331219,331236,62923,17,268578,false,L-m-0 L-m-0 L-m-0 
job-5373,3,6,4,268351,331219,331321,62868,102,268540,false,L-l-0 L-l-0 L-l-0 L-l-0 
job-5375,5,5,5,268459,331219,331353,62760,134,268675,false,C-m-0 C-l-1 C-l-1 C-l-0 C-l-0 
job-5374,2,7,6,268404,331219,331627,62815,408,268855,false,C-m-2 C-m-2 L-m-0 C-m-2 C-m-2 L-s-0 
job-5376,5,7,2,268509,331627,331641,63118,14,268787,false,L-l-0 L-l-0 
job-5377,6,6,1,268565,331627,331736,63062,109,268839,false,L-m-0 
job-5380,4,8,4,268726,331641,331809,62915,168,269125,false,C-m-0 L-l-0 C-m-0 C-s-0 
job-5379,4,9,2,268670,331641,331814,62971,173,268864,false,L-l-0 L-l-0 
job-5381,4,8,7,268782,331809,331827,63027,18,268939,false,C-m-0 C-l-1 C-l-1 C-m-0 C-l-1 L-l-0 L-m-0 
job-5384,4,6,8,268933,331827,331871,62894,44,269259,false,C-s-0 C-l-1 C-l-1 C-s-1 C-m-1 C-l-1 C-s-2 C-m-1 
job-5382,6,7,8,268828,331827,331885,62999,58,269130,false,L-m-0 C-l-2 C-l-0 C-l-2 C-l-0 L-l-0 L-l-0 C-m-0 
job-5383,2,6,5,268882,331827,331922,62945,95,269135,false,C-m-2 C-m-2 C-m-0 C-m-2 C-m-2 
job-5386,6,9,7,269028,331922,331943,62894,21,269263,false,C-l-0 C-l-1 C-l-0 C-m-0 C-l-1 C-l-2 C-l-2 
job-5378,1,9,3,268624,331641,331947,63017,306,269213,false,L-s-0 L-m-0 L-m-0 
job-5385,4,10,3,268982,331922,331950,62940,28,269253,false,L-l-0 L-m-0 L-l-0 
job-5387,6,4,8,269078,331943,332299,62865,356,269648,false,C-l-2 C-l-2 C-l-0 C-l-0 C-l-1 C-l-1 C-m-0 C-m-1 
job-5388,5,9,4,269119,332299,332323,63180,24,269168,false,L-m-0 L-l-0 L-l-0 C-m-0 
job-5389,3,5,8,269174,332299,332470,63125,171,269393,false,C-s-1 C-l-0 C-l-0 C-m-0 C-l-0 C-l-0 L-m-0 L-s-0 
job-5390,5,4,5,269230,332470,332480,63240,10,269318,false,L-l-0 L-l-0 C-l-0 L-m-0 C-l-0 
job-5391,1,10,4,269283,332480,332491,63197,11,269387,false,L-l-0 L-l-0 L-l-0 L-l-0 
job-5394,5,5,7,269426,332480,332525,63054,45,269514,false,C-l-0 C-l-2 C-l-1 C-m-0 C-l-1 C-l-2 C-l-0 
job-5393,2,10,3,269369,332480,332536,63111,56,269718,false,C-m-2 C-m-2 C-m-2 
job-5392,4,6,4,269318,332480,332572,63162,92,269587,false,L-s-0 L-l-0 L-m-0 L-m-0 
job-5395,3,4,6,269474,332480,332680,63006,200,269710,false,C-m-1 C-s-2 C-s-0 C-m-1 C-m-0 C-s-1 
job-5396,1,4,6,269523,332680,332761,63157,81,269850,false,L-m-0 L-m-0 L-m-0 L-m-0 L-m-0 L-m-0 
job-5397,2,12,8,269576,332680,332873,63104,193,270061,false,L-l-0 C-l-0 C-l-0 C-l-0 C-l-0 L-l-0 L-l-0 L-l-0 
job-5398,6,6,7,269622,332680,332902,63058,222,269852,false,C-m-2 C-l-1 C-l-2 C-m-1 C-l-1 C-l-2 C-m-0 
job-5399,2,7,4,269671,332873,332982,63202,109,269991,false,C-m-1 C-m-2 L-s-0 C-m-0 
job-5400,2,4,3,269729,332982,332995,63253,13,270019,false,L-m-0 L-m-0 L-m-0 
job-5401,1,10,5,269778,332982,333180,63204,198,270255,false,L-l-0 L-m-0 L-m-0 L-l-0 L-l-0 
job-5402,3,6,2,269823,333180,333379,63357,199,270257,false,L-m-0 L-m-0 
job-5403,2,12,2,269870,333379,333497,63509,118,270280,false,L-m-0 L-m-0 
job-5405,4,11,8,269972,333497,333533,63525,36,270085,false,C-l-0 L-m-0 C-l-0 C-l-2 C-s-1 C-l-2 C-l-2 C-l-0 
job-5404,4,6,5,269919,333379,333674,63460,295,270225,false,L-l-0 L-l-0 L-m-0 L-l-0 L-s-0 
job-5406,3,6,2,270022,333674,333716,63652,42,270147,false,L-m-0 L-m-0 
job-5410,5,7,6,270229,333674,333797,63445,123,270541,false,C-m-2 C-l-2 C-l-1 C-m-1 C-l-1 C-l-2 
job-5407,2,12,8,270062,333674,333800,63612,126,270216,false,L-l-0 L-m-0 L-s-0 L-l-0 L-l-0 L-l-0 C-m-0 C-m-0 
job-5409,4,11,4,270172,333674,333835,63502,161,270410,false,C-s-2 C-l-0 C-l-0 C-l-0 
job-5411,3,9,6,270273,333835,333851,63562,16,270576,false,L-m-0 L-l-0 L-l-0 L-m-0 L-l-0 L-l-0 
job-5408,4,12,1,270118,333674,333859,63556,185,270366,false,C-s-1 
job-5412,5,9,6,270320,333835,333864,63515,29,270524,false,C-l-1 C-l-0 C-l-2 C-l-2 C-l-0 C-l-1 
job-5413,6,6,4,270361,333851,334128,63490,277,270895,false,L-m-0 L-l-0 L-l-0 C-m-0 
job-5414,3,9,2,270420,334128,334140,63708,12,270638,false,L-m-0 L-m-0 
job-5415,1,4,7,270460,334128,334157,63668,29,270669,false,L-l-0 L-m-0 L-m-0 L-l-0 L-l-0 L-l-0 L-l-0 
job-5416,6,8,7,270509,334128,334533,63619,405,271108,false,L-l-0 C-l-0 C-l-0 C-l-2 C-l-1 C-l-1 C-l-2 
job-5417,2,8,7,270559,334533,334682,63974,149,270979,false,L-l-0 L-l-0 L-s-0 L-l-0 L-l-0 L-s-0 L-l-0 
job-5418,3,7,5,270611,334533,334938,63922,405,271166,false,L-m-0 C-l-0 C-l-0 C-l-0 C-l-0 
job-5419,3,8,8,270673,334938,334959,64265,21,270938,false,L-l-0 L-s-0 L-l-0 C-s-2 L-l-0 L-l-0 L-m-0 L-m-0 
job-5421,6,4,8,270782,334959,334987,64177,28,270900,false,L-m-0 C-l-2 C-l-0 C-l-2 C-l-0 L-l-0 L-l-0 C-m-1 
job-5420,3,6,6,270736,334938,335006,64202,68,270826,false,C-m-0 C-l-1 C-l-1 C-m-0 C-l-1 C-l-1 
job-5422,6,7,3,270829,334987,335117,64158,130,270964,false,L-l-0 L-m-0 L-l-0 
job-5423,2,12,1,270882,335117,335147,64235,30,270995,false,L-s-0 
job-5424,1,11,4,270934,335117,335459,64183,342,271502,false,L-l-0 L-l-0 L-l-0 L-l-0 
job-5425,2,9,4,270986,335459,335538,64473,79,271205,false,L-l-0 L-l-0 L-l-0 L-l-0 
job-5426,1,5,2,271033,335538,335618,64505,80,271258,false,L-s-0 L-s-0 
job-5428,2,6,6,271137,335618,335641,64481,23,271249,false,L-s-0 L-l-0 L-s-0 L-m-0 C-s-1 C-s-1 
job-5427,1,10,6,271079,335538,335644,64459,106,271247,false,L-m-0 L-l-0 L-l-0 L-m-0 L-l-0 L-l-0 
job-5429,6,4,4,271193,335618,335693,64425,75,271549,false,C-l-0 C-l-0 C-l-1 C-l-1 
job-5430,4,10,4,271235,335693,335723,64458,30,271514,false,L-l-0 L-l-0 L-s-0 L-l-0 
job-5432,5,5,4,271344,335693,335747,64349,54,271502,false,C-l-0 C-l-0 C-l-1 C-l-1 
job-5433,5,5,3,271391,335693,335769,64302,76,271517,false,C-m-0 C-l-2 C-l-2 
job-5431,2,9,6,271292,335693,335818,64401,125,271654,false,L-m-0 C-m-2 L-m-0 C-m-2 C-m-2 L-m-0 
job-5434,1,5,2,271434,335818,336148,64384,330,271835,false,L-s-0 L-s-0 
job-5436,6,6,3,271545,336148,336170,64603,22,271730,false,L-m-0 C-l-0 C-l-0 
job-5435,5,4,2,271498,336148,336196,64650,48,271767,false,L-l-0 L-l-0 
job-5438,6,6,1,271649,336148,336262,64499,114,272020,false,C-m-1 
job-5437,6,11,3,271600,336148,336268,64548,120,271926,false,C-l-1 C-l-1 C-m-0 
job-5440,5,10,8,271732,336262,336304,64530,42,271918,false,C-m-1 L-l-0 C-l-0 C-l-2 C-l-0 L-l-0 C-l-2 L-m-0 
job-5439,1,9,3,271694,336262,336321,64568,59,272026,false,L-s-0 C-m-0 C-m-0 
job-5441,4,11,7,271792,336268,336367,64476,99,272019,false,C-m-2 C-l-1 C-l-1 C-m-0 C-l-1 C-s-1 C-m-2 
job-5442,4,7,8,271829,336304,336394,64475,90,272181,false,L-l-0 L-l-0 C-l-0 C-l-0 C-l-0 L-l-0 L-m-0 L-m-0 
job-5443,3,8,6,271872,336304,336462,64432,158,272242,false,C-m-1 C-l-2 C-l-2 C-m-1 C-l-2 C-l-2 
job-5445,6,12,3,271979,336462,336472,64483,10,272254,false,C-l-1 C-m-0 C-l-1 
job-5444,4,4,5,271927,336462,336505,64535,43,272115,false,L-m-0 L-l-0 L-l-0 L-l-0 L-m-0 
job-5446,6,5,8,272019,336472,336516,64453,44,272277,false,C-l-0 C-l-2 C-l-0 C-l-1 C-l-1 C-l-2 C-m-1 C-m-0 
job-5447,4,4,6,272086,336505,336526,64419,21,272128,false,L-m-0 L-l-0 L-l-0 L-s-0 L-m-0 L-l-0 
job-5449,4,11,4,272195,336516,336676,64321,160,272636,false,C-l-1 C-l-1 C-l-1 C-s-1 
job-5448,3,6,2,272140,336505,336740,64365,235,272448,false,C-m-2 C-m-2 
job-5450,1,7,4,272248,336740,336769,64492,29,272466,false,L-m-0 L-m-0 L-m-0 L-m-0 
job-5451,6,7,8,272291,336740,336987,64449,247,272675,false,C-l-0 L-l-0 C-l-1 C-l-2 C-l-0 C-l-2 L-l-0 C-l-1 
job-5452,3,9,3,272326,336987,337160,64661,173,272545,false,L-m-0 L-m-0 L-s-0 
job-5454,5,5,5,272422,337160,337213,64738,53,272705,false,L-m-0 L-l-0 C-l-0 C-l-0 L-l-0 
job-5453,4,4,1,272379,337160,337220,64781,60,272509,false,L-s-0 
job-5456,3,5,7,272519,337160,337226,64641,66,272852,false,C-m-1 L-m-0 C-m-2 C-m-1 C-m-2 C-m-0 C-m-0 
job-5455,5,11,4,272468,337160,337250,64692,90,272649,false,C-l-1 C-l-2 C-l-1 C-l-2 
job-5458,4,11,8,272619,337226,337268,64607,42,272898,false,L-s-0 L-l-0 C-l-0 C-l-0 C-l-0 L-l-0 C-s-1 L-l-0 
job-5457,5,8,1,272572,337226,337519,64654,293,272943,false,L-m-0 
job-5461,3,9,7,272771,337519,337574,64748,55,272939,false,C-s-1 C-l-0 C-l-0 L-m-0 C-l-0 C-l-0 L-m-0 
job-5459,1,10,1,272665,337519,337719,64854,200,272943,false,L-s-0 
job-5462,1,6,8,272830,337519,337751,64689,232,273110,false,L-m-0 C-s-1 L-s-0 C-m-0 L-m-0 C-m-0 C-m-0 C-m-0 
job-5460,3,11,4,272723,337519,337785,64796,266,273259,false,L-l-0 L-l-0 L-l-0 L-l-0 
job-5463,1,6,1,272879,337751,337800,64872,49,273145,false,L-s-0 
job-5464,6,11,8,272939,337751,337802,64812,51,273101,false,C-l-0 C-l-2 C-l-0 C-l-1 C-l-2 L-m-0 C-l-1 C-m-0 
job-5465,1,8,1,272994,337802,337824,64808,22,273123,false,L-s-0 
job-5466,3,7,6,273040,337802,337873,64762,71,273155,false,L-l-0 L-s-0 L-m-0 L-l-0 L-l-0 L-m-0 
job-5467,2,7,6,273087,337873,337884,64786,11,273367,false,L-l-0 L-l-0 L-l-0 L-l-0 L-l-0 L-l-0 
job-5468,6,6,3,273139,337873,337958,64734,85,273514,false,L-m-0 C-l-0 C-l-0 
job-5469,6,8,8,273187,337884,337980,64697,96,273556,false,L-l-0 L-l-0 C-l-1 C-l-2 C-l-2 C-m-1 C-l-1 C-m-0 
job-5470,6,6,1,273231,337884,338264,64653,380,273753,false,C-m-2 
job-5471,1,8,3,273280,338264,338323,64984,59,273500,false,L-m-0 L-m-0 L-m-0 
job-5472,5,4,5,273328,338264,338369,64936,105,273577,false,L-l-0 L-l-0 L-m-0 C-l-0 C-l-0 
job-5474,2,11,4,273434,338264,338370,64830,106,273734,false,C-m-2 L-l-0 C-l-0 C-m-2 
job-5473,4,8,4,273390,338264,338372,64874,108,273675,false,L-s-0 C-l-1 C-l-1 C-l-1 
job-5476,4,6,6,273518,338370,338434,64852,64,273607,false,L-m-0 L-l-0 C-m-0 C-m-0 L-l-0 L-l-0 
job-5477,5,5,8,273570,338372,338472,64802,100,273810,false,C-m-1 C-l-1 C-l-1 C-l-2 C-l-0 C-l-2 C-l-0 C-m-2 
job-5478,1,10,7,273619,338472,338520,64853,48,273703,false,L-m-0 L-l-0 L-l-0 L-s-0 L-l-0 L-l-0 L-m-0 
job-5479,5,7,7,273665,338472,338530,64807,58,273863,false,L-l-0 C-l-1 C-l-0 C-l-2 C-l-1 C-l-0 C-l-2 
job-5475,3,6,1,273481,338370,338589,64889,219,273752,false,L-m-0 
job-5480,2,11,1,273711,338589,338629,64878,40,273913,false,L-s-0 
job-5483,1,4,7,273869,338589,338639,64720,50,273927,false,L-m-0 L-l-0 L-l-0 C-s-1 L-l-0 L-l-0 L-s-0 
job-5484,2,10,7,273911,338629,338640,64718,11,274170,false,C-s-0 C-l-1 C-l-1 C-s-1 C-l-1 C-l-1 L-s-0 
job-5481,3,7,1,273765,338589,338650,64824,61,273912,false,L-m-0 
job-5485,6,4,1,273967,338629,338661,64662,32,274195,false,C-m-0 
job-5486,3,8,6,274029,338629,338666,64600,37,274348,false,C-s-2 C-l-0 C-l-0 C-l-1 C-l-0 C-l-0 
job-5482,2,7,6,273822,338589,338675,64767,86,273922,false,L-m-0 L-l-0 L-m-0 L-l-0 L-l-0 L-l-0 
job-5487,5,10,4,274078,338629,338687,64551,58,274394,false,C-m-2 C-l-2 C-l-2 C-m-1 
job-5490,6,9,7,274203,338687,338734,64484,47,274506,false,C-l-0 C-l-2 C-l-1 C-m-1 C-l-0 C-l-2 C-l-1 
job-5488,1,9,4,274122,338687,338736,64565,49,274361,false,L-l-0 L-l-0 L-l-0 L-l-0 
job-5489,3,7,6,274162,338687,338842,64525,155,274467,false,L-s-0 C-m-0 L-l-0 C-m-0 L-m-0 L-m-0 
job-5491,5,4,4,274254,338734,338953,64480,219,274742,false,C-m-1 L-l-0 C-l-0 C-l-0 
job-5492,3,7,5,274291,338953,338976,64662,23,274396,false,L-l-0 L-s-0 L-l-0 L-l-0 L-l-0 
job-5493,5,4,5,274341,338953,339087,64612,134,274670,false,C-l-0 C-l-1 C-l-0 L-m-0 C-l-1 
job-5494,4,10,7,274392,339087,339104,64695,17,274591,false,L-l-0 L-m-0 L-s-0 L-l-0 L-m-0 L-l-0 C-s-1 
job-5495,6,10,7,274440,339087,339368,64647,281,275020,false,C-l-0 C-l-1 C-l-2 C-l-0 C-l-1 C-l-2 C-m-0 
job-5496,5,4,7,274491,339368,339493,64877,125,274851,false,C-l-2 L-l-0 C-l-0 C-l-2 C-l-0 L-l-0 L-m-0 
job-5497,3,4,2,274535,339493,339537,64958,44,274846,false,L-m-0 L-m-0 
job-5498,4,9,1,274580,339537,339555,64957,18,274803,false,L-s-0 
job-5499,6,8,4,274623,339537,339561,64914,24,274934,false,L-m-0 L-l-0 L-l-0 C-m-0 
job-5500,5,6,7,274668,339537,339702,64869,165,274944,false,C-m-1 C-l-1 C-l-0 C-l-2 C-l-1 C-l-2 C-l-0 
job-5501,4,4,8,274712,339561,339726,64849,165,275136,false,L-s-0 L-l-0 C-m-0 L-l-0 L-l-0 L-m-0 C-m-0 L-m-0 
job-5503,3,12,6,274811,339702,339782,64891,80,274938,false,C-s-2 C-l-1 C-l-1 C-l-1 C-l-1 C-s-1 
job-5502,6,7,5,274762,339702,339782,64940,80,274859,false,C-m-1 C-l-2 C-l-0 C-l-0 C-l-2 
job-5504,4,7,5,274869,339782,339810,64913,28,275155,false,L-m-0 L-l-0 L-l-0 L-m-0 L-l-0 
job-5506,3,6,6,274972,339782,339810,64810,28,275176,false,C-m-2 C-l-1 C-l-1 C-l-1 C-l-1 C-m-2 
job-5505,4,11,1,274920,339782,339849,64862,67,275071,false,L-s-0 
job-5507,2,6,4,275013,339782,339871,64769,89,275112,false,C-m-2 C-m-1 C-s-1 C-s-1 
job-5508,2,10,3,275068,339782,339984,64714,202,275470,false,C-m-0 C-m-0 C-m-0 
job-5510,4,7,4,275164,339984,340037,64820,53,275270,false,L-s-0 L-l-0 L-l-0 L-l-0 
job-5509,5,6,5,275122,339782,340040,64660,258,275413,false,C-l-0 C-l-2 C-l-0 C-l-2 C-m-1 
job-5511,2,8,5,275218,340037,340074,64819,37,275257,false,L-s-0 C-l-0 L-s-0 C-m-1 C-l-2 
job-5513,6,9,3,275300,340037,340078,64737,41,275638,false,C-m-0 C-l-1 C-l-1 
job-5512,5,12,3,275262,340037,340190,64775,153,275417,false,L-m-0 L-l-0 L-l-0 
job-5514,5,5,6,275355,340040,340210,64685,170,275783,false,C-m-2 C-l-2 C-l-0 C-m-1 C-l-0 C-l-2 
job-5515,1,4,1,275406,340210,340261,64804,51,275606,false,L-s-0 
job-5516,5,9,2,275469,340210,340329,64741,119,275821,false,L-l-0 L-l-0 
job-5517,1,8,6,275509,340329,340361,64820,32,275726,false,L-l-0 L-l-0 L-l-0 L-l-0 L-l-0 L-l-0 
job-5518,2,7,4,275551,340329,340371,64778,42,275618,false,L-m-0 L-m-0 L-m-0 L-m-0 
job-5519,4,9,2,275599,340329,340374,64730,45,275919,false,L-s-0 C-s-1 
job-5520,2,12,6,275659,340329,340412,64670,83,275905,false,C-m-0 C-l-1 C-l-1 C-m-0 C-l-1 C-l-1 
job-5522,6,8,7,275765,340361,340451,64596,90,276125,false,C-l-2 C-l-0 C-l-2 C-m-1 L-l-0 C-l-0 L-l-0 
job-5521,3,6,2,275717,340329,340615,64612,286,276164,false,C-s-2 C-m-0 
job-5524,2,5,3,275867,340615,340629,64748,14,276009,false,L-s-0 C-s-2 C-s-2 
job-5523,4,6,5,275820,340615,340631,64795,16,276094,false,L-m-0 L-l-0 L-l-0 L-l-0 L-m-0 
job-5525,1,10,6,275908,340615,340740,64707,125,276056,false,L-s-0 C-l-1 C-l-1 C-s-1 C-l-1 C-l-1 
job-5526,2,11,8,275965,340615,340751,64650,136,276283,false,C-l-0 C-l-2 C-l-0 C-l-2 C-l-0 C-l-0 C-l-2 C-l-2 
job-5530,5,10,7,276132,340751,340770,64619,19,276379,false,C-m-2 C-l-2 C-l-2 C-m-1 C-l-0 C-l-0 C-m-0 
job-5529,3,8,8,276096,340740,340801,64644,61,276383,false,C-l-1 L-l-0 L-l-0 C-l-1 C-l-1 L-l-0 L-l-0 C-l-1 
job-5527,6,4,1,276007,340740,340838,64733,98,276393,false,L-m-0 
job-5528,3,10,1,276052,340740,340885,64688,145,276319,false,L-s-0 
job-5533,1,8,5,276280,340770,340916,64490,146,276501,false,C-s-1 C-s-2 C-m-0 C-m-0 C-m-0 
job-5532,3,6,5,276231,340770,340942,64539,172,276654,false,C-s-2 C-l-0 C-l-0 C-l-0 C-l-0 
job-5531,2,4,2,276186,340770,341011,64584,241,276679,false,C-s-1 L-m-0 
job-5535,2,11,7,276372,341011,341030,64639,19,276426,false,L-m-0 L-l-0 L-l-0 C-s-2 L-l-0 L-l-0 L-m-0 
job-5534,1,10,1,276328,341011,341033,64683,22,276573,false,L-s-0 
job-5536,5,4,7,276412,341011,341038,64599,27,276669,false,C-m-0 C-l-0 C-l-0 C-l-2 C-l-1 C-l-1 C-l-2 
job-5537,1,8,4,276461,341038,341050,64577,12,276667,false,L-m-0 L-m-0 L-m-0 L-m-0 
job-5538,2,8,2,276508,341038,341074,64530,36,276617,false,L-s-0 L-s-0 
job-5539,2,12,1,276550,341038,341318,64488,280,276912,false,L-l-0 
job-5540,2,11,2,276597,341318,341347,64721,29,276844,false,L-m-0 L-m-0 
job-5543,6,5,7,276757,341318,341387,64561,69,276844,false,C-m-2 C-l-0 C-l-0 C-m-0 C-l-1 C-l-1 C-m-1 
job-5542,2,12,8,276694,341318,341468,64624,150,276880,false,L-s-0 L-l-0 C-l-2 C-l-2 L-l-0 C-l-2 C-s-1 C-l-2 
job-5541,3,12,2,276660,341318,341513,64658,195,276856,false,L-l-0 L-l-0 
job-5544,4,9,2,276802,341468,341544,64666,76,276878,false,L-s-0 L-l-0 
job-5545,2,4,7,276849,341468,341693,64619,225,277156,false,L-l-0 L-m-0 L-m-0 C-s-1 L-m-0 L-m-0 C-s-1 
job-5546,2,10,4,276900,341693,341725,64793,32,277092,false,L-l-0 L-l-0 L-l-0 L-l-0 
job-5547,4,5,6,276956,341693,341837,64737,144,277217,false,L-l-0 L-s-0 L-m-0 C-m-0 C-m-0 L-m-0 
job-5548,3,9,5,277013,341837,341857,64824,20,277269,false,L-l-0 L-s-0 L-l-0 L-l-0 L-l-0 
job-5550,5,6,1,277112,341837,341915,64725,78,277364,false,C-m-0 
job-5551,5,12,5,277165,341837,341935,64672,98,277446,false,C-m-1 C-l-1 C-l-0 C-l-0 C-l-1 
job-5549,4,9,1,277064,341837,342085,64773,248,277513,false,L-m-0 
job-5552,1,12,6,277213,341935,342414,64722,479,277743,false,L-s-0 L-l-0 L-m-0 L-l-0 L-l-0 L-l-0 
job-5553,1,10,5,277269,342414,342482,65145,68,277519,false,L-s-0 L-l-0 L-l-0 L-l-0 L-l-0 
job-5554,3,9,6,277322,342414,342614,65092,200,277575,false,L-m-0 C-l-0 C-l-0 L-m-0 C-l-0 C-l-0 
job-5555,2,10,7,277373,342614,342651,65241,37,277576,false,L-m-0 L-l-0 L-l-0 L-m-0 L-l-0 L-l-0 L-m-0 
job-5556,4,5,8,277419,342614,342849,65195,235,277795,false,L-s-0 C-l-1 L-l-0 C-l-0 C-l-0 C-l-1 C-l-0 C-l-1 
job-5558,6,9,7,277516,342849,342874,65333,25,277789,false,L-l-0 C-l-1 C-l-0 L-m-0 C-l-0 C-l-1 L-l-0 
job-5557,5,9,2,277469,342614,342891,65145,277,277832,false,C-l-2 C-l-2 
job-5559,2,5,8,277564,342849,343092,65285,243,277986,false,C-m-0 C-m-0 C-m-0 L-m-0 L-s-0 C-l-2 C-m-0 L-s-0 
job-5560,3,5,7,277616,343092,343168,65476,76,277836,false,L-s-0 L-l-0 L-l-0 L-m-0 L-l-0 L-l-0 L-m-0 
job-5561,2,6,6,277670,343092,343572,65422,480,278257,false,C-l-0 L-m-0 C-l-0 C-l-0 C-l-0 C-l-0 
job-5562,5,4,2,277719,343572,343607,65853,35,277791,false,L-l-0 L-l-0 
job-5564,1,7,3,277811,343607,343638,65796,31,277972,false,L-s-0 L-m-0 L-s-0 
job-5563,3,12,2,277772,343572,343644,65800,72,277847,false,L-m-0 L-m-0 
job-5566,4,10,4,277894,343607,343752,65713,145,278082,false,C-m-1 C-s-1 C-s-2 C-m-1 
job-5565,5,4,7,277850,343607,343760,65757,153,278105,false,C-m-0 C-l-0 L-l-0 C-l-2 C-l-0 L-l-0 C-l-2 
job-5567,5,10,5,277932,343752,343788,65820,36,278195,false,L-m-0 C-l-1 C-m-2 C-m-1 C-l-1 
job-5568,6,12,4,277977,343760,343813,65783,53,278032,false,C-l-0 L-l-0 L-l-0 C-l-0 
job-5570,5,7,5,278076,343788,343842,65712,54,278170,false,C-m-1 C-l-1 L-m-0 C-m-2 C-l-1 
job-5569,3,7,5,278028,343760,343852,65732,92,278202,false,L-s-0 C-m-2 L-m-0 C-m-1 C-s-1 
job-5571,3,8,7,278135,343788,343973,65653,185,278429,false,C-s-2 C-l-2 C-l-2 C-m-0 C-l-2 C-l-2 C-m-0 
job-5572,4,11,5,278184,343973,344056,65789,83,278341,false,L-m-0 L-l-0 L-l-0 L-l-0 L-m-0 
job-5573,2,10,7,278221,344056,344067,65835,11,278299,false,L-m-0 L-l-0 L-l-0 L-m-0 L-l-0 L-l-0 L-m-0 
job-5574,6,5,7,278272,344056,344067,65784,11,278341,false,C-l-0 C-l-1 C-l-0 C-m-0 C-l-1 C-l-2 C-l-2 
job-5576,6,10,1,278355,344056,344174,65701,118,278622,false,C-m-1 
job-5575,4,7,2,278309,344056,344328,65747,272,278630,false,L-s-0 L-l-0 
job-5577,1,9,4,278403,344328,344350,65925,22,278527,false,L-l-0 L-l-0 L-l-0 L-l-0 
job-5578,2,8,2,278472,344328,344387,65856,59,278675,false,L-s-0 L-l-0 
job-5579,1,5,4,278519,344387,344408,65868,21,278824,false,L-m-0 L-m-0 L-m-0 L-m-0 
job-5581,6,8,7,278621,344387,344524,65766,137,279013,false,C-m-0 L-l-0 L-l-0 C-l-0 C-l-2 C-l-0 C-l-2 
job-5582,6,5,6,278672,344524,344605,65852,81,278775,false,L-l-0 C-l-0 C-l-1 C-l-1 C-l-0 L-l-0 
job-5580,3,9,2,278573,344387,344662,65814,275,279029,false,L-s-0 L-m-0 
job-5583,6,12,1,278716,344524,344709,65808,185,278919,false,C-m-0 
job-5584,1,4,2,278776,344709,344766,65933,57,279115,false,L-s-0 L-s-0 
job-5585,3,10,4,278824,344709,344788,65885,79,279041,false,L-l-0 L-l-0 L-l-0 L-l-0 
job-5586,2,11,4,278870,344709,344969,65839,260,279338,false,L-m-0 L-m-0 C-m-0 C-m-0 
job-5587,6,7,2,278919,344969,345043,66050,74,279237,false,L-l-0 L-l-0 
job-5589,4,10,3,279023,344969,345075,65946,106,279377,false,L-s-0 C-m-1 C-m-1 
job-5588,6,7,2,278972,344969,345145,65997,176,279348,false,C-m-0 L-m-0 
job-5590,4,4,1,279076,345145,345181,66069,36,279181,false,L-s-0 
job-5591,4,10,5,279127,345145,345183,66018,38,279182,false,L-m-0 L-l-0 L-l-0 L-l-0 L-m-0 
job-5592,4,9,1,279189,345145,345211,65956,66,279527,false,C-s-1 
job-5593,6,6,4,279259,345145,345371,65886,226,279779,false,C-l-0 C-l-1 C-l-1 C-l-0 
job-5594,1,5,5,279309,345371,345428,66062,57,279595,false,L-m-0 L-m-0 L-m-0 L-m-0 L-m-0 
job-5595,4,4,6,279363,345371,345680,66008,309,279713,false,L-s-0 L-l-0 C-m-0 C-m-0 L-l-0 L-l-0 
job-5597,5,10,3,279460,345680,345741,66220,61,279612,false,L-l-0 L-l-0 C-m-0 
job-5596,1,4,5,279404,345680,345816,66276,136,279754,false,L-m-0 L-m-0 L-m-0 L-m-0 L-m-0 
job-5598,2,10,3,279498,345741,345971,66243,230,279894,false,L-l-0 L-m-0 L-l-0 
job-5600,3,8,7,279592,345971,345987,66379,16,279803,false,C-m-0 L-l-0 L-l-0 C-m-0 L-l-0 L-l-0 L-s-0 
job-5599,1,8,4,279544,345971,346028,66427,57,279613,false,L-m-0 L-m-0 L-m-0 L-m-0 
job-5601,2,8,7,279644,345971,346086,66327,115,279972,false,C-l-1 C-m-0 C-l-1 C-l-1 C-l-1 C-l-1 C-l-1 
job-5602,2,6,7,279692,345971,346228,66279,257,280038,false,C-l-0 C-l-0 C-l-0 C-l-0 C-l-0 C-s-1 C-l-0 
job-5603,2,12,1,279747,346228,346251,66481,23,279976,false,L-s-0 
job-5604,5,5,4,279792,346228,346275,66436,47,280059,false,L-m-0 L-l-0 L-l-0 C-m-0 
job-5608,5,11,3,280004,346275,346299,66271,24,280176,false,C-l-1 C-m-2 C-l-1 
job-5607,5,10,1,279951,346275,346306,66324,31,280220,false,C-m-1 
job-5605,1,6,8,279847,346275,346315,66428,40,279891,false,L-l-0 L-l-0 L-l-0 L-l-0 L-l-0 L-l-0 L-l-0 L-l-0 
job-5606,5,9,4,279898,346275,346316,66377,41,280109,false,C-m-0 C-l-0 C-l-0 L-m-0 
job-5609,5,9,4,280050,346299,346467,66249,168,280223,false,C-l-2 C-l-1 C-l-1 C-l-2 
job-5612,4,12,2,280200,346467,346566,66267,99,280416,false,C-m-2 C-m-2 
job-5613,4,6,6,280251,346467,346576,66216,109,280555,false,C-s-0 C-m-0 C-l-1 C-m-0 C-l-1 C-l-1 
job-5610,3,4,5,280097,346467,346576,66370,109,280350,false,L-s-0 L-l-0 L-l-0 L-l-0 L-l-0 
job-5611,6,8,5,280158,346467,346584,66309,117,280300,false,L-m-0 C-l-0 C-l-2 C-l-2 C-l-0 
job-5615,4,7,8,280336,346576,346636,66240,60,280442,false,C-s-2 C-l-1 C-m-2 C-l-1 C-l-1 C-m-0 C-m-0 C-m-2 
job-5614,3,8,3,280291,346467,346649,66176,182,280473,false,C-s-1 C-m-1 C-m-1 
job-5617,6,12,5,280434,346649,346751,66215,102,280692,false,L-l-0 L-l-0 C-l-0 L-m-0 C-l-0 
job-5616,1,5,1,280394,346649,346979,66255,330,280946,false,L-s-0 
job-5618,5,8,1,280481,346979,347002,66498,23,280632,false,L-m-0 
job-5619,1,11,6,280535,346979,347036,66444,57,280620,false,L-m-0 L-l-0 L-m-0 L-l-0 L-l-0 L-l-0 
job-5621,3,8,6,280623,346979,347097,66356,118,280841,false,C-m-2 C-l-2 C-l-2 C-m-2 C-l-2 C-l-2 
job-5620,4,10,5,280581,346979,347105,66398,126,280873,false,L-s-0 C-l-1 C-l-1 C-s-1 C-l-1 
job-5622,5,6,5,280665,347097,347135,66432,38,280704,false,L-m-0 L-l-0 C-l-0 L-l-0 C-l-0 
job-5623,4,5,7,280704,347097,347262,66393,165,281143,false,C-m-0 C-l-2 C-l-2 C-m-1 C-m-1 C-l-2 C-m-0 
job-5624,6,12,8,280754,347262,347291,66508,29,280921,false,L-l-0 C-l-0 C-l-0 C-l-1 C-l-1 L-l-0 C-m-0 L-m-0 
job-5625,2,12,5,280809,347262,347403,66453,141,281090,false,L-m-0 C-m-1 L-s-0 C-m-1 C-m-0 
job-5626,2,4,8,280858,347403,347451,66545,48,280990,false,L-s-0 L-l-0 L-l-0 L-l-0 L-l-0 L-s-0 L-l-0 L-l-0 
job-5627,3,12,3,280904,347403,347475,66499,72,281197,false,L-m-0 C-s-1 L-m-0 
job-5628,6,4,7,280956,347403,347489,66447,86,281244,false,C-l-2 C-l-1 C-l-0 C-m-0 C-l-1 C-l-0 C-l-2 
job-5629,3,8,7,281015,347475,347495,66460,20,281286,false,L-m-0 L-l-0 L-l-0 L-l-0 L-m-0 L-l-0 L-s-0 
job-5630,4,8,4,281057,347475,347638,66418,163,281483,false,C-m-1 C-m-2 C-m-2 C-m-1 
job-5631,3,4,6,281113,347489,347973,66376,484,281813,false,C-m-0 C-l-1 C-l-1 C-m-0 C-l-1 C-l-1 
job-5632,1,7,7,281159,347973,348080,66814,107,281345,false,L-s-0 L-l-0 L-l-0 L-l-0 L-l-0 L-l-0 L-l-0 
job-5633,1,7,3,281213,348080,348096,66867,16,281344,false,L-m-0 L-m-0 L-m-0 
job-5636,5,4,5,281367,348080,348129,66713,49,281709,false,C-m-0 C-l-1 C-l-0 C-l-0 C-l-1 
job-5634,2,8,5,281269,348080,348184,66811,104,281442,false,L-l-0 L-l-0 L-m-0 L-l-0 L-l-0 
job-5635,3,5,7,281315,348080,348204,66765,124,281617,false,L-s-0 C-l-2 C-l-2 C-l-2 C-l-2 L-l-0 C-s-1 
job-5637,5,10,6,281417,348129,348390,66712,261,281909,false,C-m-0 C-l-0 C-l-1 L-m-0 C-l-1 C-l-0 
job-5638,3,8,5,281461,348129,348455,66668,326,282004,false,C-m-2 C-m-1 C-m-2 C-m-0 C-m-1 
job-5640,3,12,8,281547,348390,348472,66843,82,281903,false,L-s-0 C-l-0 C-l-0 C-l-0 C-l-0 L-m-0 C-s-1 L-m-0 
job-5639,1,12,8,281508,348390,348501,66882,111,281836,false,C-m-0 C-m-0 L-l-0 C-m-1 L-l-0 L-l-0 L-l-0 C-m-2 
job-5641,3,8,8,281597,348390,348526,66793,136,281815,false,C-l-1 C-l-2 C-l-1 C-l-1 C-l-1 C-l-2 C-l-2 C-l-2 
job-5643,6,8,5,281697,348501,348532,66804,31,281952,false,C-m-1 C-m-0 C-l-0 L-m-0 C-l-0 
job-5642,6,12,2,281655,348501,348532,66846,31,281943,false,L-l-0 L-l-0 
job-5644,5,4,2,281746,348526,348565,66780,39,281905,false,C-l-1 C-l-1 
job-5645,3,7,5,281806,348526,348601,66720,75,281939,false,L-s-0 C-l-2 C-l-2 C-l-2 C-l-2 
job-5646,5,11,4,281875,348532,348705,66657,173,282052,false,C-m-0 C-l-0 C-l-0 L-m-0 
job-5648,4,5,8,281978,348705,348738,66727,33,282261,false,L-l-0 L-m-0 C-l-0 C-l-0 C-l-0 L-s-0 L-l-0 L-l-0 
job-5647,1,9,3,281920,348705,348816,66785,111,282057,false,L-m-0 L-m-0 L-m-0 
job-5649,3,4,6,282033,348705,349006,66672,301,282447,false,C-l-2 C-l-2 C-l-2 C-m-0 C-m-0 C-l-2 
job-5650,5,7,4,282093,349006,349041,66913,35,282360,false,L-m-0 L-l-0 L-l-0 C-m-0 
job-5651,2,10,6,282137,349006,349138,66869,132,282501,false,L-m-0 C-m-1 C-m-1 C-m-0 C-m-1 L-l-0 
job-5652,4,8,2,282191,349138,349149,66947,11,282280,false,L-m-0 L-m-0 
job-5653,3,8,6,282244,349138,349239,66894,101,282403,false,L-s-0 L-l-0 L-l-0 C-s-1 L-l-0 L-l-0 
job-5655,5,4,4,282340,349239,349250,66899,11,282464,false,L-m-0 C-l-0 C-l-0 C-m-0 
job-5656,6,5,1,282404,349239,349251,66835,12,282435,false,C-m-1 
job-5654,3,5,4,282286,349239,349252,66953,13,282474,false,L-l-0 L-l-0 L-l-0 L-l-0 
job-5657,4,9,4,282470,349239,349371,66769,132,282758,false,L-s-0 C-l-1 C-l-1 C-l-1 
job-5658,1,5,2,282514,349251,349580,66737,329,283036,false,L-m-0 L-m-0 
job-5659,4,11,5,282566,349580,349609,67014,29,282743,false,L-m-0 L-l-0 L-l-0 L-l-0 L-m-0 
job-5660,6,12,1,282611,349580,349611,66969,31,282930,false,C-m-0 
job-5661,6,10,4,282651,349580,349664,66929,84,282792,false,C-l-0 C-l-1 C-l-0 C-l-1 
job-5663,6,12,6,282743,349609,349713,66866,104,283046,false,L-m-0 L-l-0 L-l-0 C-m-2 C-l-2 C-l-2 
job-5662,3,9,3,282705,349580,349759,66875,179,283135,false,C-m-1 C-m-1 L-s-0 
job-5664,4,4,8,282789,349664,349978,66875,314,283141,false,C-l-0 C-l-0 C-l-1 C-l-1 C-l-1 C-m-0 C-l-0 C-m-0 
job-5665,6,11,1,282845,349978,350034,67133,56,283196,false,L-m-0 
job-5666,4,5,6,282897,349978,350163,67081,185,283158,false,L-s-0 L-l-0 C-m-0 C-m-0 L-l-0 L-l-0 
job-5668,4,11,6,282994,350163,350176,67169,13,283184,false,L-s-0 C-m-0 L-l-0 C-m-0 L-l-0 L-l-0 
job-5669,3,11,7,283048,350163,350203,67115,40,283157,false,C-l-1 C-l-2 C-l-1 C-l-2 C-l-2 C-l-2 C-l-1 
job-5667,6,12,1,282942,350163,350259,67221,96,283235,false,L-m-0 
job-5671,3,10,8,283147,350259,350270,67112,11,283310,false,L-m-0 L-l-0 L-l-0 C-s-2 L-l-0 L-l-0 C-s-0 L-m-0 
job-5670,1,4,2,283094,350259,350286,67165,27,283236,false,L-s-0 L-s-0 
job-5672,5,9,7,283195,350259,350445,67064,186,283435,false,C-m-0 C-l-2 C-l-1 C-l-1 C-l-0 C-l-2 C-l-0 
job-5674,3,10,8,283296,350445,350511,67149,66,283496,false,C-s-0 L-l-0 L-l-0 C-s-1 L-l-0 L-m-0 L-s-0 L-l-0 
job-5675,5,6,7,283350,350445,350532,67095,87,283699,false,C-l-0 C-l-2 C-l-1 C-l-2 C-l-1 C-m-0 C-l-0 
job-5676,3,7,3,283401,350445,350560,67044,115,283645,false,C-m-1 C-m-0 C-m-1 
job-5673,2,10,2,283246,350445,350607,67199,162,283558,false,L-m-0 L-m-0 
job-5677,2,6,7,283460,350445,350694,66985,249,283972,false,C-m-2 C-l-2 C-l-0 C-m-2 C-l-1 C-m-2 C-m-1 
job-5680,5,7,7,283614,350694,350753,67080,59,283941,false,C-m-0 L-l-0 C-l-0 C-l-1 C-l-1 L-l-0 C-l-0 
job-5678,2,12,2,283506,350445,350760,66939,315,283888,false,C-s-2 C-m-2 
job-5682,6,12,7,283714,350753,350878,67039,125,284053,false,C-l-2 C-l-0 L-l-0 C-m-0 C-l-0 L-l-0 C-l-2 
job-5681,5,4,1,283655,350694,350899,67039,205,283988,false,C-m-1 
job-5679,2,4,7,283566,350694,350899,67128,205,284015,false,L-m-0 C-m-2 C-m-2 C-s-2 C-m-2 L-m-0 L-m-0 
job-5683,1,11,2,283770,350899,350966,67129,67,283878,false,L-m-0 L-m-0 
job-5684,3,9,6,283816,350899,350980,67083,81,283942,false,L-l-0 L-m-0 L-s-0 L-l-0 L-l-0 L-l-0 
job-5685,1,8,2,283856,350899,351301,67043,402,284461,false,C-s-1 C-s-1 
job-5686,1,10,2,283899,351301,351351,67402,50,284077,false,L-m-0 L-m-0 
job-5688,6,9,4,284000,351301,351374,67301,73,284172,false,L-l-0 C-l-0 C-l-0 L-l-0 
job-5687,1,7,2,283944,351301,351457,67357,156,284322,false,L-s-0 L-m-0 
job-5689,3,7,5,284039,351301,351626,67262,325,284567,false,C-l-1 C-l-1 L-s-0 C-l-1 C-l-1 
job-5691,4,11,4,284149,351626,351731,67477,105,284379,false,L-s-0 L-l-0 L-l-0 L-l-0 
job-5692,4,11,1,284205,351731,351742,67526,11,284296,false,L-s-0 
job-5690,1,4,7,284094,351626,351745,67532,119,284489,false,L-m-0 L-m-0 L-m-0 L-m-0 L-m-0 L-m-0 L-m-0 
job-5694,6,6,5,284291,351731,351780,67440,49,284557,false,L-l-0 C-l-1 C-l-0 C-l-1 C-l-0 
job-5693,2,10,1,284250,351731,351824,67481,93,284372,false,L-l-0 
job-5695,5,6,5,284342,351731,351868,67389,137,284723,false,C-m-1 C-l-2 C-m-2 C-m-0 C-l-2 
job-5697,2,4,5,284437,351868,351889,67431,21,284679,false,L-l-0 L-l-0 L-l-0 L-l-0 L-l-0 
job-5696,2,7,2,284386,351868,351898,67482,30,284715,false,L-s-0 L-s-0 
job-5700,5,6,4,284580,351868,351958,67288,90,284849,false,C-m-1 C-l-1 C-l-1 C-m-0 
job-5699,2,12,7,284542,351868,351964,67326,96,284644,false,L-m-0 C-l-2 C-l-2 C-l-2 C-l-2 L-l-0 C-s-2 
job-5701,3,12,6,284629,351958,352017,67329,59,284813,false,L-s-0 L-l-0 C-m-0 C-m-0 L-l-0 L-l-0 
job-5698,3,5,7,284491,351868,352022,67377,154,284778,false,L-m-0 C-l-0 C-l-0 C-s-1 C-l-0 C-l-0 L-m-0 
job-5702,5,4,2,284679,351958,352042,67279,84,285026,false,C-l-1 C-l-1 
job-5703,3,9,8,284729,351964,352043,67235,79,285036,false,C-m-1 C-l-2 C-l-2 L-l-0 C-l-2 C-l-2 C-s-0 C-m-1 
job-5704,2,4,5,284782,351964,352156,67182,192,285103,false,C-m-1 L-m-0 C-s-2 C-m-0 C-l-1 
job-5705,1,5,7,284848,352156,352181,67308,25,284877,false,L-l-0 L-l-0 L-l-0 L-l-0 L-l-0 L-l-0 L-l-0 
job-5706,5,8,7,284899,352156,352228,67257,72,285003,false,C-m-0 C-l-0 C-l-1 L-m-0 C-l-1 C-l-0 L-l-0 
job-5707,1,10,5,284949,352228,352316,67279,88,285296,false,L-s-0 L-l-0 L-l-0 L-l-0 L-l-0 
job-5709,6,5,6,285045,352316,352332,67271,16,285112,false,L-l-0 C-l-1 C-l-0 L-l-0 C-l-0 C-l-1 
job-5708,1,5,4,284997,352316,352341,67319,25,285279,false,L-m-0 L-m-0 L-m-0 L-m-0 
job-5710,4,8,6,285095,352316,352388,67221,72,285296,false,C-m-1 C-m-1 L-m-0 C-m-0 C-m-0 L-s-0 
job-5711,1,9,5,285146,352388,352413,67242,25,285427,false,L-l-0 L-l-0 L-l-0 L-l-0 L-l-0 
job-5713,3,8,8,285240,352388,352511,67148,123,285617,false,C-m-0 C-l-1 C-l-1 C-l-1 C-l-1 L-m-0 L-s-0 C-m-0 
job-5712,5,11,1,285196,352388,352511,67192,123,285543,false,L-m-0 
job-5715,5,6,6,285347,352511,352521,67164,10,285362,false,C-l-2 C-l-0 C-l-0 C-l-2 C-l-1 C-l-1 
job-5716,2,8,3,285389,352521,352539,67132,18,285513,false,L-s-0 L-l-0 C-m-0 
job-5714,5,5,3,285295,352511,352540,67216,29,285410,false,L-l-0 L-l-0 C-m-0 
job-5717,4,4,7,285440,352521,352607,67081,86,285805,false,L-m-0 C-l-1 C-l-1 C-m-1 C-l-1 L-m-0 C-m-1 
job-5718,2,6,8,285478,352521,352806,67043,285,286030,false,C-s-1 C-l-0 L-s-0 C-l-0 C-l-0 C-l-0 C-l-0 C-l-0 
job-5719,4,8,3,285523,352806,352938,67283,132,285717,false,L-l-0 L-l-0 L-l-0 
job-5721,4,5,3,285627,352806,352997,67179,191,285866,false,C-l-0 C-l-0 C-l-0 
job-5723,4,5,4,285723,352806,353013,67083,207,286175,false,C-s-1 C-l-1 C-l-1 C-l-1 
job-5720,3,9,3,285582,352806,353056,67224,250,286113,false,L-s-0 L-m-0 L-m-0 
job-5724,4,12,3,285761,352806,353180,67045,374,286162,false,C-l-2 C-l-2 C-l-2 
job-5725,4,9,1,285808,352938,353262,67130,324,286325,false,L-l-0 
job-5722,3,9,2,285669,352806,353317,67137,511,286334,false,C-m-2 C-m-2 
job-5726,2,11,2,285851,353262,353324,67411,62,286003,false,L-s-0 C-m-2 
job-5728,6,4,6,285950,353317,353363,67367,46,286039,false,C-m-0 C-l-1 C-l-2 C-m-2 C-l-2 C-l-1 
job-5727,5,10,5,285900,353262,353434,67362,172,286131,false,L-m-0 L-l-0 C-l-0 L-l-0 C-l-0 
job-5729,3,6,7,285991,353324,353476,67333,152,286265,false,L-s-0 C-s-1 C-s-2 C-m-1 C-s-0 L-m-0 C-m-1 
job-5730,4,9,6,286038,353434,353480,67396,46,286233,false,L-m-0 L-l-0 C-m-0 C-m-0 L-l-0 L-l-0 
job-5731,6,12,1,286081,353434,353699,67353,265,286559,false,C-m-2 
job-5733,4,5,8,286176,353699,353746,67523,47,286263,false,L-s-0 L-l-0 C-l-1 C-l-1 C-l-1 L-l-0 C-s-1 L-l-0 
job-5732,1,5,6,286126,353699,353753,67573,54,286331,false,L-m-0 L-m-0 L-m-0 L-m-0 L-m-0 L-m-0 
job-5734,6,6,2,286225,353746,353766,67521,20,286362,false,L-l-0 L-l-0 
job-5735,6,11,7,286274,353746,353770,67472,24,286502,false,C-l-0 C-l-2 C-l-1 C-m-0 C-l-1 C-l-0 C-l-2 
job-5736,1,9,3,286323,353753,353774,67430,21,286474,false,L-s-0 C-m-0 C-m-0 
job-5737,3,6,2,286367,353753,353804,67386,51,286582,false,L-s-0 L-m-0 
job-5738,2,5,1,286410,353804,353814,67394,10,286573,false,L-s-0 
job-5739,1,9,6,286459,353804,353836,67345,32,286769,false,L-l-0 L-s-0 L-l-0 L-l-0 L-l-0 L-l-0 
job-5740,2,6,8,286508,353804,353842,67296,38,286557,false,C-m-0 C-m-0 L-m-0 C-m-0 L-m-0 L-m-0 C-m-0 L-m-0 
job-5741,4,10,3,286555,353804,353901,67249,97,286938,false,C-l-0 C-l-0 C-l-0 
job-5742,4,5,8,286602,353804,354059,67202,255,286902,false,C-l-2 C-l-1 C-l-1 C-l-2 C-l-1 C-m-1 C-l-2 C-m-1 
job-5744,3,6,7,286709,354059,354076,67350,17,286765,false,L-m-0 C-l-0 C-l-0 C-s-1 C-l-0 C-l-0 L-s-0 
job-5743,5,9,3,286655,354059,354104,67404,45,286943,false,L-l-0 L-l-0 L-m-0 
job-5745,6,8,4,286761,354059,354204,67298,145,287092,false,C-l-1 C-l-2 C-l-1 C-l-2 
job-5747,6,9,4,286856,354076,354298,67220,222,287270,false,C-m-2 C-l-0 C-l-0 C-m-1 
job-5746,1,7,7,286812,354059,354335,67247,276,287169,false,C-s-1 C-m-0 L-l-0 L-s-0 L-l-0 C-m-0 C-m-0 
job-5748,6,8,7,286893,354298,354399,67405,101,287248,false,L-m-0 C-l-0 C-l-1 C-m-1 C-l-1 L-l-0 C-l-0 
job-5749,2,8,2,286937,354399,354409,67462,10,287084,false,L-s-0 L-s-0 
job-5751,1,11,4,287038,354399,354439,67361,40,287291,false,L-m-0 C-m-0 L-m-0 C-m-0 
job-5752,6,11,7,287085,354399,354441,67314,42,287204,false,C-l-0 C-l-2 C-l-1 C-m-1 C-l-2 C-l-1 C-l-0 
job-5750,1,10,4,286989,354399,354445,67410,46,287076,false,L-l-0 L-l-0 L-l-0 L-l-0 
job-5753,4,6,5,287122,354439,354454,67317,15,287237,false,L-s-0 C-s-1 L-m-0 L-m-0 L-l-0 
job-5754,5,8,7,287172,354441,354586,67269,145,287383,false,C-l-0 C-l-1 C-l-0 C-m-0 C-l-1 C-l-2 C-l-2 
job-5755,1,7,3,287218,354586,354600,67368,14,287371,false,L-m-0 L-m-0 L-m-0 
job-5758,6,12,4,287365,354586,354699,67221,113,287735,false,C-l-0 C-l-1 C-l-1 C-l-0 
job-5757,2,12,4,287320,354586,354760,67266,174,287660,false,C-l-2 C-l-2 C-l-2 C-l-2 
job-5759,3,6,6,287402,354586,354770,67184,184,287656,false,C-m-0 C-m-1 C-s-1 C-m-1 C-m-0 L-s-0 
job-5760,2,9,4,287438,354770,354854,67332,84,287603,false,L-s-0 L-m-0 C-s-0 L-m-0 
job-5756,1,11,5,287272,354586,354892,67314,306,287658,false,L-l-0 L-l-0 L-m-0 L-l-0 L-l-0 
job-5762,4,4,4,287546,354854,354949,67308,95,287692,false,L-m-0 L-s-0 L-l-0 C-s-1 
job-5761,4,6,5,287490,354770,354951,67280,181,287809,false,C-m-0 C-l-2 C-l-2 C-m-0 C-l-2 
job-5763,1,8,1,287595,354949,354983,67354,34,287872,false,L-s-0 
job-5764,5,10,8,287644,354949,355131,67305,182,288080,false,C-m-1 L-l-0 L-l-0 C-l-1 C-l-0 C-l-1 C-l-0 L-m-0 
job-5765,6,5,1,287700,355131,355170,67431,39,287777,false,L-m-0 
job-5767,5,11,6,287813,355131,355206,67318,75,287941,false,C-l-0 C-l-1 C-l-1 C-l-2 C-l-0 C-l-2 
job-5766,3,6,3,287762,355131,355252,67369,121,287997,false,L-l-0 L-l-0 L-l-0 
job-5768,5,12,8,287857,355206,355301,67349,95,288102,false,L-m-0 C-l-2 C-l-0 C-l-1 C-l-1 C-l-0 C-l-2 C-m-0 
job-5770,6,6,3,287952,355301,355355,67349,54,288103,false,L-l-0 L-l-0 C-m-0 
job-5769,3,11,2,287902,355301,355368,67399,67,288085,false,L-m-0 L-m-0 
job-5772,1,7,4,288040,355301,355401,67261,100,288411,false,C-m-1 C-m-1 L-s-0 C-m-1 
job-5771,1,9,4,287992,355301,355465,67309,164,288224,false,L-s-0 L-m-0 C-m-0 C-m-0 
job-5774,6,7,8,288144,355465,355475,67321,10,288229,false,C-l-0 C-l-2 C-l-1 C-l-2 C-l-0 L-l-0 C-l-1 L-l-0 
job-5773,3,7,3,288085,355465,355554,67380,89,288225,false,L-m-0 L-m-0 L-s-0 
job-5775,6,7,3,288190,355465,355849,67275,384,288670,false,C-m-0 C-m-1 C-m-2 
job-5778,3,10,3,288333,355849,355873,67516,24,288439,false,C-s-1 C-m-0 C-m-0 
job-5776,2,10,3,288231,355849,355888,67618,39,288391,false,L-m-0 L-m-0 L-m-0 
job-5777,3,11,6,288276,355849,355909,67573,60,288373,false,L-s-0 L-l-0 L-l-0 C-s-0 L-l-0 L-l-0 
job-5780,2,8,8,288435,355849,355999,67414,150,288633,false,C-l-1 C-l-2 C-l-2 C-l-2 C-l-0 C-m-0 C-l-2 C-l-2 
job-5779,5,8,4,288372,355849,356048,67477,199,288644,false,C-l-0 C-l-1 C-l-1 C-l-0 
job-5781,2,4,6,288488,356048,356073,67560,25,288747,false,L-l-0 L-l-0 L-l-0 L-l-0 L-l-0 L-l-0 
job-5783,5,7,6,288596,356048,356097,67452,49,288711,false,C-m-0 C-l-0 C-l-1 L-m-0 C-l-0 C-l-1 
job-5782,3,12,1,288545,356048,356105,67503,57,288867,false,L-s-0 
job-5784,6,5,1,288663,356048,356209,67385,161,288888,false,C-m-1 
job-5785,5,6,1,288711,356209,356255,67498,46,288912,false,L-m-0 
job-5786,3,7,5,288773,356209,356285,67436,76,288942,false,L-l-0 L-l-0 L-m-0 L-l-0 L-l-0 
job-5787,4,4,6,288823,356209,356367,67386,158,289149,false,C-m-0 C-l-1 L-s-0 C-m-0 C-l-1 C-l-1 
job-5788,2,7,5,288883,356367,356407,67484,40,289095,false,L-l-0 L-l-0 L-l-0 L-l-0 L-l-0 
job-5789,5,9,5,288931,356367,356500,67436,133,289118,false,C-l-1 C-l-1 C-l-0 L-m-0 C-l-0 
job-5790,5,11,8,288975,356500,356679,67525,179,289189,false,C-m-0 C-l-0 C-l-0 C-l-1 C-l-1 L-l-0 L-m-0 L-l-0 
job-5791,2,11,5,289006,356679,356716,67673,37,289153,false,L-s-0 L-l-0 L-l-0 L-l-0 L-l-0 
job-5792,5,9,8,289057,356679,356783,67622,104,289235,false,C-m-0 C-l-1 C-l-0 C-l-2 C-l-1 C-l-0 C-l-2 L-m-0 
job-5793,4,11,8,289108,356783,356800,67675,17,289277,false,L-l-0 L-m-0 L-l-0 L-m-0 C-m-1 L-s-0 L-l-0 C-m-1 
job-5794,2,12,3,289155,356783,356813,67628,30,289332,false,C-l-0 C-l-0 C-l-0 
job-5795,6,5,4,289206,356783,356863,67577,80,289553,false,C-m-0 C-l-2 C-l-2 C-l-0 
job-5796,1,4,2,289257,356863,356888,67606,25,289566,false,L-s-0 L-s-0 
job-5797,6,10,4,289307,356863,356918,67556,55,289427,false,L-m-0 L-l-0 L-l-0 C-m-0 
job-5798,5,5,4,289358,356863,356947,67505,84,289631,false,C-l-0 C-l-0 C-l-1 C-l-1 
job-5800,1,6,8,289444,356947,356977,67503,30,289530,false,L-l-0 L-l-0 L-l-0 L-l-0 L-l-0 L-l-0 L-l-0 L-l-0 
job-5799,1,6,2,289396,356947,357027,67551,80,289490,false,L-s-0 L-s-0 
job-5801,4,8,3,289498,356947,357094,67449,147,289750,false,L-m-0 C-s-1 L-m-0 
job-5803,5,4,7,289602,356947,357152,67345,205,289859,false,C-l-0 C-l-2 C-l-0 C-m-1 C-l-1 C-l-1 C-l-2 
job-5802,4,6,2,289556,356947,357162,67391,215,289958,false,C-m-0 C-m-0 
job-5805,2,5,6,289705,357152,357164,67447,12,289955,false,C-s-2 L-s-0 L-l-0 L-m-0 L-s-0 C-s-2 
job-5804,5,5,3,289649,357152,357169,67503,17,289768,false,L-l-0 L-m-0 L-l-0 
job-5806,5,9,7,289758,357152,357232,67394,80,290130,false,C-m-1 C-l-1 C-l-1 C-l-2 C-l-0 C-l-2 C-l-0 
job-5807,3,8,1,289804,357232,357266,67428,34,289858,false,L-s-0 
job-5808,2,10,2,289855,357232,357490,67377,258,290297,false,L-m-0 L-m-0 
job-5809,1,4,2,289903,357490,357593,67587,103,290012,false,L-s-0 L-s-0 
job-5810,1,9,3,289956,357593,357625,67637,32,290078,false,L-m-0 L-m-0 L-m-0 
job-5811,5,11,8,290002,357593,357688,67591,95,290174,false,C-l-2 C-l-1 C-l-0 C-l-0 C-l-1 L-l-0 C-l-2 L-l-0 
job-5812,5,12,5,290052,357688,357704,67636,16,290113,false,L-m-0 L-l-0 C-l-0 L-l-0 C-l-0 
job-5813,6,8,1,290103,357704,357714,67601,10,290386,false,L-m-0 
job-5815,1,6,8,290202,357704,357746,67502,42,290521,false,C-s-1 L-l-0 L-s-0 L-s-0 L-l-0 L-m-0 C-s-1 L-m-0 
job-5816,3,11,5,290246,357746,357757,67500,11,290515,false,L-s-0 L-m-0 L-l-0 C-s-2 L-m-0 
job-5814,3,11,3,290149,357704,357767,67555,63,290447,false,L-l-0 L-l-0 L-l-0 
job-5817,4,9,4,290300,357746,357783,67446,37,290384,false,C-l-0 C-l-0 C-l-0 C-s-1 
job-5818,4,5,1,290351,357746,357878,67395,132,290762,false,C-s-0 
job-5819,2,6,1,290385,357878,357914,67493,36,290692,false,L-s-0 
job-5821,5,9,4,290482,357914,357929,67432,15,290746,false,L-m-0 L-l-0 L-l-0 C-m-0 
job-5822,4,6,1,290524,357914,357956,67390,42,290809,false,C-s-1 
job-5823,1,10,7,290577,357929,358027,67352,98,290952,false,L-s-0 L-l-0 L-l-0 L-m-0 L-l-0 L-l-0 L-m-0 
job-5824,3,9,4,290632,357929,358033,67297,104,291033,false,C-l-0 C-l-0 C-l-0 L-m-0 
job-5820,2,4,1,290430,357914,358094,67484,180,290792,false,L-s-0 
job-5827,4,6,8,290761,358094,358178,67333,84,291059,false,L-s-0 C-l-2 L-m-0 C-l-2 C-l-2 C-m-0 C-m-0 L-m-0 
job-5825,4,12,3,290684,357929,358192,67245,263,290999,false,C-l-1 C-l-1 C-l-1 
job-5826,5,6,2,290718,358094,358226,67376,132,291148,false,L-l-0 L-l-0 
job-5828,2,6,8,290803,358094,358531,67291,437,291376,false,C-m-1 C-m-1 C-m-1 C-m-2 C-m-1 C-m-2 L-l-0 C-m-2 
job-5829,1,11,8,290859,358531,358607,67672,76,291031,false,L-s-0 L-l-0 L-l-0 L-l-0 L-l-0 L-m-0 C-s-1 L-m-0 
job-5831,6,12,3,290973,358531,358709,67558,178,291379,false,C-m-1 C-l-2 C-l-2 
job-5830,6,5,6,290920,358531,358783,67611,252,291363,false,C-m-0 C-l-1 C-l-0 L-m-0 C-l-1 C-l-0 
job-5832,6,4,2,291030,358783,358840,67753,57,291252,false,L-l-0 L-l-0 
job-5833,3,9,5,291096,358783,358901,67687,118,291355,false,L-s-0 C-m-1 L-m-0 L-m-0 C-m-1 
job-5834,2,4,2,291139,358901,359082,67762,181,291572,false,L-s-0 L-s-0 
job-5835,2,10,4,291189,358901,359103,67712,202,291625,false,L-l-0 L-l-0 L-l-0 L-l-0 
job-5839,1,9,7,291419,359103,359122,67684,19,291564,false,C-l-0 C-l-0 C-l-0 C-m-0 C-l-0 C-l-0 C-m-0 
job-5837,2,4,7,291307,359103,359135,67796,32,291587,false,L-l-0 L-l-0 L-l-0 L-l-0 L-l-0 L-l-0 L-m-0 
job-5838,1,12,3,291360,359103,359145,67743,42,291454,false,L-m-0 L-m-0 C-s-1 
job-5840,5,12,4,291474,359103,359279,67629,176,291929,false,C-m-1 C-l-2 C-l-2 C-m-0 
job-5836,3,8,1,291247,359103,359283,67856,180,291707,false,L-s-0 
job-5841,3,10,7,291535,359103,359433,67568,330,292015,false,C-s-0 C-l-1 C-l-1 C-m-1 C-l-1 C-l-1 C-s-2 
job-5842,4,12,3,291591,359433,359545,67842,112,291747,false,L-m-0 L-m-0 L-s-0 
job-5843,5,12,8,291650,359433,359571,67783,138,291915,false,L-l-0 L-l-0 C-l-0 C-l-1 C-l-1 C-l-2 C-l-2 C-l-0 
job-5844,1,12,8,291697,359571,359584,67874,13,291726,false,L-m-0 L-l-0 L-s-0 L-l-0 L-l-0 L-l-0 C-s-1 L-m-0 
job-5845,5,5,2,291753,359571,359609,67818,38,291793,false,C-m-0 L-m-0 
job-5846,1,5,4,291797,359571,359616,67774,45,292042,false,C-m-0 C-m-0 C-s-0 C-m-0 
job-5847,4,9,8,291841,359571,359686,67730,115,292207,false,C-l-0 C-l-1 C-l-1 C-l-0 C-l-1 C-m-1 C-l-0 C-m-1 
job-5848,6,9,8,291890,359686,359803,67796,117,292141,false,L-l-0 C-l-0 C-l-2 C-l-2 C-l-0 L-l-0 C-m-0 L-m-0 
job-5849,5,11,5,291934,359803,359905,67869,102,292279,false,L-l-0 L-l-0 C-l-0 L-m-0 C-l-0 
job-5850,1,6,6,291986,359905,360250,67919,345,292474,false,L-l-0 L-l-0 L-l-0 L-l-0 L-l-0 L-l-0 
job-5851,4,8,5,292027,359905,360253,67878,348,292436,false,L-s-0 L-m-0 L-m-0 C-s-1 L-l-0 
job-5852,3,11,3,292084,360250,360331,68166,81,292372,false,L-l-0 C-s-2 L-l-0 
job-5854,2,4,7,292190,360250,360353,68060,103,292415,false,L-l-0 C-m-0 C-l-0 C-l-0 C-l-0 C-l-0 C-l-0 
job-5853,3,11,2,292139,360250,360446,68111,196,292409,false,C-m-0 C-m-0 
job-5855,5,5,4,292237,360250,360572,68013,322,292626,false,C-l-1 C-l-2 C-l-1 C-l-2 
job-5856,1,10,4,292286,360572,360642,68286,70,292478,false,L-l-0 L-l-0 L-l-0 L-l-0 
job-5857,6,11,7,292333,360572,360732,68239,160,292604,false,L-m-0 C-l-0 C-l-1 C-l-2 C-l-1 C-l-2 C-l-0 
job-5858,5,11,4,292374,360642,360815,68268,173,292835,false,C-m-1 L-l-0 L-l-0 C-m-0 
job-5859,5,10,2,292409,360815,360837,68406,22,292538,false,L-l-0 L-l-0 
job-5862,6,10,8,292566,360815,360879,68249,64,292893,false,C-l-0 C-l-2 C-l-1 C-l-0 C-l-2 C-m-2 C-l-1 C-m-0 
job-5861,6,11,1,292515,360815,361043,68300,228,292855,false,C-m-1 
job-5860,2,4,6,292456,360815,361050,68359,235,292921,false,L-l-0 L-s-0 L-m-0 L-s-0 L-m-0 L-m-0 
job-5864,5,12,8,292686,361050,361161,68364,111,293013,false,C-l-2 C-l-1 C-l-0 C-l-1 L-m-0 C-l-0 C-l-2 C-m-2 
job-5863,1,9,5,292625,361050,361167,68425,117,292983,false,L-l-0 L-l-0 L-l-0 L-l-0 L-l-0 
job-5865,5,5,4,292732,361161,361698,68429,537,293549,false,L-m-0 C-l-0 C-m-0 C-l-0 
job-5866,4,10,2,292785,361698,361732,68913,34,292946,false,L-m-0 L-m-0 
job-5867,4,5,7,292839,361698,361745,68859,47,293021,false,L-l-0 L-s-0 C-l-2 L-l-0 C-l-2 C-l-2 L-l-0 
job-5868,6,8,4,292880,361698,361752,68818,54,292986,false,C-l-1 C-l-1 C-l-0 C-l-0 
job-5869,2,12,5,292931,361745,361756,68814,11,292978,false,L-s-0 L-l-0 L-l-0 L-l-0 L-l-0 
job-5871,1,8,5,293037,361745,361791,68708,46,293206,false,C-m-0 L-m-0 C-m-0 C-m-0 L-m-0 
job-5872,6,12,4,293095,361745,361792,68650,47,293190,false,C-m-2 C-l-2 C-l-2 C-m-1 
job-5873,4,10,4,293155,361791,361813,68636,22,293425,false,L-s-0 L-l-0 L-l-0 L-l-0 
job-5870,3,4,2,292985,361745,361820,68760,75,293278,false,L-m-0 L-m-0 
job-5875,1,12,6,293252,361792,361870,68540,78,293574,false,C-l-0 L-m-0 L-m-0 C-l-0 C-l-0 C-l-0 
job-5874,4,7,5,293207,361791,361903,68584,112,293412,false,C-m-0 C-l-1 C-l-1 C-m-0 C-l-1 
job-5877,4,8,2,293349,361792,361972,68443,180,293735,false,C-m-1 C-s-1 
job-5876,1,10,2,293296,361792,361985,68496,193,293503,false,C-m-1 C-m-1 
job-5878,1,6,8,293403,361972,361986,68569,14,293701,false,C-m-1 C-m-1 L-m-0 L-s-0 L-m-0 L-m-0 L-s-0 L-m-0 
job-5879,3,5,7,293445,361972,362352,68527,380,293972,false,C-m-0 L-l-0 L-m-0 L-l-0 L-l-0 L-l-0 C-m-0 
job-5880,1,6,2,293493,362352,362443,68859,91,293680,false,L-s-0 L-s-0 
job-5881,3,9,3,293537,362443,362464,68906,21,293591,false,L-m-0 L-m-0 L-s-0 
job-5883,5,12,4,293632,362443,362479,68811,36,293937,false,C-l-0 C-l-0 L-l-0 L-l-0 
job-5882,1,12,3,293577,362443,362580,68866,137,293823,false,L-l-0 L-m-0 L-l-0 
job-5884,4,5,4,293692,362443,362618,68751,175,294002,false,C-l-1 C-l-1 C-l-1 C-s-1 
job-5885,1,11,4,293743,362618,362644,68875,26,293943,false,L-l-0 L-l-0 L-l-0 L-l-0 
job-5886,6,4,7,293791,362618,362774,68827,156,294050,false,L-l-0 C-l-1 C-l-0 C-m-0 C-l-1 L-m-0 C-l-0 
job-5888,1,7,4,293907,362774,362865,68867,91,294125,false,L-m-0 L-l-0 L-l-0 L-l-0 
job-5889,1,9,4,293952,362774,362923,68822,149,294198,false,L-s-0 L-l-0 L-l-0 L-l-0 
job-5887,1,12,2,293846,362774,362931,68928,157,294282,false,L-m-0 L-m-0 
job-5890,2,10,3,293998,362774,363036,68776,262,294508,false,C-m-0 C-m-0 C-m-0 
job-5891,3,4,4,294044,363036,363055,68992,19,294274,false,L-l-0 L-l-0 L-l-0 L-l-0 
job-5892,4,9,5,294103,363036,363083,68933,47,294285,false,C-m-0 L-m-0 L-s-0 C-m-0 L-m-0 
job-5894,6,7,8,294202,363055,363119,68853,64,294468,false,L-l-0 C-l-2 C-l-0 C-l-1 C-l-0 C-l-1 C-l-2 L-l-0 
job-5893,6,5,1,294157,363036,363193,68879,157,294530,false,C-m-1 
job-5895,2,6,4,294247,363055,363307,68808,252,294644,false,C-m-2 C-m-1 C-m-2 C-m-2 
job-5896,1,11,3,294292,363307,363347,69015,40,294470,false,L-l-0 L-l-0 L-l-0 
job-5897,1,10,6,294338,363307,363509,68969,202,294773,false,L-m-0 C-s-1 L-l-0 L-s-0 L-m-0 L-m-0 
job-5899,4,6,6,294429,363509,363529,69080,20,294740,false,C-m-0 C-l-1 C-l-1 L-m-0 C-l-1 C-m-0 
job-5900,5,6,6,294488,363509,363551,69021,42,294701,false,C-m-2 C-l-2 C-l-0 C-m-1 C-l-0 C-l-2 
job-5898,1,12,7,294387,363509,363559,69122,50,294726,false,L-s-0 L-l-0 L-l-0 L-m-0 L-l-0 L-l-0 L-m-0 
job-5901,1,8,1,294543,363559,363588,69016,29,294727,false,L-s-0 
job-5902,5,11,8,294598,363559,363622,68961,63,294843,false,C-m-0 L-l-0 C-l-1 C-l-0 C-l-1 L-l-0 C-l-0 L-m-0 
job-5903,5,11,7,294643,363622,363682,68979,60,294721,false,C-l-1 L-l-0 C-l-0 C-l-1 C-l-0 L-l-0 L-m-0 
job-5904,6,7,3,294699,363622,363888,68923,266,295072,false,C-m-0 C-l-2 C-l-2 
job-5907,4,6,8,294848,363888,363914,69040,26,294961,false,C-l-1 C-l-1 C-l-2 C-l-2 C-l-1 C-m-1 C-l-2 C-m-1 
job-5906,4,10,7,294806,363888,363916,69082,28,295094,false,L-m-0 L-m-0 L-l-0 C-m-0 L-l-0 L-l-0 C-m-0 
job-5905,2,10,1,294758,363888,364014,69130,126,295173,false,L-s-0 
job-5908,5,9,5,294897,363914,364057,69017,143,295182,false,C-l-0 C-l-1 C-l-0 C-m-1 C-l-1 
job-5909,4,6,6,294940,364057,364089,69117,32,295081,false,L-m-0 L-s-0 L-l-0 L-l-0 L-m-0 L-l-0 
job-5910,6,6,3,294978,364057,364323,69079,266,295398,false,C-l-1 C-m-0 C-l-1 
job-5911,2,7,2,295020,364323,364510,69303,187,295321,false,L-s-0 L-s-0 
job-5913,4,9,6,295128,364510,364550,69382,40,295197,false,L-s-0 C-m-0 L-l-0 C-m-0 L-l-0 L-l-0 
job-5914,6,4,2,295177,364510,364560,69333,50,295501,false,C-l-0 C-l-0 
job-5912,3,4,2,295067,364323,364748,69256,425,295594,false,L-m-0 L-m-0 
job-5915,1,5,2,295220,364748,364778,69528,30,295286,false,L-s-0 L-s-0 
job-5917,4,11,8,295313,364748,364798,69435,50,295631,false,L-l-0 L-l-0 C-l-1 C-l-1 C-l-1 L-l-0 C-m-0 C-m-0 
job-5918,5,11,7,295367,364798,364844,69431,46,295640,false,C-m-0 L-l-0 C-l-0 C-l-2 C-l-0 L-l-0 C-l-2 
job-5916,1,12,2,295262,364748,364865,69486,117,295487,false,L-m-0 L-m-0 
job-5920,5,10,4,295463,364844,364953,69381,109,295789,false,C-l-0 L-l-0 L-l-0 C-l-0 
job-5919,4,5,6,295421,364798,364958,69377,160,295730,false,L-s-0 C-l-1 L-m-0 C-s-1 C-l-1 C-l-1 
job-5921,3,7,5,295512,364844,365083,69332,239,296004,false,C-s-2 C-l-2 C-l-2 C-l-2 C-l-2 
job-5923,3,10,4,295601,365083,365105,69482,22,295649,false,L-l-0 L-l-0 L-l-0 L-l-0 
job-5922,1,7,3,295545,364958,365114,69413,156,295767,false,L-s-0 L-s-0 C-s-2 
job-5924,5,4,1,295657,365083,365161,69426,78,295861,false,L-m-0 
job-5925,2,12,4,295706,365083,365303,69377,220,295936,false,L-m-0 C-l-0 C-l-0 C-l-0 
job-5927,2,5,7,295790,365303,365342,69513,39,296056,false,L-m-0 L-s-0 L-s-0 C-s-1 L-m-0 L-m-0 C-s-1 
job-5926,2,8,6,295756,365303,365370,69547,67,295911,false,L-l-0 L-l-0 L-l-0 L-l-0 L-l-0 L-l-0 
job-5930,5,5,5,295942,365370,365391,69428,21,296232,false,C-l-1 L-m-0 L-l-0 C-l-1 L-l-0 
job-5929,3,8,4,295877,365303,365401,69426,98,296128,false,C-l-0 C-l-0 C-l-0 C-l-0 
job-5928,3,4,2,295837,365303,365416,69466,113,296016,false,C-m-0 C-m-0 
job-5931,2,8,4,295995,365391,365475,69396,84,296232,false,L-m-0 C-m-0 L-m-0 L-m-0 
job-5935,6,12,6,296205,365475,365502,69270,27,296444,false,C-m-0 C-l-2 C-l-2 C-m-2 C-l-1 C-l-1 
job-5934,4,9,7,296155,365475,365503,69320,28,296364,false,C-s-2 C-l-0 L-l-0 C-m-1 C-l-0 C-l-0 C-m-1 
job-5933,4,6,4,296086,365475,365512,69389,37,296272,false,L-m-0 L-l-0 L-l-0 L-m-0 
job-5932,1,6,1,296044,365475,365544,69431,69,296169,false,L-s-0 
job-5936,6,6,7,296262,365503,365586,69241,83,296610,false,C-l-0 C-l-0 C-l-2 C-l-2 C-l-1 C-l-1 C-m-0 
job-5937,5,10,8,296326,365586,365602,69260,16,296354,false,L-l-0 C-l-0 C-l-1 C-l-1 C-l-0 L-l-0 C-m-0 L-m-0 
job-5938,1,4,4,296394,365602,365632,69208,30,296550,false,L-s-0 L-s-0 L-s-0 L-s-0 
job-5939,6,12,5,296437,365602,365704,69165,102,296539,false,L-l-0 C-l-0 L-l-0 L-m-0 C-l-0 
job-5940,2,10,4,296488,365704,365728,69216,24,296697,false,L-l-0 L-l-0 L-l-0 L-l-0 
job-5943,5,6,7,296644,365704,365732,69060,28,296920,false,C-l-0 C-l-1 C-l-1 C-l-2 C-l-0 C-l-2 C-m-0 
job-5941,6,12,1,296543,365704,365813,69161,109,296662,false,L-m-0 
job-5942,2,4,7,296593,365704,365837,69111,133,296969,false,L-l-0 L-s-0 L-l-0 C-s-1 L-s-0 L-m-0 C-s-1 
job-5944,3,11,3,296700,365704,366052,69004,348,297221,false,C-m-1 C-m-0 C-m-1 
job-5945,2,4,3,296746,366052,366381,69306,329,297335,false,L-m-0 L-m-0 L-m-0 
job-5949,4,4,8,296944,366381,366436,69437,55,297040,false,C-m-0 L-l-0 C-m-1 C-m-2 C-m-0 C-m-2 L-s-0 C-m-1 
job-5946,2,6,4,296787,366381,366453,69594,72,296933,false,L-m-0 L-m-0 L-m-0 L-m-0 
job-5948,5,11,6,296884,366381,366457,69497,76,296961,false,C-l-2 C-l-0 C-l-1 C-l-2 C-l-0 C-l-1 
job-5947,4,12,2,296839,366381,366478,69542,97,297053,false,L-l-0 L-l-0 
job-5950,2,7,4,296995,366478,366489,69483,11,297075,false,L-m-0 L-m-0 L-m-0 L-m-0 
job-5952,6,4,6,297083,366478,366625,69395,147,297236,false,C-m-0 C-l-1 C-l-1 C-m-1 C-l-2 C-l-2 
job-5951,5,12,4,297039,366478,366825,69439,347,297501,false,L-l-0 L-l-0 C-l-0 C-l-0 
job-5953,3,7,2,297137,366625,366830,69488,205,297545,false,L-m-0 L-m-0 
job-5954,2,9,5,297186,366825,366975,69639,150,297459,false,L-l-0 L-l-0 L-m-0 L-l-0 L-l-0 
job-5955,1,11,8,297243,366975,366986,69732,11,297445,false,L-s-0 L-l-0 L-l-0 L-l-0 L-l-0 L-m-0 C-s-1 L-m-0 
job-5959,4,5,5,297457,366986,367038,69529,52,297517,false,C-m-0 C-l-1 C-l-1 C-m-0 C-l-1 
job-5957,2,5,2,297365,366986,367051,69621,65,297584,false,L-s-0 L-s-0 
job-5956,2,5,4,297321,366986,367059,69665,73,297610,false,L-m-0 L-m-0 L-m-0 L-m-0 
job-5958,2,7,7,297414,366986,367063,69572,77,297587,false,L-l-0 L-l-0 L-l-0 L-l-0 C-s-2 L-l-0 C-s-2 
job-5960,5,7,8,297512,367038,367124,69526,86,297819,false,C-m-0 C-l-1 C-l-1 C-l-2 C-l-0 C-l-0 C-l-2 C-m-1 
job-5961,1,6,1,297568,367124,367269,69556,145,297940,false,L-s-0 
job-5963,1,9,8,297693,367124,367269,69431,145,297859,false,C-m-0 C-l-0 C-l-0 C-l-0 C-l-0 L-m-0 C-l-0 C-m-0 
job-5962,3,8,8,297626,367124,367373,69498,249,298155,false,L-m-0 L-l-0 L-l-0 L-l-0 L-l-0 L-s-0 C-s-1 L-m-0 
job-5964,1,7,1,297739,367373,367432,69634,59,298013,false,L-s-0 
job-5968,2,11,5,297926,367373,367512,69447,139,298298,false,C-s-2 C-l-2 C-l-2 C-l-2 C-l-2 
job-5967,2,5,7,297875,367373,367546,69498,173,298085,false,C-s-1 L-m-0 L-m-0 C-s-1 C-m-0 C-s-2 L-s-0 
job-5966,6,5,3,297827,367373,367552,69546,179,298225,false,C-l-0 C-l-0 C-m-0 
job-5965,4,4,4,297779,367373,367594,69594,221,298001,false,L-m-0 L-l-0 L-l-0 L-l-0 
job-5969,2,6,1,297978,367594,367614,69616,20,298108,false,L-s-0 
job-5970,6,8,5,298042,367594,367643,69552,49,298125,false,L-m-0 L-l-0 C-l-1 L-l-0 C-l-1 
job-5971,2,11,8,298100,367594,367752,69494,158,298515,false,C-l-0 L-m-0 C-l-2 C-l-2 C-l-0 C-l-2 C-l-2 C-l-0 
job-5972,5,9,8,298140,367752,367767,69612,15,298317,false,L-l-0 C-l-0 C-l-1 C-l-1 C-l-0 L-l-0 C-m-0 L-m-0 
job-5973,1,12,1,298193,367767,367862,69574,95,298321,false,L-s-0 
job-5974,3,11,5,298249,367767,367933,69518,166,298681,false,L-m-0 L-l-0 L-l-0 L-l-0 L-l-0 
job-5976,2,5,5,298364,367933,367989,69569,56,298699,false,L-l-0 L-l-0 L-l-0 L-l-0 L-l-0 
job-5975,1,7,2,298303,367933,368006,69630,73,298500,false,L-s-0 L-s-0 
job-5977,2,4,4,298429,367933,368148,69504,215,298709,false,L-m-0 L-l-0 L-m-0 L-m-0 
job-5978,4,9,2,298476,368148,368169,69672,21,298653,false,L-m-0 L-m-0 
job-5979,5,6,5,298517,368148,368197,69631,49,298779,false,C-m-0 L-l-0 C-l-0 L-l-0 C-l-0 
job-5980,2,11,7,298561,368148,368339,69587,191,298940,false,C-l-1 C-l-0 C-m-0 C-l-1 L-l-0 C-l-1 C-l-1 
job-5981,6,10,3,298612,368339,368353,69727,14,298862,false,L-l-0 L-l-0 L-m-0 
job-5982,6,7,5,298661,368339,368384,69678,45,298812,false,C-l-0 C-l-0 C-l-2 C-m-0 C-l-2 
job-5983,3,8,7,298709,368339,368389,69630,50,298941,false,L-s-0 C-l-1 C-l-1 C-m-1 C-l-1 C-l-1 C-m-1 
job-5984,4,10,3,298767,368339,368555,69572,216,299053,false,C-s-1 C-m-2 C-m-2 
job-5985,3,8,7,298830,368555,368572,69725,17,298895,false,L-s-0 L-l-0 L-l-0 L-m-0 L-l-0 L-l-0 L-m-0 
job-5986,3,10,8,298874,368555,368878,69681,323,299348,false,C-l-0 C-l-0 C-l-1 C-l-0 C-l-1 C-l-1 C-l-1 C-l-0 
job-5987,1,11,2,298918,368878,369100,69960,222,299202,false,L-m-0 L-m-0 
job-5988,1,7,5,298963,369100,369118,70137,18,299102,false,L-l-0 L-l-0 L-l-0 L-l-0 L-l-0 
job-5989,5,7,1,299030,369118,369220,70088,102,299333,false,L-m-0 
job-5990,1,5,2,299076,369220,369251,70144,31,299233,false,L-s-0 L-s-0 
job-5992,5,9,4,299185,369220,369261,70035,41,299345,false,L-m-0 C-l-0 C-l-0 C-m-0 
job-5993,6,7,3,299218,369220,369292,70002,72,299577,false,C-m-1 C-l-1 C-l-1 
job-5991,5,7,2,299130,369220,369324,70090,104,299429,false,L-l-0 L-l-0 
job-5995,3,7,4,299326,369261,369377,69935,116,299546,false,C-l-0 C-l-0 C-l-0 C-l-0 
job-5994,3,9,2,299275,369261,369387,69986,126,299474,false,L-m-0 L-m-0 
job-5996,2,5,2,299376,369324,369539,69948,215,299809,false,L-s-0 L-m-0 
job-5997,2,11,6,299422,369539,369559,70117,20,299473,false,L-m-0 L-l-0 L-l-0 L-m-0 L-l-0 L-l-0 
job-5999,6,4,3,299507,369539,369568,70032,29,299795,false,C-l-0 C-m-0 C-l-0 
job-5998,2,6,3,299467,369539,369789,70072,250,299856,false,L-s-0 L-m-0 L-s-0 
job-6000,2,4,8,299548,369789,369827,70241,38,299650,false,L-s-0 L-l-0 L-l-0 L-l-0 L-l-0 L-s-0 L-l-0 L-l-0 
job-6001,2,9,4,299600,369789,370137,70189,348,300074,false,L-m-0 L-m-0 L-m-0 C-s-1 
job-6002,3,8,5,299654,370137,370201,70483,64,299891,false,L-l-0 L-s-0 L-l-0 L-l-0 L-l-0 
job-6003,5,5,7,299695,370137,370266,70442,129,300031,false,L-m-0 C-l-1 C-l-0 C-l-1 C-l-0 C-l-2 C-l-2 
job-6004,5,9,7,299747,370266,370415,70519,149,300114,false,C-l-1 L-l-0 C-l-0 C-l-1 C-l-0 L-l-0 L-m-0 
job-6006,4,10,7,299839,370415,370441,70576,26,300009,false,L-s-0 C-l-0 C-l-0 L-m-0 C-l-0 L-l-0 L-m-0 
job-6005,1,12,3,299798,370415,370508,70617,93,300070,false,L-l-0 L-l-0 L-l-0 
job-6008,2,7,8,299950,370415,370555,70465,140,300286,false,C-m-2 C-m-2 C-m-0 C-s-1 C-m-2 C-m-2 C-s-1 C-m-1 
job-6009,4,10,5,300008,370508,370577,70500,69,300222,false,L-l-0 L-m-0 L-m-0 L-l-0 L-l-0 
job-6007,6,6,6,299895,370415,370583,70520,168,300165,false,C-m-0 C-l-2 C-l-1 C-m-1 C-l-1 C-l-2 
job-6010,5,5,1,300052,370508,370739,70456,231,300387,false,C-l-0 
job-6012,5,5,2,300149,370739,370914,70590,175,300537,false,L-m-0 L-l-0 
job-6013,4,7,7,300197,370914,370946,70717,32,300487,false,L-m-0 C-l-1 C-l-1 L-m-0 C-l-1 C-s-1 L-s-0 
job-6011,1,6,7,300105,370739,371010,70634,271,300659,false,L-l-0 L-l-0 L-l-0 L-l-0 L-l-0 L-l-0 L-l-0 
job-6015,5,11,6,300298,370946,371028,70648,82,300532,false,L-m-0 C-l-1 C-l-1 C-m-1 C-l-0 C-l-0 
job-6014,6,10,3,300252,370914,371118,70662,204,300493,false,C-m-0 C-l-2 C-l-2 
job-6017,5,6,5,300392,371028,371133,70636,105,300601,false,L-m-0 L-l-0 C-l-0 C-m-1 C-l-0 
job-6016,1,10,7,300349,371028,371159,70679,131,300608,false,L-s-0 C-m-0 C-m-0 L-l-0 L-l-0 L-l-0 L-l-0 
job-6020,2,12,8,300524,371133,371201,70609,68,300628,false,C-l-1 C-l-2 C-l-2 C-l-2 C-l-1 C-l-1 C-l-2 C-l-1 
job-6018,3,11,2,300432,371133,371246,70701,113,300750,false,L-m-0 C-m-0 
job-6019,4,4,6,300480,371133,371251,70653,118,300878,false,L-m-0 C-l-0 L-l-0 C-l-0 L-l-0 C-l-0 
job-6021,5,11,6,300570,371201,371454,70631,253,300825,false,C-m-1 C-l-1 C-l-1 C-m-0 C-l-2 C-l-2 
job-6022,2,9,2,300624,371454,371599,70830,145,301036,false,L-m-0 L-m-0 
job-6023,3,9,3,300668,371599,371614,70931,15,300708,false,L-m-0 L-m-0 L-s-0 
job-6024,4,4,5,300705,371599,371687,70894,88,300843,false,C-m-0 L-l-0 L-l-0 C-m-0 L-l-0 
job-6025,3,4,7,300760,371687,371703,70927,16,300862,false,L-s-0 L-l-0 L-l-0 L-m-0 L-l-0 L-l-0 L-m-0 
job-6026,6,7,2,300803,371687,371849,70884,162,301242,false,C-l-0 C-l-0 
job-6027,5,10,4,300865,371687,372184,70822,497,301516,false,C-l-1 C-l-1 C-l-2 C-l-2 
job-6028,5,7,2,300908,372184,372251,71276,67,301185,false,L-l-0 L-l-0 
job-6029,3,5,5,300958,372184,372277,71226,93,301087,false,L-m-0 L-m-0 L-s-0 C-m-0 C-m-0 
job-6030,4,6,5,301006,372184,372367,71178,183,301278,false,C-m-1 C-l-1 C-l-1 C-m-1 C-l-1 
job-6031,6,4,3,301058,372367,372394,71309,27,301262,false,L-l-0 L-l-0 L-m-0 
job-6032,5,10,7,301096,372367,372427,71271,60,301210,false,C-m-0 C-l-1 C-l-1 C-l-2 C-l-0 C-l-2 C-l-0 
job-6033,6,10,4,301140,372394,372431,71254,37,301462,false,L-m-0 L-l-0 L-l-0 C-m-1 
job-6035,4,9,4,301255,372431,372485,71176,54,301329,false,L-m-0 L-l-0 L-l-0 L-l-0 
job-6034,1,4,2,301199,372431,372601,71232,170,301404,false,L-s-0 L-s-0 
job-6036,1,8,2,301302,372601,372617,71299,16,301542,false,L-s-0 L-s-0 
job-6038,4,6,2,301407,372601,372718,71194,117,301700,false,L-m-0 L-l-0 
job-6037,1,7,5,301355,372601,372795,71246,194,301705,false,L-l-0 L-l-0 L-l-0 L-l-0 L-l-0 
job-6039,2,4,8,301464,372795,372816,71331,21,301704,false,L-s-0 L-l-0 L-l-0 L-l-0 L-l-0 L-s-0 L-l-0 L-l-0 
job-6040,6,12,6,301514,372795,372866,71281,71,301764,false,C-l-0 C-l-0 L-m-0 C-m-0 C-l-2 C-l-2 
job-6041,6,10,2,301567,372866,372912,71299,46,301812,false,L-l-0 L-l-0 
job-6042,2,5,1,301618,372866,372941,71248,75,301796,false,L-s-0 
job-6043,1,5,5,301676,372866,372977,71190,111,302063,false,L-m-0 L-s-0 L-s-0 L-m-0 L-m-0 
job-6045,1,6,5,301771,372977,373072,71206,95,301876,false,L-m-0 L-m-0 L-m-0 L-m-0 L-m-0 
job-6048,6,10,5,301917,373072,373098,71155,26,302208,false,L-l-0 C-l-0 C-l-0 C-l-1 C-l-1 
job-6046,3,6,2,301814,373072,373104,71258,32,302101,false,L-m-0 L-m-0 
job-6044,2,12,1,301723,372977,373108,71254,131,302111,false,L-s-0 
job-6049,4,4,5,301975,373072,373114,71097,42,302267,false,C-m-0 C-l-2 C-l-2 C-m-0 C-l-2 
job-6047,4,10,1,301865,373072,373122,71207,50,302056,false,L-l-0 
job-6050,3,7,5,302030,373072,373191,71042,119,302287,false,C-m-1 C-m-2 C-s-1 C-m-2 C-m-1 
job-6051,3,8,7,302061,373098,373228,71037,130,302235,false,C-l-0 L-l-0 C-l-0 C-l-0 C-l-0 L-l-0 C-s-2 
job-6053,1,9,8,302177,373228,373238,71051,10,302329,false,L-m-0 C-l-0 C-l-0 C-l-0 C-l-0 L-m-0 C-l-0 L-m-0 
job-6054,6,12,3,302245,373228,373238,70983,10,302469,false,C-m-0 C-l-1 C-l-1 
job-6052,2,6,6,302122,373228,373243,71106,15,302182,false,L-l-0 L-l-0 L-l-0 L-l-0 L-l-0 L-l-0 
job-6055,3,7,6,302291,373228,373483,70937,255,302703,false,L-s-0 C-l-2 C-l-2 C-s-1 C-l-2 C-l-2 
job-6056,2,9,1,302339,373483,373505,71144,22,302410,false,L-s-0 
job-6057,1,11,7,302392,373483,373625,71091,142,302690,false,L-m-0 L-l-0 L-l-0 C-s-1 L-l-0 L-l-0 L-m-0 
job-6058,2,12,7,302446,373483,373645,71037,162,302611,false,C-l-1 C-l-0 C-l-0 C-l-0 C-l-0 C-l-1 C-l-1 
job-6060,1,6,4,302544,373645,373719,71101,74,302711,false,L-m-0 L-m-0 L-s-0 L-m-0 
job-6059,1,10,1,302492,373645,373737,71153,92,302650,false,L-s-0 
job-6061,2,12,4,302593,373719,373737,71126,18,302850,false,L-l-0 L-l-0 L-l-0 L-l-0 
job-6062,5,12,6,302642,373719,373913,71077,194,302934,false,L-m-0 C-l-0 C-l-1 C-m-0 C-l-0 C-l-1 
job-6063,3,11,7,302688,373719,374136,71031,417,303314,false,C-s-0 C-l-2 C-l-2 C-m-0 C-l-2 C-l-2 L-m-0 
job-6064,6,6,6,302736,374136,374171,71400,35,302945,false,C-m-0 C-l-0 L-l-0 L-m-0 C-l-0 L-l-0 
job-6067,3,5,8,302868,374136,374231,71268,95,303095,false,L-s-0 C-s-0 C-s-1 C-s-2 C-m-2 C-m-1 C-m-2 C-m-1 
job-6065,2,11,6,302782,374136,374238,71354,102,303042,false,C-m-0 C-l-1 C-l-1 C-l-1 C-l-1 L-m-0 
job-6066,6,9,2,302818,374136,374318,71318,182,303246,false,C-l-2 C-l-2 
job-6068,4,5,6,302911,374171,374382,71260,211,303131,false,L-m-0 L-l-0 C-l-0 C-m-0 L-l-0 L-l-0 
job-6070,4,10,8,303013,374382,374434,71369,52,303319,false,C-l-0 L-l-0 L-l-0 C-l-0 C-l-0 L-l-0 L-m-0 L-m-0 
job-6071,2,9,1,303068,374382,374498,71314,116,303215,false,C-s-1 
job-6073,5,11,5,303181,374434,374502,71253,68,303377,false,L-l-0 L-l-0 C-l-0 L-m-0 C-l-0 
job-6072,4,4,6,303131,374382,374527,71251,145,303568,false,C-l-1 C-l-2 C-l-1 C-l-1 C-l-2 C-l-2 
job-6074,6,10,5,303230,374502,374626,71272,124,303514,false,L-m-0 L-l-0 C-l-0 L-l-0 C-l-0 
job-6069,1,4,3,302963,374382,374649,71419,267,303469,false,L-s-0 L-s-0 L-s-0 
job-6075,2,7,7,303273,374626,374683,71353,57,303457,false,L-l-0 L-l-0 L-l-0 L-m-0 L-l-0 L-l-0 L-l-0 
job-6076,6,5,8,303340,374626,374696,71286,70,303573,false,C-l-0 L-m-0 C-l-1 C-l-2 C-l-1 C-l-2 C-l-0 C-m-0 
job-6077,3,7,8,303387,374649,374809,71262,160,303692,false,C-s-1 C-s-0 C-s-2 C-m-2 C-m-1 C-m-2 L-s-0 C-m-1 
job-6078,4,4,8,303432,374809,374833,71377,24,303519,false,L-m-0 L-l-0 L-l-0 L-l-0 C-m-0 L-s-0 L-m-0 C-m-0 
job-6079,3,11,2,303487,374809,374859,71322,50,303725,false,C-s-0 C-s-1 
job-6080,5,9,6,303528,374809,375037,71281,228,304000,false,C-l-1 C-l-2 C-l-0 C-l-2 C-l-0 C-l-1 
job-6081,2,4,5,303576,375037,375055,71461,18,303668,false,L-l-0 L-l-0 L-l-0 L-l-0 L-l-0 
job-6082,2,9,7,303620,375037,375084,71417,47,303688,false,L-m-0 C-m-0 C-m-0 L-m-0 C-m-0 L-l-0 L-m-0 
job-6083,1,6,1,303677,375084,375118,71407,34,303786,false,L-s-0 
job-6084,3,10,3,303724,375084,375251,71360,167,303992,false,L-m-0 L-m-0 L-s-0 
job-6085,2,5,6,303776,375251,375279,71475,28,304096,false,L-l-0 L-l-0 L-l-0 L-l-0 L-l-0 L-l-0 
job-6086,5,9,6,303829,375251,375407,71422,156,304033,false,C-m-0 C-l-1 C-l-1 L-m-0 C-l-0 C-l-0 
job-6087,1,6,2,303873,375407,375460,71534,53,303994,false,L-s-0 L-s-0 
job-6090,4,5,4,304026,375460,375518,71434,58,304356,false,L-s-0 C-l-2 C-l-2 C-l-2 
job-6088,5,4,5,303934,375407,375533,71473,126,304317,false,L-m-0 C-l-0 C-l-0 L-l-0 L-l-0 
job-6089,6,10,2,303980,375407,375552,71427,145,304173,false,C-l-1 C-l-1 
job-6094,3,10,7,304233,375533,375596,71300,63,304338,false,C-m-1 C-m-0 C-m-0 C-s-1 C-m-2 C-m-2 C-m-1 
job-6091,2,7,2,304080,375533,375605,71453,72,304424,false,L-s-0 L-s-0 
job-6093,4,11,6,304190,375533,375636,71343,103,304374,false,C-l-0 C-l-2 C-l-0 C-l-0 C-l-2 C-l-2 
job-6092,3,11,7,304136,375533,375695,71397,162,304581,false,L-m-0 L-l-0 L-l-0 L-m-0 L-l-0 L-l-0 C-s-2 
job-6095,5,6,7,304279,375636,375788,71357,152,304466,false,C-l-0 C-l-2 C-l-1 C-m-0 C-l-0 C-l-2 C-l-1 
job-6096,6,6,7,304325,375788,375852,71463,64,304521,false,L-m-0 C-l-0 C-l-1 L-l-0 C-l-0 C-l-1 L-l-0 
job-6097,4,8,8,304387,375852,375880,71465,28,304505,false,L-m-0 L-l-0 L-l-0 L-l-0 C-m-0 L-s-0 L-m-0 C-m-0 
job-6098,1,9,1,304435,375852,375922,71417,70,304594,false,C-s-1 
job-6099,6,9,2,304477,375852,375950,71375,98,304765,false,C-l-0 C-l-0 
job-6101,4,9,3,304584,375852,375991,71268,139,304980,false,C-l-1 C-l-1 C-l-1 
job-6102,1,11,6,304638,375852,376027,71214,175,305048,false,C-m-2 C-l-2 C-l-2 C-m-2 C-l-2 C-l-2 
job-6100,2,6,5,304529,375852,376109,71323,257,304918,false,C-m-1 C-s-1 C-m-1 C-m-1 C-m-1 
job-6103,1,7,8,304692,376027,376123,71335,96,304849,false,L-s-0 L-l-0 L-l-0 L-s-0 L-l-0 L-l-0 L-l-0 C-s-1 
job-6105,3,9,8,304786,376109,376141,71323,32,304838,false,C-l-0 C-l-0 C-s-1 C-l-0 C-l-0 L-m-0 C-m-0 C-m-0 
job-6104,1,10,3,304747,376109,376189,71362,80,304943,false,L-m-0 L-m-0 L-l-0 
job-6106,6,8,5,304846,376109,376251,71263,142,305064,false,C-l-1 C-l-2 C-l-2 C-m-1 C-l-1 
job-6107,5,12,1,304889,376189,376269,71300,80,305186,false,L-m-0 
job-6109,5,11,5,304994,376251,376286,71257,35,305135,false,C-l-0 L-l-0 C-l-0 C-m-2 L-l-0 
job-6108,3,8,2,304937,376251,376299,71314,48,304993,false,L-s-0 L-m-0 
job-6111,5,8,1,305093,376299,376312,71206,13,305207,false,L-m-0 
job-6110,2,5,2,305040,376299,376318,71259,19,305065,false,L-s-0 L-s-0 
job-6112,3,8,8,305133,376299,376524,71166,225,305436,false,L-l-0 L-m-0 C-l-0 C-l-0 C-l-0 L-l-0 C-l-0 L-l-0 
job-6113,1,5,5,305192,376524,376553,71332,29,305294,false,L-m-0 L-m-0 L-m-0 L-m-0 L-m-0 
job-6114,3,5,8,305251,376524,376794,71273,270,305675,false,L-l-0 L-m-0 L-l-0 L-l-0 L-l-0 C-m-0 L-s-0 C-m-0 
job-6115,3,12,2,305304,376794,376959,71490,165,305566,false,L-m-0 L-m-0 
job-6116,1,9,8,305342,376794,376973,71452,179,305565,false,L-l-0 L-l-0 L-l-0 L-l-0 L-l-0 C-m-0 C-m-0 C-m-0 
job-6117,5,8,3,305392,376959,377025,71567,66,305611,false,C-l-0 L-m-0 C-l-0 
job-6119,6,10,8,305492,376973,377059,71481,86,305831,false,L-l-0 C-l-1 L-l-0 C-l-2 C-l-1 C-m-2 C-l-2 C-m-0 
job-6120,2,7,8,305543,377025,377141,71482,116,305908,false,C-s-0 L-m-0 L-m-0 C-m-2 L-m-0 C-m-0 C-s-0 L-m-0 
job-6118,4,7,3,305440,376959,377212,71519,253,305893,false,L-s-0 C-m-1 C-m-1 
job-6121,6,4,8,305587,377059,377384,71472,325,305995,false,L-l-0 C-m-2 C-l-1 C-l-1 C-m-0 C-l-0 L-l-0 C-l-0 
job-6122,6,5,6,305638,377384,377431,71746,47,305868,false,C-m-0 C-l-0 L-l-0 L-m-0 C-l-0 L-l-0 
job-6124,6,9,3,305741,377431,377607,71690,176,306056,false,L-l-0 L-l-0 C-m-0 
job-6123,2,9,2,305692,377431,377690,71739,259,306088,false,L-m-0 L-m-0 
job-6126,5,6,2,305831,377690,377708,71859,18,306113,false,L-l-0 L-l-0 
job-6125,6,11,1,305793,377690,377710,71897,20,305883,false,L-m-0 
job-6128,2,10,5,305934,377708,377722,71774,14,306005,false,C-s-1 L-l-0 L-l-0 L-l-0 L-l-0 
job-6127,1,7,3,305885,377708,377723,71823,15,306112,false,L-s-0 L-m-0 L-m-0 
job-6129,1,6,5,305998,377708,377985,71710,277,306335,false,C-s-1 C-s-2 L-s-0 C-s-2 L-l-0 
job-6130,5,9,5,306039,377985,378009,71946,24,306121,false,L-l-0 L-l-0 C-l-0 L-m-0 C-l-0 
job-6131,4,5,8,306086,377985,378070,71899,85,306270,false,L-s-0 C-l-1 C-l-2 C-l-2 C-l-2 C-l-1 C-l-1 C-s-1 
job-6132,3,12,8,306144,377985,378378,71841,393,306826,false,C-m-0 L-m-0 C-m-1 C-m-1 C-m-0 C-m-2 C-s-0 C-m-2 
job-6134,2,12,7,306211,378378,378489,72167,111,306437,false,L-m-0 C-l-0 C-l-0 C-s-1 C-l-0 C-l-0 L-m-0 
job-6133,1,11,5,306182,378378,378642,72196,264,306635,false,L-s-0 L-l-0 L-l-0 L-l-0 L-l-0 
job-6135,2,10,3,306276,378642,378663,72366,21,306494,false,L-m-0 L-m-0 L-m-0 
job-6136,1,8,5,306328,378642,378721,72314,79,306530,false,L-l-0 L-l-0 L-l-0 L-l-0 L-l-0 
job-6137,1,7,6,306375,378642,378748,72267,106,306539,false,L-s-0 C-m-0 L-l-0 C-m-0 C-m-0 C-m-0 
job-6138,3,11,2,306417,378748,378774,72331,26,306610,false,L-m-0 L-m-0 
job-6139,1,9,4,306468,378748,378794,72280,46,306607,false,L-l-0 L-l-0 L-l-0 L-m-0 
job-6141,3,9,4,306578,378748,378982,72170,234,306885,false,L-s-0 C-m-0 L-l-0 C-m-0 
job-6140,6,11,5,306521,378748,379034,72227,286,306822,false,L-l-0 C-l-1 C-l-1 C-l-0 C-l-0 
job-6143,4,12,3,306667,378982,379055,72315,73,306786,false,L-m-0 C-s-1 L-m-0 
job-6142,2,11,4,306621,378982,379109,72361,127,306967,false,L-s-0 L-l-0 L-l-0 L-l-0 
job-6145,6,5,5,306755,379034,379140,72279,106,307000,false,C-l-0 C-l-1 C-l-1 L-l-0 C-l-0 
job-6146,3,8,6,306810,379034,379210,72224,176,306988,false,C-l-2 C-l-2 C-l-2 C-m-1 C-m-1 C-l-2 
job-6147,4,6,8,306858,379210,379233,72352,23,307022,false,L-m-0 L-m-0 L-s-0 L-l-0 L-l-0 C-m-1 L-l-0 C-m-1 
job-6144,4,8,2,306717,378982,379242,72265,260,306983,false,C-m-0 C-m-0 
job-6148,3,10,6,306901,379210,379361,72309,151,307117,false,C-l-0 C-l-0 C-l-0 C-m-2 C-m-2 C-l-0 
job-6149,1,7,2,306955,379361,379394,72406,33,307184,false,L-s-0 L-s-0 
job-6150,5,7,5,306989,379361,379484,72372,123,307283,false,L-m-0 C-l-0 C-l-0 L-l-0 L-l-0 
job-6151,1,8,1,307044,379484,379518,72440,34,307143,false,L-s-0 
job-6152,6,7,3,307107,379484,379775,72377,291,307600,false,L-l-0 L-m-0 L-l-0 
job-6153,6,9,2,307153,379775,379793,72622,18,307359,false,L-l-0 L-l-0 
job-6154,1,8,5,307199,379775,379868,72576,93,307424,false,L-m-0 L-s-0 L-s-0 L-m-0 L-m-0 
job-6155,6,5,6,307254,379775,379888,72521,113,307372,false,C-l-0 C-l-2 C-l-1 C-l-2 C-l-0 C-l-1 
job-6156,1,9,5,307295,379888,379898,72593,10,307339,false,L-l-0 L-l-0 L-l-0 L-l-0 L-l-0 
job-6157,5,5,2,307351,379888,380089,72537,201,307677,false,C-m-0 L-m-0 
job-6158,5,7,4,307408,380089,380107,72681,18,307574,false,L-m-0 L-l-0 L-l-0 C-m-0 
job-6159,1,5,2,307462,380107,380220,72645,113,307766,false,L-s-0 L-s-0 
job-6160,5,11,8,307513,380107,380271,72594,164,307829,false,C-m-0 L-l-0 C-l-1 C-l-0 C-l-1 L-l-0 C-l-0 L-m-0 
job-6161,2,9,8,307558,380220,380305,72662,85,307708,false,C-m-0 C-l-0 C-m-1 C-l-1 L-l-0 C-m-1 C-m-1 L-m-0 
job-6162,1,4,3,307600,380305,380560,72705,255,307900,false,L-s-0 L-s-0 L-s-0 
job-6163,1,5,2,307647,380560,380590,72913,30,307891,false,L-s-0 L-s-0 
job-6164,2,12,3,307698,380560,380653,72862,93,307945,false,L-l-0 L-l-0 L-l-0 
job-6166,3,5,5,307798,380653,380703,72855,50,308041,false,L-s-0 L-l-0 L-l-0 C-s-1 L-l-0 
job-6165,3,10,5,307741,380560,380718,72819,158,308014,false,L-m-0 L-l-0 L-m-0 C-m-2 C-m-2 
job-6167,6,12,5,307849,380653,380809,72804,156,308037,false,C-l-0 C-l-1 C-l-0 C-m-0 C-l-1 
job-6168,6,5,2,307906,380653,380906,72747,253,308211,false,C-l-2 C-l-2 
job-6169,1,11,3,307955,380906,380972,72951,66,308127,false,L-l-0 L-l-0 L-l-0 
job-6170,4,12,8,307999,380906,381201,72907,295,308326,false,C-s-0 C-m-2 L-m-0 L-s-0 C-m-2 L-l-0 C-s-2 L-m-0 
job-6171,3,7,5,308042,381201,381212,73159,11,308245,false,L-l-0 L-s-0 L-l-0 L-l-0 L-l-0 
job-6172,5,10,8,308086,381201,381227,73115,26,308193,false,C-l-0 C-l-0 C-l-2 C-l-1 C-l-1 L-m-0 C-l-2 C-m-2 
job-6173,2,5,6,308148,381201,381433,73053,232,308496,false,L-m-0 C-l-2 C-l-1 C-m-2 C-l-0 C-s-1 
job-6174,5,8,4,308198,381433,381532,73235,99,308472,false,L-m-0 L-l-0 L-l-0 C-m-0 
job-6175,6,7,7,308253,381433,381775,73180,342,308691,false,C-l-0 C-l-2 C-l-1 C-m-1 C-l-0 C-l-1 C-l-2 
job-6176,5,11,4,308314,381775,381805,73461,30,308353,false,L-m-0 L-l-0 L-l-0 C-m-0 
job-6179,5,4,6,308444,381805,381827,73361,22,308701,false,C-m-0 C-l-0 C-l-0 L-m-0 C-l-1 C-l-1 
job-6180,6,4,5,308506,381827,381868,73321,41,308583,false,L-m-0 C-l-0 C-l-1 C-l-1 C-l-0 
job-6177,1,12,2,308357,381805,381899,73448,94,308714,false,L-m-0 L-m-0 
job-6178,1,9,5,308401,381805,381970,73404,165,308567,false,L-l-0 L-l-0 L-l-0 L-l-0 L-l-0 
job-6181,5,8,5,308555,381827,382058,73272,231,308900,false,C-m-1 C-l-2 C-m-2 C-m-0 C-l-2 
job-6184,6,9,7,308709,382058,382126,73349,68,308896,false,C-m-1 C-l-2 C-l-1 C-l-0 C-l-0 C-l-1 C-l-2 
job-6182,1,9,6,308602,382058,382166,73456,108,308863,false,L-s-0 L-l-0 L-l-0 L-l-0 L-l-0 L-l-0 
job-6185,5,11,7,308752,382126,382209,73374,83,309035,false,C-m-1 C-l-2 C-l-1 C-l-2 C-l-0 C-l-0 C-l-1 
job-6186,6,8,6,308806,382209,382236,73403,27,309074,false,C-l-0 C-l-1 C-l-1 L-l-0 C-l-0 L-l-0 
job-6187,4,5,3,308849,382209,382263,73360,54,308994,false,L-s-0 C-m-1 C-m-1 
job-6183,5,11,2,308648,382058,382277,73410,219,308978,false,C-m-0 L-m-0 
job-6188,1,5,4,308900,382277,382352,73377,75,309146,false,L-m-0 L-m-0 L-m-0 L-m-0 
job-6189,6,5,5,308948,382277,382781,73329,504,309618,false,C-m-0 L-l-0 C-l-0 L-l-0 C-l-0 
job-6190,2,4,8,308999,382781,382878,73782,97,309283,false,L-s-0 L-l-0 L-l-0 L-l-0 L-l-0 L-s-0 L-l-0 L-l-0 
job-6191,4,11,6,309042,382781,382935,73739,154,309237,false,C-s-1 C-l-1 C-l-1 L-m-0 C-l-1 L-m-0 
job-6192,2,5,5,309091,382935,382972,73844,37,309258,false,L-l-0 L-l-0 L-l-0 L-l-0 L-l-0 
job-6193,6,5,5,309135,382935,382977,73800,42,309449,false,C-l-1 C-l-2 C-l-2 L-m-0 C-l-1 
job-6195,5,8,6,309230,382977,383073,73747,96,309562,false,L-m-0 L-l-0 C-l-1 C-m-0 C-l-1 L-l-0 
job-6194,3,6,5,309183,382935,383093,73752,158,309444,false,L-s-0 C-l-0 C-l-0 C-l-0 C-l-0 
job-6197,2,12,8,309329,383073,383290,73744,217,309750,false,C-m-0 C-l-1 C-l-1 C-l-1 C-l-1 L-m-0 C-m-0 L-m-0 
job-6198,6,6,8,309377,383290,383316,73913,26,309453,false,C-l-0 C-l-1 C-l-2 C-l-2 C-l-1 L-l-0 C-l-0 L-m-0 
job-6196,1,7,7,309277,383073,383386,73796,313,309714,false,L-l-0 L-s-0 L-l-0 L-l-0 L-l-0 L-l-0 L-l-0 
job-6199,6,8,4,309421,383316,383468,73895,152,309687,false,C-m-0 C-l-0 C-l-0 L-m-0 
job-6200,5,9,3,309458,383468,383510,74010,42,309619,false,L-l-0 L-l-0 L-m-0 
job-6201,2,10,4,309509,383468,383551,73959,83,309849,false,L-s-0 L-l-0 C-s-1 L-m-0 
job-6203,4,7,8,309610,383551,383582,73941,31,309654,false,L-l-0 C-m-0 L-l-0 L-m-0 L-m-0 L-s-0 L-l-0 C-m-0 
job-6202,4,6,3,309558,383468,383596,73910,128,309957,false,C-l-0 C-l-0 C-l-0 
job-6204,1,9,6,309670,383551,383646,73881,95,309911,false,C-s-1 C-l-2 C-l-2 C-l-2 C-l-2 C-l-2 
job-6205,2,6,5,309721,383551,383907,73830,356,310201,false,C-s-0 C-s-2 C-s-2 C-s-0 C-s-1 
job-6208,6,11,5,309893,383907,383931,74014,24,310147,false,L-l-0 C-l-1 L-l-0 C-m-0 C-l-1 
job-6206,1,4,4,309777,383907,383943,74130,36,309846,false,L-s-0 L-s-0 L-s-0 L-s-0 
job-6209,1,7,7,309950,383907,384020,73957,113,310236,false,C-m-0 C-m-1 L-m-0 C-m-1 C-m-0 L-m-0 C-m-1 
job-6210,6,5,5,309998,384020,384051,74022,31,310263,false,L-l-0 L-l-0 C-l-0 C-m-0 C-l-0 
job-6207,6,11,1,309827,383907,384070,74080,163,310115,false,L-m-0 
job-6211,1,6,1,310037,384070,384115,74033,45,310238,false,L-s-0 
job-6212,1,4,5,310087,384115,384129,74028,14,310127,false,L-m-0 L-m-0 L-m-0 L-m-0 L-m-0 
job-6215,2,6,5,310258,384129,384193,73871,64,310374,false,L-l-0 L-l-0 L-l-0 L-m-0 L-l-0 
job-6213,1,4,1,310147,384129,384199,73982,70,310287,false,L-s-0 
job-6214,3,9,3,310200,384129,384208,73929,79,310284,false,L-m-0 L-m-0 L-s-0 
job-6217,6,6,4,310357,384129,384279,73772,150,310513,false,C-l-0 C-l-1 C-l-1 C-l-0 
job-6218,4,8,6,310405,384279,384348,73874,69,310689,false,L-m-0 L-l-0 L-s-0 L-m-0 L-l-0 C-s-1 
job-6216,1,9,5,310295,384129,384365,73834,236,310773,false,C-m-0 C-m-0 L-l-0 C-m-0 L-l-0 
job-6220,5,10,7,310506,384365,384428,73859,63,310719,false,L-l-0 C-l-1 L-m-0 C-l-0 C-l-1 L-l-0 C-l-0 
job-6221,2,11,1,310566,384428,384463,73862,35,310675,false,L-m-0 
job-6219,1,5,3,310457,384365,384499,73908,134,310722,false,L-s-0 L-s-0 L-s-0 
job-6223,6,5,5,310657,384428,384551,73771,123,310797,false,C-l-2 C-l-2 C-l-1 C-m-0 C-l-1 
job-6222,4,8,7,310614,384428,384666,73814,238,310857,false,L-l-0 C-l-0 L-m-0 L-l-0 C-l-0 C-l-0 L-l-0 
job-6224,4,4,7,310716,384428,384838,73712,410,311245,false,C-s-1 C-s-2 C-m-1 C-m-2 C-m-1 C-s-0 C-m-2 
job-6227,1,11,8,310852,384838,384917,73986,79,311143,false,C-l-0 C-l-1 C-l-1 C-l-1 C-l-1 C-l-0 C-l-0 C-l-0 
job-6226,4,12,5,310808,384666,384921,73858,255,311278,false,L-m-0 L-l-0 L-m-0 L-l-0 L-l-0 
job-6229,6,4,3,310949,384917,384940,73968,23,311188,false,C-l-2 C-m-0 C-l-2 
job-6225,2,7,2,310757,384666,384963,73909,297,311164,false,L-s-0 L-s-0 
job-6228,2,5,5,310906,384917,384971,74011,54,311174,false,C-l-0 C-l-0 C-l-0 C-l-0 C-l-0 
job-6230,6,9,1,310999,384963,384983,73964,20,311280,false,L-m-0 
job-6231,1,7,7,311040,384963,385038,73923,75,311301,false,L-m-0 C-l-0 C-l-0 L-m-0 L-l-0 L-l-0 L-l-0 
job-6232,4,6,3,311091,384963,385042,73872,79,311371,false,L-s-0 L-l-0 L-l-0 
job-6233,3,12,4,311139,384963,385202,73824,239,311556,false,C-l-1 C-l-1 C-l-1 C-l-1 
job-6234,4,10,4,311186,385202,385243,74016,41,311396,false,L-l-0 L-l-0 L-s-0 L-l-0 
job-6236,2,11,8,311278,385202,385261,73924,59,311393,false,C-l-2 C-l-1 C-l-2 C-l-0 C-l-2 L-m-0 C-s-1 C-l-2 
job-6235,5,10,5,311236,385202,385289,73966,87,311348,false,L-m-0 C-l-1 C-l-0 C-l-0 C-l-1 
job-6237,6,6,3,311329,385202,385505,73873,303,311851,false,C-m-2 C-m-1 C-m-0 
job-6238,2,10,4,311366,385505,385638,74139,133,311769,false,L-l-0 L-l-0 L-l-0 L-l-0 
job-6239,3,11,8,311412,385505,385717,74093,212,311881,false,L-s-0 C-l-2 C-l-2 C-l-2 C-l-2 L-m-0 L-m-0 C-s-1 
job-6240,2,12,1,311461,385717,385743,74256,26,311780,false,L-s-0 
job-6241,6,8,8,311515,385717,386169,74202,452,312201,false,L-l-0 C-l-1 C-l-2 C-l-2 C-l-1 L-l-0 C-m-0 L-m-0 
job-6242,5,8,1,311558,386169,386270,74611,101,311813,false,L-m-0 
job-6244,2,12,6,311648,386270,386315,74622,45,311712,false,L-s-0 L-m-0 C-m-0 C-m-2 C-m-2 L-m-0 
job-6243,6,9,3,311605,386169,386323,74564,154,311878,false,L-l-0 L-l-0 C-m-0 
job-6245,1,8,4,311700,386315,386325,74615,10,311787,false,C-m-0 C-m-0 L-s-0 L-s-0 
job-6247,5,4,7,311799,386315,386335,74516,20,312062,false,C-l-0 C-l-1 C-l-1 C-m-2 C-l-0 C-l-2 C-l-2 
job-6246,2,10,6,311739,386315,386361,74576,46,311844,false,C-m-1 L-m-0 L-m-0 C-m-1 C-m-1 L-m-0 
job-6248,2,9,2,311864,386335,386392,74471,57,311996,false,L-l-0 L-l-0 
job-6249,6,12,1,311913,386392,386431,74479,39,312190,false,L-m-0 
job-6250,3,5,3,311981,386392,386437,74411,45,312247,false,L-l-0 L-l-0 L-l-0 
job-6251,6,6,6,312034,386392,386527,74358,135,312295,false,C-l-0 C-l-2 C-l-0 C-l-2 C-l-1 C-l-1 
job-6252,2,5,1,312095,386527,386613,74432,86,312381,false,L-s-0 
job-6253,2,10,1,312150,386613,386661,74463,48,312266,false,L-s-0 
job-6254,4,6,5,312200,386613,386802,74413,189,312462,false,L-m-0 L-l-0 L-m-0 L-l-0 L-l-0 
job-6255,2,8,4,312257,386802,386858,74545,56,312393,false,L-m-0 L-m-0 L-m-0 L-m-0 
job-6256,6,12,7,312303,386802,386885,74499,83,312584,false,C-l-0 C-l-2 C-l-0 C-m-0 C-l-2 L-l-0 L-l-0 
job-6257,5,12,6,312348,386885,386968,74537,83,312497,false,C-m-0 L-l-0 C-l-0 L-m-0 C-l-0 L-l-0 
job-6258,6,9,5,312394,386885,387100,74491,215,312627,false,C-l-2 C-l-1 C-l-2 C-m-1 C-l-1 
job-6261,6,11,6,312560,387100,387121,74540,21,312619,false,C-l-0 C-l-1 C-l-0 C-l-2 C-l-1 C-l-2 
job-6259,2,6,4,312457,387100,387128,74643,28,312711,false,L-m-0 L-m-0 L-m-0 L-m-0 
job-6260,4,8,2,312507,387100,387140,74593,40,312756,false,L-l-0 L-l-0 
job-6263,6,4,5,312655,387140,387164,74485,24,312715,false,C-m-0 L-l-0 C-l-0 L-l-0 C-l-0 
job-6264,1,12,3,312704,387164,387216,74460,52,312846,false,L-l-0 L-l-0 L-l-0 
job-6262,1,6,4,312610,387140,387268,74530,128,313005,false,L-m-0 L-m-0 L-m-0 L-m-0 
job-6265,5,9,3,312765,387164,387294,74399,130,313053,false,L-l-0 C-l-0 C-l-0 
job-6266,5,4,7,312807,387164,387364,74357,200,313201,false,C-m-2 C-l-2 C-l-1 C-m-1 C-l-2 C-l-1 C-m-0 
job-6268,5,8,8,312917,387364,387386,74447,22,312985,false,C-l-2 C-l-0 C-l-0 C-l-1 C-l-1 L-l-0 C-l-2 L-l-0 
job-6270,5,4,6,313030,387386,387427,74356,41,313216,false,C-l-0 C-l-0 C-l-1 L-l-0 C-l-1 L-l-0 
job-6267,1,7,4,312864,387364,387472,74500,108,313227,false,L-m-0 L-m-0 L-m-0 L-m-0 
job-6269,4,10,5,312979,387364,387475,74385,111,313227,false,L-s-0 C-m-1 C-m-0 C-m-0 C-m-1 
job-6271,4,6,5,313078,387472,387495,74394,23,313356,false,L-m-0 L-l-0 L-l-0 L-m-0 L-l-0 
job-6275,5,9,3,313271,387472,387537,74201,65,313609,false,C-l-2 C-l-2 C-l-1 
job-6274,3,5,3,313222,387472,387543,74250,71,313393,false,C-m-2 C-m-2 C-l-0 
job-6273,3,8,3,313171,387472,387566,74301,94,313511,false,C-l-0 C-l-0 C-l-0 
job-6272,3,6,1,313124,387472,387605,74348,133,313389,false,C-s-1 
job-6276,6,12,6,313325,387495,387717,74170,222,313781,false,L-m-0 L-l-0 C-l-1 C-m-0 L-l-0 C-m-1 
job-6279,4,9,5,313478,387717,387845,74239,128,313883,false,C-s-2 C-m-2 C-m-2 C-m-0 C-m-0 
job-6278,4,9,4,313424,387717,387859,74293,142,313726,false,L-m-0 L-m-0 L-s-0 C-s-1 
job-6280,6,5,4,313513,387845,387876,74332,31,313707,false,C-l-0 C-l-0 C-l-1 C-l-1 
job-6281,4,8,8,313566,387845,387881,74279,36,313827,false,C-m-0 C-s-2 C-l-2 C-l-2 C-l-2 C-m-0 C-m-2 C-m-2 
job-6277,2,5,6,313376,387717,387897,74341,180,313718,false,L-l-0 L-l-0 L-l-0 L-l-0 L-l-0 L-l-0 
job-6282,4,11,8,313629,387876,387922,74247,46,313879,false,L-m-0 C-s-0 C-l-0 C-s-1 C-l-0 C-l-0 L-s-0 L-m-0 
job-6285,5,8,6,313778,387922,387933,74144,11,313950,false,C-m-1 C-l-2 C-l-1 C-m-2 C-l-1 C-l-2 
job-6283,2,12,6,313679,387922,387936,74243,14,313877,false,L-m-0 L-l-0 L-l-0 L-l-0 L-m-0 L-l-0 
job-6284,5,11,3,313724,387922,387940,74198,18,313883,false,C-l-0 C-l-0 C-m-0 
job-6286,6,9,8,313834,387936,388055,74102,119,314236,false,C-m-1 L-l-0 C-l-1 C-l-2 C-l-2 L-l-0 C-l-1 L-m-0 
job-6287,2,6,1,313885,388055,388067,74170,12,314170,false,L-s-0 
job-6288,1,9,8,313932,388055,388123,74123,68,314003,false,L-m-0 L-l-0 L-l-0 L-l-0 L-l-0 L-l-0 L-m-0 L-s-0 
job-6289,4,9,2,313979,388055,388402,74076,347,314607,false,C-s-1 L-m-0 
job-6291,5,8,5,314084,388402,388468,74318,66,314446,false,L-m-0 C-l-2 C-l-2 C-l-1 C-l-1 
job-6290,2,8,7,314035,388402,388469,74367,67,314121,false,L-l-0 L-l-0 L-s-0 L-l-0 L-l-0 L-s-0 L-l-0 
job-6292,6,12,5,314132,388402,388571,74270,169,314401,false,C-m-1 C-l-0 C-m-2 C-m-0 C-l-0 
job-6293,2,7,3,314192,388571,388739,74379,168,314450,false,L-m-0 L-m-0 L-m-0 
job-6294,5,5,2,314234,388739,388782,74505,43,314324,false,L-l-0 L-l-0 
job-6295,1,6,1,314295,388782,388820,74487,38,314378,false,L-s-0 
job-6296,5,11,5,314346,388782,388903,74436,121,314644,false,L-l-0 C-l-0 L-l-0 L-m-0 C-l-0 
job-6299,5,10,4,314487,388820,388907,74333,87,314814,false,C-l-2 C-l-1 C-l-1 C-l-2 
job-6297,4,11,2,314402,388782,388920,74380,138,314640,false,C-m-0 C-m-0 
job-6298,6,6,1,314445,388782,389059,74337,277,314858,false,C-m-1 
job-6301,3,9,3,314577,389059,389097,74482,38,314744,false,C-m-1 L-m-0 C-m-1 
job-6300,2,8,3,314544,388907,389099,74363,192,314938,false,L-s-0 L-s-0 C-m-1 
job-6302,5,10,7,314613,389059,389217,74446,158,314998,false,L-l-0 C-l-1 L-m-0 C-l-0 C-l-1 L-l-0 C-l-0 
job-6304,4,8,4,314707,389059,389245,74352,186,315041,false,C-m-2 C-m-0 C-m-0 C-m-2 
job-6303,4,12,3,314659,389059,389419,74400,360,315038,false,C-l-2 C-l-2 C-l-2 
job-6306,6,6,6,314817,389419,389431,74602,12,314897,false,C-l-0 C-l-1 C-l-1 L-l-0 C-l-0 L-l-0 
job-6307,6,4,1,314869,389419,389441,74550,22,315093,false,C-m-0 
job-6305,1,6,4,314756,389419,389455,74663,36,315072,false,L-m-0 L-m-0 L-m-0 L-m-0 
job-6308,3,12,1,314911,389419,389457,74508,38,315000,false,L-s-0 
job-6309,4,10,2,314969,389419,389504,74450,85,315204,false,C-m-1 C-m-1 
job-6310,1,9,5,315020,389504,389514,74484,10,315301,false,L-l-0 L-l-0 L-l-0 L-l-0 L-l-0 
job-6311,2,10,3,315069,389504,389557,74435,53,315211,false,L-m-0 L-m-0 L-m-0 
job-6312,6,10,5,315114,389504,389564,74390,60,315471,false,C-m-0 C-l-2 C-l-2 C-l-0 C-l-0 
job-6313,5,11,7,315178,389557,389625,74379,68,315481,false,L-m-0 L-l-0 C-l-1 C-m-2 C-l-1 L-l-0 C-m-1 
job-6314,5,12,6,315232,389625,389766,74393,141,315539,false,L-m-0 C-l-2 L-l-0 C-m-0 C-l-2 L-l-0 
job-6315,3,5,7,315284,389625,389773,74341,148,315548,false,L-m-0 C-l-0 C-l-0 C-m-0 C-l-0 C-l-0 L-s-0 
job-6316,3,6,3,315342,389766,389823,74424,57,315599,false,L-l-0 C-m-0 L-m-0 
job-6317,6,8,3,315384,389766,389852,74382,86,315627,false,C-l-1 L-l-0 C-l-1 
job-6318,5,7,6,315428,389773,389881,74345,108,315556,false,L-m-0 C-l-2 C-l-0 C-m-0 C-l-2 C-l-0 
job-6319,6,7,6,315476,389852,389928,74376,76,315833,false,C-m-2 C-l-1 C-l-1 C-m-1 L-l-0 L-l-0 
job-6320,4,11,4,315516,389852,390011,74336,159,315934,false,L-s-0 C-s-0 C-s-1 C-s-2 
job-6322,3,10,8,315614,390011,390043,74397,32,315921,false,L-s-0 L-l-0 L-l-0 L-l-0 C-m-1 L-l-0 C-m-1 L-m-0 
job-6323,2,12,7,315675,390011,390063,74336,52,315938,false,C-l-0 C-l-0 C-m-1 C-m-0 C-m-0 C-l-0 C-l-0 
job-6324,5,9,5,315722,390011,390065,74289,54,315908,false,C-m-2 C-l-2 C-l-1 C-l-1 C-l-2 
job-6325,6,4,7,315769,390065,390122,74296,57,316043,false,C-m-0 C-l-1 C-l-0 L-l-0 C-l-0 C-l-1 L-l-0 
job-6321,4,11,1,315572,389881,390203,74309,322,315944,false,L-m-0 
job-6326,1,10,5,315822,390203,390218,74381,15,316030,false,L-s-0 L-l-0 L-l-0 L-l-0 L-l-0 
job-6327,5,10,4,315875,390203,390226,74328,23,316170,false,L-m-0 C-l-0 C-l-0 C-m-0 
job-6328,4,6,4,315929,390203,390243,74274,40,315983,false,C-l-1 L-l-0 C-l-1 C-l-1 
job-6329,3,12,2,315974,390243,390261,74269,18,316209,false,L-m-0 L-m-0 
job-6331,4,11,7,316062,390243,390276,74181,33,316266,false,C-s-1 C-l-2 C-l-2 C-l-0 C-l-0 C-l-0 C-l-2 
job-6330,2,11,7,316021,390243,390300,74222,57,316348,false,L-s-0 L-l-0 L-l-0 C-m-0 L-l-0 L-l-0 C-m-0 
job-6332,4,7,4,316111,390243,390678,74132,435,316774,false,C-l-1 C-m-0 C-l-1 C-l-1 
job-6334,1,7,6,316216,390678,390733,74462,55,316478,false,L-l-0 L-l-0 L-l-0 L-l-0 L-l-0 L-l-0 
job-6335,4,6,8,316269,390678,390748,74409,70,316578,false,C-l-1 C-l-1 C-l-1 L-l-0 C-m-0 C-m-0 L-m-0 L-m-0 
job-6336,4,12,4,316328,390733,390763,74405,30,316397,false,C-m-1 L-l-0 L-l-0 C-m-1 
job-6333,3,11,1,316158,390678,390854,74520,176,316490,false,L-s-0 
job-6337,3,6,5,316370,390733,390897,74363,164,316562,false,C-l-2 C-l-2 C-l-2 C-s-1 C-l-2 
job-6339,6,9,2,316467,390733,390901,74266,168,316643,false,C-l-0 C-l-0 
job-6341,1,6,5,316563,390897,390962,74334,65,316888,false,C-s-2 L-l-0 L-l-0 L-l-0 L-l-0 
job-6340,4,5,2,316509,390897,390978,74388,81,316617,false,L-m-0 L-m-0 
job-6338,2,7,1,316417,390733,390980,74316,247,316799,false,C-s-2 
job-6343,2,11,1,316646,390897,391078,74251,181,316971,false,C-s-0 
job-6342,4,7,4,316601,390897,391150,74296,253,316999,false,L-s-0 L-l-0 L-l-0 C-s-1 
job-6344,6,11,5,316689,390897,391195,74208,298,317033,false,C-l-1 C-l-2 C-l-2 C-m-0 C-l-1 
job-6345,6,10,7,316759,391150,391218,74391,68,317038,false,C-l-0 C-l-0 L-l-0 C-m-1 L-l-0 C-m-2 L-m-0 
job-6346,5,7,5,316811,391195,391333,74384,138,316972,false,C-l-2 C-l-2 C-l-1 C-m-0 C-l-1 
job-6347,6,9,3,316867,391333,391400,74466,67,317220,false,L-l-0 L-l-0 L-m-0 
job-6348,5,12,2,316920,391333,391921,74413,588,317654,false,C-l-2 C-l-2 
job-6350,3,7,4,317006,391921,391940,74915,19,317201,false,L-m-0 L-m-0 C-m-0 C-m-0 
job-6349,2,9,6,316967,391921,391946,74954,25,317179,false,L-s-0 L-l-0 L-l-0 L-l-0 L-l-0 L-l-0 
job-6351,1,11,2,317059,391940,391961,74881,21,317344,false,L-m-0 L-m-0 
job-6352,4,9,6,317110,391940,392060,74830,120,317523,false,L-m-0 C-l-1 C-l-1 C-m-0 C-l-1 C-m-0 
job-6353,2,7,4,317158,392060,392084,74902,24,317436,false,L-m-0 L-m-0 L-m-0 L-m-0 
job-6354,4,9,7,317212,392060,392091,74848,31,317444,false,C-l-0 L-l-0 C-l-0 L-l-0 C-l-0 L-l-0 L-s-0 
job-6356,4,7,5,317318,392060,392200,74742,140,317562,false,C-m-1 C-l-2 C-l-2 C-m-1 C-l-2 
job-6355,4,5,2,317263,392060,392361,74797,301,317861,false,C-m-0 C-m-0 
job-6357,1,8,3,317372,392060,392539,74688,479,317878,false,C-m-2 C-m-2 C-m-2 
job-6358,2,9,7,317410,392539,392593,75129,54,317687,false,L-m-0 L-l-0 L-l-0 L-l-0 L-l-0 L-l-0 L-m-0 
job-6361,4,12,8,317580,392539,392643,74959,104,317761,false,C-l-0 C-l-0 C-l-0 C-m-2 C-l-1 C-m-2 C-l-1 C-l-1 
job-6359,2,8,7,317469,392539,392688,75070,149,317776,false,L-s-0 C-m-0 L-s-0 C-m-0 C-m-0 L-m-0 C-m-0 
job-6360,6,8,1,317523,392539,392913,75016,374,317940,false,C-m-1 
job-6363,5,11,6,317680,392913,393003,75233,90,318055,false,L-m-0 L-l-0 C-l-0 C-m-0 C-l-0 L-l-0 
job-6362,2,8,1,317630,392913,393097,75283,184,317940,false,L-s-0 
job-6364,1,12,1,317733,393097,393127,75364,30,317840,false,L-s-0 
job-6366,4,10,7,317854,393127,393231,75273,104,318184,false,L-s-0 C-l-2 C-l-2 C-m-1 C-s-1 C-l-2 C-m-1 
job-6365,5,8,8,317793,393097,393293,75304,196,318174,false,C-m-0 L-l-0 C-l-1 C-l-1 C-l-0 L-l-0 C-l-0 L-m-0 
job-6367,6,12,2,317901,393231,393413,75330,182,318307,false,C-l-2 C-l-2 
job-6368,6,11,8,317956,393293,393480,75337,187,318312,false,C-l-0 L-l-0 C-l-1 C-l-0 C-l-1 L-l-0 C-m-0 L-m-0 
job-6370,6,12,4,318041,393480,393525,75439,45,318263,false,L-m-0 L-l-0 L-l-0 C-m-0 
job-6369,3,11,5,317997,393413,393540,75416,127,318179,false,L-s-0 C-l-2 C-l-2 C-l-2 C-l-2 
job-6371,6,10,3,318091,393480,393623,75389,143,318512,false,C-m-1 C-l-1 C-l-1 
job-6372,4,10,1,318139,393623,393663,75484,40,318201,false,L-s-0 
job-6373,6,11,8,318180,393623,393744,75443,121,318406,false,L-l-0 L-l-0 C-l-2 C-l-2 C-l-1 L-m-0 C-l-1 C-m-0 
job-6375,3,6,4,318266,393744,393771,75478,27,318474,false,L-l-0 L-l-0 L-l-0 L-l-0 
job-6374,1,4,8,318215,393744,393773,75529,29,318302,false,L-m-0 L-m-0 L-m-0 L-m-0 L-m-0 L-m-0 L-m-0 L-m-0 
job-6377,4,11,3,318378,393744,393791,75366,47,318707,false,C-m-2 C-m-2 C-s-2 
job-6376,2,4,1,318326,393744,393806,75418,62,318661,false,L-s-0 
job-6378,6,4,4,318425,393744,393858,75319,114,318725,false,C-l-0 C-l-1 C-l-1 C-l-0 
job-6380,6,9,5,318532,393858,393879,75326,21,318695,false,L-l-0 C-l-0 L-l-0 L-m-0 C-l-0 
job-6381,4,7,2,318588,393858,393891,75270,33,318680,false,C-m-1 C-m-1 
job-6379,1,10,4,318476,393744,393892,75268,148,318879,false,L-s-0 C-m-0 C-m-0 C-m-0 
job-6382,3,4,1,318650,393892,394035,75242,143,318871,false,L-s-0 
job-6383,3,5,4,318695,394035,394065,75340,30,318785,false,L-l-0 L-l-0 L-l-0 L-l-0 
job-6386,3,6,7,318853,394035,394166,75182,131,319078,false,C-s-1 C-l-1 C-l-1 C-s-0 C-l-1 C-l-1 C-s-2 
job-6385,1,8,7,318797,394035,394168,75238,133,318998,false,L-m-0 C-l-0 C-l-0 C-l-0 C-l-0 C-l-0 C-l-0 
job-6384,2,5,5,318753,394035,394194,75282,159,319122,false,L-m-0 L-s-0 L-s-0 L-m-0 L-m-0 
job-6387,3,8,6,318894,394035,394307,75141,272,319404,false,C-m-1 C-l-2 C-l-2 C-m-1 C-l-2 C-l-2 
job-6388,4,11,6,318946,394307,394367,75361,60,319167,false,L-m-0 L-s-0 L-l-0 L-l-0 L-m-0 L-l-0 
job-6389,6,5,7,319000,394307,394503,75307,196,319391,false,C-l-2 C-l-1 C-m-0 C-l-0 C-l-1 C-l-0 C-l-2 
job-6390,1,10,8,319057,394503,394513,75446,10,319265,false,L-m-0 L-l-0 L-l-0 L-l-0 L-l-0 L-m-0 L-s-0 L-m-0 
job-6391,1,5,5,319103,394503,394544,75400,41,319415,false,C-s-1 C-s-1 L-s-0 C-s-1 L-l-0 
job-6392,4,11,2,319159,394503,394584,75344,81,319493,false,C-m-0 C-m-0 
job-6393,2,6,7,319206,394584,394608,75378,24,319280,false,L-l-0 L-l-0 L-s-0 L-l-0 L-l-0 L-s-0 L-l-0 
job-6395,1,9,7,319321,394584,394741,75263,157,319687,false,L-m-0 C-l-0 L-l-0 C-l-0 C-l-0 C-l-0 L-l-0 
job-6394,3,11,7,319252,394584,394806,75332,222,319634,false,L-m-0 C-l-1 C-l-1 C-s-1 C-l-1 C-l-1 L-m-0 
job-6396,6,6,8,319362,394741,394831,75379,90,319616,false,L-l-0 L-l-0 C-l-0 C-m-1 C-l-0 C-l-2 C-l-2 C-m-0 
job-6397,5,12,7,319411,394831,394995,75420,164,319860,false,C-l-1 L-l-0 C-l-0 C-l-1 C-l-0 L-l-0 L-m-0 
job-6402,4,11,4,319661,394995,395059,75334,64,320006,false,C-m-1 C-m-2 C-m-1 C-m-2 
job-6398,1,8,2,319454,394995,395066,75541,71,319608,false,L-s-0 L-s-0 
job-6401,6,8,2,319606,394995,395106,75389,111,319754,false,L-l-0 C-m-0 
job-6400,2,9,4,319550,394995,395144,75445,149,319932,false,L-m-0 L-l-0 L-l-0 L-l-0 
job-6399,6,11,1,319505,394995,395221,75490,226,319743,false,L-m-0 
job-6403,1,8,6,319714,395221,395248,75507,27,319743,false,L-l-0 L-l-0 L-l-0 L-l-0 L-l-0 L-l-0 
job-6404,2,12,2,319766,395221,395321,75455,100,319869,false,L-m-0 L-m-0 
job-6405,6,7,4,319819,395221,395323,75402,102,320058,false,C-l-0 C-l-0 C-l-1 C-l-1 
job-6406,4,11,7,319871,395321,395353,75450,32,319911,false,L-l-0 L-l-0 L-s-0 L-l-0 L-m-0 L-m-0 C-s-2 
job-6407,1,8,8,319912,395321,395469,75409,148,320124,false,C-l-2 C-l-2 C-l-2 C-s-1 C-l-2 C-l-2 C-s-1 C-l-2 
job-6409,6,6,7,320019,395469,395523,75450,54,320272,false,C-l-1 C-l-0 L-l-0 C-l-1 C-l-0 L-l-0 L-m-0 
job-6408,5,10,3,319961,395321,395529,75360,208,320224,false,C-m-0 C-m-1 C-m-2 
job-6410,5,9,1,320078,395469,395637,75391,168,320370,false,C-l-2 
job-6411,3,10,3,320119,395637,395673,75518,36,320226,false,L-m-0 L-m-0 L-s-0 
job-6413,5,7,3,320225,395637,395678,75412,41,320280,false,C-m-1 C-l-0 C-l-0 
job-6414,3,12,4,320272,395673,395709,75401,36,320558,false,L-s-0 L-m-0 C-m-1 L-m-0 
job-6412,3,8,6,320166,395637,395717,75471,80,320478,false,C-m-0 L-l-0 L-l-0 C-m-0 L-l-0 L-l-0 
job-6415,2,10,4,320323,395673,395733,75350,60,320411,false,C-s-2 C-l-0 C-s-1 C-m-0 
job-6416,1,8,4,320372,395733,395760,75361,27,320553,false,L-m-0 L-m-0 L-m-0 L-m-0 
job-6417,5,4,4,320435,395733,395775,75298,42,320730,false,L-l-0 L-l-0 C-l-0 C-l-0 
job-6419,6,8,6,320542,395775,395795,75233,20,320799,false,L-m-0 C-l-1 L-l-0 C-m-0 C-l-1 L-l-0 
job-6420,1,5,8,320590,395775,395803,75185,28,320699,false,L-m-0 C-m-1 C-m-1 C-m-0 C-m-1 C-m-1 L-m-0 C-m-0 
job-6421,4,8,1,320653,395803,395834,75150,31,320842,false,L-m-0 
job-6418,1,12,1,320487,395775,395839,75288,64,320760,false,L-s-0 
job-6422,5,7,5,320699,395803,395866,75104,63,320770,false,L-l-0 C-l-1 C-l-1 C-m-0 L-l-0 
job-6424,4,10,8,320803,395834,395917,75031,83,320900,false,C-m-2 C-l-2 C-l-2 C-l-2 C-m-1 L-m-0 C-m-2 C-m-1 
job-6423,1,11,8,320757,395834,396005,75077,171,321122,false,L-m-0 C-l-1 L-m-0 C-l-1 L-l-0 L-l-0 C-m-0 C-m-0 
job-6425,5,6,4,320848,396005,396073,75157,68,321019,false,L-m-0 L-l-0 L-l-0 C-m-0 
job-6426,4,8,7,320896,396005,396181,75109,176,321149,false,L-s-0 C-l-0 C-l-1 C-l-1 C-l-0 C-l-1 C-l-0 
job-6427,3,7,1,320943,396073,396616,75130,543,321598,false,L-m-0 
job-6429,6,8,5,321033,396616,396653,75583,37,321185,false,C-l-1 L-m-0 C-l-0 C-l-1 C-l-0 
job-6428,3,12,5,320990,396616,396735,75626,119,321195,false,L-l-0 L-s-0 L-l-0 L-l-0 L-l-0 
job-6431,3,12,5,321133,396735,396756,75602,21,321165,false,L-m-0 L-l-0 L-l-0 L-l-0 L-l-0 
job-6432,5,8,5,321172,396735,396760,75563,25,321481,false,C-m-1 C-l-1 C-l-0 C-l-1 C-l-0 
job-6430,1,5,7,321088,396616,396761,75528,145,321508,false,C-s-1 L-m-0 C-s-2 C-s-1 C-s-2 C-s-2 L-m-0 
job-6434,4,11,3,321274,396760,396923,75486,163,321472,false,L-l-0 L-m-0 L-l-0 
job-6433,6,12,4,321227,396735,396934,75508,199,321427,false,C-m-2 C-l-2 C-l-2 C-m-0 
job-6437,4,6,5,321422,396923,396935,75501,12,321516,false,C-m-1 L-l-0 L-l-0 C-m-1 L-l-0 
job-6435,6,8,1,321314,396923,396949,75609,26,321428,false,L-m-0 
job-6436,3,9,1,321356,396923,396980,75567,57,321451,false,L-s-0 
job-6439,6,11,4,321508,396934,397029,75426,95,321882,false,C-l-0 C-l-0 C-l-1 C-l-1 
job-6440,3,5,7,321560,396934,397070,75374,136,321903,false,C-s-2 C-l-2 C-l-2 C-m-0 C-l-2 C-l-2 C-m-0 
job-6438,2,8,3,321466,396934,397095,75468,161,321733,false,C-s-1 L-m-0 C-s-1 
job-6442,6,6,8,321650,397095,397107,75445,12,321802,false,L-l-0 C-l-0 C-l-0 C-l-1 C-l-1 L-l-0 C-m-0 L-m-0 
job-6441,2,12,1,321603,397095,397113,75492,18,321847,false,L-s-0 
job-6443,4,5,2,321706,397095,397113,75389,18,321941,false,C-m-1 C-m-1 
job-6446,4,7,7,321830,397107,397222,75277,115,321990,false,C-s-1 C-l-2 C-l-0 C-l-2 C-l-0 C-l-0 C-l-2 
job-6445,6,4,4,321791,397107,397314,75316,207,322098,false,C-m-0 L-m-0 L-l-0 L-l-0 
job-6444,1,10,7,321749,397095,397340,75346,245,322095,false,L-m-0 C-m-0 C-m-2 C-m-2 C-m-0 L-m-0 C-m-2 
job-6447,1,11,2,321888,397107,397687,75219,580,322514,false,C-s-0 C-s-2 
job-6450,6,9,8,322055,397687,397700,75632,13,322343,false,C-l-0 C-l-2 C-l-1 C-l-1 C-l-0 C-m-2 C-l-2 C-m-1 
job-6448,2,7,8,321935,397687,397755,75752,68,322291,false,L-l-0 L-l-0 L-l-0 L-l-0 L-l-0 L-s-0 L-l-0 L-s-0 
job-6451,6,10,7,322100,397700,397772,75600,72,322279,false,C-l-0 C-l-1 C-l-1 C-l-2 C-l-0 C-l-2 C-m-1 
job-6449,4,5,2,321997,397687,397773,75690,86,322183,false,L-m-0 L-m-0 
job-6452,4,6,1,322153,397700,397801,75547,101,322350,false,C-s-1 
job-6453,5,4,5,322198,397772,397819,75574,47,322248,false,C-m-0 L-l-0 C-l-0 C-l-0 L-l-0 
job-6454,3,4,4,322242,397772,398017,75530,245,322760,false,L-s-0 C-m-0 C-m-1 C-m-1 
job-6456,2,4,5,322336,398017,398076,75681,59,322585,false,L-m-0 L-m-0 L-m-0 C-s-1 L-m-0 
job-6455,3,9,5,322286,398017,398103,75731,86,322451,false,L-l-0 L-s-0 L-l-0 L-l-0 L-l-0 
job-6457,3,6,2,322385,398103,398116,75718,13,322644,false,L-m-0 L-m-0 
job-6458,5,4,5,322444,398103,398123,75659,20,322709,false,L-l-0 L-l-0 C-l-1 C-m-0 C-l-1 
job-6459,4,12,4,322491,398103,398183,75612,80,322816,false,L-s-0 C-s-2 C-m-2 C-m-2 
job-6460,5,6,6,322547,398116,398395,75569,279,322872,false,L-m-0 C-l-2 C-l-0 C-m-1 C-l-0 C-l-2 
job-6461,2,7,5,322603,398395,398417,75792,22,322857,false,L-l-0 L-l-0 L-l-0 L-l-0 L-l-0 
job-6462,1,11,2,322652,398395,398426,75743,31,322780,false,L-s-0 L-l-0 
job-6463,4,6,7,322697,398395,398560,75698,165,322950,false,L-m-0 C-l-1 C-l-1 C-m-0 C-l-1 C-m-0 L-m-0 
job-6464,3,6,2,322746,398560,398661,75814,101,322996,false,L-m-0 L-m-0 
job-6465,4,6,1,322792,398661,398675,75869,14,323041,false,L-s-0 
job-6467,6,5,3,322895,398661,398760,75766,99,323147,false,L-m-0 C-l-0 C-l-0 
job-6469,6,11,6,322987,398760,398779,75773,19,323061,false,C-l-0 C-l-0 C-l-1 C-l-2 C-l-1 C-l-2 
job-6468,4,9,4,322938,398760,398799,75822,39,323125,false,L-m-0 L-m-0 L-s-0 C-s-1 
job-6466,3,4,3,322841,398661,398804,75820,143,323061,false,L-l-0 L-l-0 L-l-0 
job-6470,4,4,5,323032,398760,398861,75728,101,323419,false,C-m-1 C-s-2 C-m-2 C-m-2 C-m-1 
job-6471,1,12,3,323096,398861,398875,75765,14,323225,false,L-l-0 L-l-0 L-l-0 
job-6472,4,7,2,323153,398861,399158,75708,297,323496,false,L-s-0 L-l-0 
job-6474,2,7,8,323257,399158,399174,75901,16,323364,false,L-m-0 L-m-0 L-l-0 C-m-2 C-m-2 C-m-2 L-m-0 C-m-2 
job-6473,2,8,7,323212,399158,399178,75946,20,323485,false,L-l-0 L-l-0 L-s-0 L-l-0 L-l-0 L-s-0 L-l-0 
job-6475,3,6,4,323312,399158,399190,75846,32,323406,false,C-l-0 C-l-0 C-l-0 C-l-0 
job-6476,3,10,8,323366,399158,399236,75792,78,323541,false,C-l-1 C-l-2 C-l-2 C-l-2 C-l-1 C-l-1 C-l-2 C-l-1 
job-6477,2,12,1,323411,399174,399239,75763,65,323711,false,L-m-0 
job-6478,2,7,8,323462,399174,399270,75712,96,323857,false,C-s-2 C-m-0 L-l-0 C-m-0 C-m-0 L-m-0 C-s-2 L-m-0 
job-6479,4,12,7,323514,399178,399376,75664,198,323962,false,L-s-0 L-l-0 C-m-2 C-m-2 C-m-1 L-l-0 C-m-1 
job-6481,5,12,4,323616,399376,399422,75760,46,323836,false,C-m-0 C-l-0 C-l-0 L-m-0 
job-6480,2,5,5,323561,399376,399471,75815,95,323716,false,L-l-0 L-l-0 L-l-0 L-l-0 L-l-0 
job-6482,3,7,1,323664,399471,399497,75807,26,323854,false,L-s-0 
job-6483,2,12,5,323716,399471,399590,75755,119,323898,false,L-m-0 L-l-0 L-l-0 L-l-0 L-l-0 
job-6485,1,5,6,323817,399471,399683,75654,212,324199,false,C-m-0 C-m-0 L-s-0 C-m-0 C-s-1 C-m-0 
job-6484,3,6,7,323757,399471,399747,75714,276,324282,false,L-m-0 C-l-1 C-l-1 C-s-1 C-l-1 C-l-1 L-m-0 
job-6486,1,11,7,323865,399471,399786,75606,315,324260,false,C-m-1 C-l-2 C-l-2 C-m-0 C-l-2 C-l-2 C-m-1 
job-6487,6,11,5,323916,399786,399809,75870,23,324078,false,L-m-0 C-l-0 L-l-0 L-l-0 C-l-0 
job-6488,3,8,3,323959,399786,399990,75827,204,324219,false,L-s-0 C-m-0 C-m-0 
job-6489,5,6,5,324010,399990,400009,75980,19,324048,false,L-l-0 L-l-0 C-l-0 L-m-0 C-l-0 
job-6490,4,8,4,324061,399990,400077,75929,87,324219,false,L-s-0 C-l-1 C-l-1 C-l-1 
job-6491,5,6,8,324113,400009,400490,75896,481,324731,false,L-l-0 C-l-2 C-l-0 C-l-2 C-l-0 L-m-0 C-m-0 L-l-0 
job-6492,2,10,7,324169,400490,400822,76321,332,324570,false,L-m-0 L-l-0 L-l-0 L-m-0 L-l-0 L-l-0 L-m-0 
job-6493,2,7,7,324209,400822,400882,76613,60,324544,false,L-l-0 L-l-0 L-s-0 L-l-0 L-l-0 L-s-0 L-l-0 
job-6495,2,8,5,324292,400822,400976,76530,154,324617,false,C-s-1 L-m-0 L-l-0 C-s-1 C-m-0 
job-6494,6,11,2,324246,400822,400984,76576,162,324486,false,L-m-0 C-m-0 
job-6497,3,8,4,324385,400976,401015,76591,39,324696,false,L-l-0 L-l-0 L-l-0 L-l-0 
job-6498,4,10,2,324445,400976,401018,76531,42,324767,false,C-m-1 C-m-1 
job-6496,3,12,1,324335,400976,401020,76641,44,324484,false,L-s-0 
job-6499,6,4,5,324484,400976,401030,76492,54,324702,false,C-l-2 C-l-2 C-l-0 C-m-2 C-l-0 
job-6500,1,4,3,324534,401020,401069,76486,49,324815,false,L-s-0 C-m-2 C-m-2 
job-6502,1,10,8,324633,401069,401128,76436,59,324816,false,L-m-0 L-m-0 L-s-0 C-m-1 C-m-1 C-m-1 C-m-0 C-m-0 
job-6503,2,8,4,324672,401069,401138,76397,69,324920,false,C-m-2 C-m-2 C-m-2 C-m-2 
job-6501,6,8,6,324582,401020,401141,76438,121,324784,false,L-m-0 L-l-0 C-l-1 C-m-0 C-l-1 L-l-0 
job-6505,5,10,2,324773,401128,401156,76355,28,324918,false,C-l-2 C-l-2 
job-6504,3,8,6,324728,401128,401163,76400,35,324778,false,L-s-0 C-l-0 C-l-0 C-s-1 C-l-0 C-l-0 
job-6506,6,5,1,324810,401156,401172,76346,16,325078,false,L-m-0 
job-6508,6,8,7,324902,401156,401246,76254,90,325147,false,C-m-2 C-l-2 C-l-1 C-m-0 C-l-1 C-l-2 C-m-1 
job-6507,2,7,8,324862,401156,401376,76294,220,325131,false,C-s-2 L-m-0 L-l-0 L-l-0 L-l-0 L-l-0 C-s-2 L-l-0 
job-6509,6,4,7,324956,401246,401380,76290,134,325384,false,C-l-0 C-l-1 L-m-0 C-l-2 C-l-1 C-l-0 C-l-2 
job-6510,4,7,8,325006,401376,401437,76370,61,325286,false,L-l-0 L-l-0 L-s-0 L-l-0 C-m-0 C-m-1 C-m-1 C-m-0 
job-6512,3,7,7,325122,401380,401449,76258,69,325266,false,C-s-2 C-l-0 C-l-0 C-s-0 C-l-0 C-l-0 C-s-1 
job-6511,6,12,2,325075,401380,401450,76305,70,325330,false,L-m-0 C-m-2 
job-6513,3,9,8,325164,401380,401708,76216,328,325754,false,C-l-1 C-l-2 C-l-1 C-l-2 C-l-2 C-l-1 C-l-2 C-l-1 
job-6514,6,8,7,325214,401708,401795,76494,87,325563,false,L-m-0 C-l-0 C-l-1 L-l-0 C-l-0 C-l-1 L-l-0 
job-6515,4,10,7,325262,401708,401877,76446,169,325505,false,L-s-0 C-l-2 C-l-2 C-m-1 C-l-2 C-s-1 C-m-1 
job-6516,1,7,4,325310,401708,401883,76398,175,325562,false,C-s-2 L-m-0 C-s-2 L-m-0 
job-6519,5,8,4,325464,401877,401894,76413,17,325723,false,C-l-1 C-l-1 C-l-0 C-l-0 
job-6517,1,8,5,325363,401877,401916,76514,39,325446,false,L-l-0 L-l-0 L-m-0 L-m-0 L-l-0 
job-6518,4,12,4,325410,401877,401927,76467,50,325702,false,L-s-0 L-l-0 L-l-0 C-s-1 
job-6521,3,9,1,325576,401927,401993,76351,66,325645,false,L-m-0 
job-6522,2,9,5,325628,401927,402006,76299,79,325830,false,L-m-0 L-l-0 L-l-0 L-m-0 L-l-0 
job-6520,1,4,2,325513,401927,402025,76414,98,325839,false,L-s-0 L-s-0 
job-6523,5,8,7,325682,401927,402025,76245,98,325975,false,L-l-0 C-l-2 C-l-0 C-l-0 C-l-1 C-l-1 C-l-2 
job-6525,4,12,4,325786,401927,402052,76141,125,326028,false,C-m-2 C-m-0 C-m-0 C-m-2 
job-6524,3,12,1,325730,401927,402174,76197,247,326008,false,C-s-1 
job-6526,5,5,5,325838,402025,402213,76187,188,326211,false,L-m-0 C-l-0 L-l-0 C-l-0 L-l-0 
job-6527,6,9,1,325891,402213,402223,76322,10,326151,false,L-m-0 
job-6528,1,4,5,325938,402213,402367,76275,154,326179,false,L-s-0 L-m-0 L-m-0 L-s-0 L-s-0 
job-6529,4,7,2,325983,402367,402384,76384,17,326088,false,L-m-0 L-m-0 
job-6530,4,6,7,326015,402367,402790,76352,423,326652,false,L-l-0 L-s-0 C-l-2 L-l-0 C-l-2 C-l-2 L-l-0 
job-6531,3,5,1,326059,402790,402801,76731,11,326108,false,L-s-0 
job-6533,5,9,5,326169,402790,402891,76621,101,326285,false,C-m-1 C-l-2 C-l-1 C-l-1 C-l-2 
job-6532,5,4,6,326113,402790,402995,76677,205,326513,false,L-m-0 C-l-0 L-l-0 C-m-0 C-l-0 L-l-0 
job-6534,1,8,7,326215,402995,403038,76780,43,326471,false,L-s-0 L-s-0 L-l-0 L-l-0 L-l-0 L-l-0 L-l-0 
job-6536,5,4,3,326312,403038,403067,76726,29,326548,false,L-m-0 L-l-0 L-l-0 
job-6535,1,7,1,326266,403038,403084,76772,46,326388,false,L-s-0 
job-6537,2,7,1,326353,403084,403183,76731,99,326572,false,L-s-0 
job-6539,4,4,8,326461,403084,403323,76623,239,326990,false,C-l-0 C-l-2 C-l-0 C-l-2 C-l-2 C-m-0 C-l-0 C-m-0 
job-6538,3,8,6,326405,403084,403389,76679,305,327006,false,L-m-0 L-l-0 L-l-0 L-m-0 L-l-0 L-l-0 
job-6540,3,10,8,326508,403084,403477,76576,393,326917,false,C-s-1 C-l-1 C-l-1 C-m-1 C-m-1 C-l-1 C-s-2 C-l-1 
job-6541,3,4,7,326565,403477,403496,76912,19,326591,false,L-s-0 L-l-0 L-l-0 L-m-0 L-l-0 L-l-0 L-m-0 
job-6542,4,10,6,326618,403477,403621,76859,144,326999,false,C-l-0 C-l-1 C-l-1 C-l-0 C-l-0 C-l-1 
job-6543,1,11,1,326663,403621,403697,76958,76,326989,false,L-s-0 
job-6544,5,7,3,326722,403621,403794,76899,173,326907,false,L-m-0 L-l-0 L-l-0 
job-6546,5,5,4,326830,403794,403836,76964,42,327168,false,L-m-0 L-l-0 L-l-0 C-m-0 
job-6545,3,4,1,326772,403794,404112,77022,318,327107,false,L-s-0 
job-6548,3,11,6,326921,404112,404162,77191,50,327098,false,L-m-0 L-l-0 L-l-0 L-m-0 L-l-0 L-l-0 
job-6549,5,7,7,326969,404112,404191,77143,79,327049,false,C-l-0 C-l-2 C-l-1 C-m-0 C-l-1 C-l-0 C-l-2 
job-6550,2,9,8,327012,404112,404249,77100,137,327423,false,C-m-1 C-l-2 C-l-0 C-l-1 C-m-0 L-m-0 L-s-0 C-m-1 
job-6551,1,6,3,327068,404249,404280,77181,31,327154,false,L-s-0 L-m-0 L-m-0 
job-6547,1,6,1,326871,404112,404298,77241,186,327060,false,L-s-0 
job-6553,3,8,3,327158,404298,404314,77140,16,327427,false,L-l-0 L-m-0 L-l-0 
job-6552,1,4,6,327116,404280,404322,77164,42,327389,false,L-m-0 L-s-0 L-s-0 L-m-0 L-m-0 L-m-0 
job-6554,2,4,3,327200,404322,404529,77122,207,327497,false,L-m-0 L-m-0 L-m-0 
job-6556,4,11,6,327315,404529,404544,77214,15,327492,false,C-m-2 L-l-0 L-l-0 C-m-2 L-s-0 L-l-0 
job-6555,5,8,1,327254,404529,404571,77275,42,327388,false,L-m-0 
job-6557,3,9,4,327367,404529,404629,77162,100,327472,false,C-l-0 L-m-0 C-l-0 C-l-0 
job-6558,3,10,2,327416,404529,404907,77113,378,327809,false,C-s-0 C-l-0 
job-6559,5,10,7,327463,404907,404990,77444,83,327552,false,C-l-1 L-l-0 C-l-0 C-l-1 C-l-0 L-l-0 L-m-0 
job-6560,6,7,6,327504,404990,405015,77486,25,327801,false,C-m-0 C-l-0 L-l-0 L-m-0 C-l-0 L-l-0 
job-6561,3,5,1,327561,404990,405046,77429,56,327915,false,L-s-0 
job-6565,5,8,6,327768,405015,405063,77247,48,327883,false,C-m-1 C-l-1 C-l-1 C-m-0 C-l-2 C-l-2 
job-6562,2,7,2,327620,405015,405087,77395,72,327815,false,L-m-0 L-m-0 
job-6563,3,4,6,327675,405015,405091,77340,76,327834,false,C-s-1 L-l-0 L-l-0 L-m-0 L-l-0 L-l-0 
job-6566,5,6,6,327818,405063,405132,77245,69,328019,false,C-m-0 C-l-2 C-l-1 C-m-1 C-l-1 C-l-2 
job-6564,4,10,4,327726,405015,405168,77289,153,327936,false,C-s-2 C-l-0 C-l-0 C-l-0 
job-6567,5,12,6,327869,405132,405224,77263,92,327974,false,C-m-0 C-l-1 C-l-1 L-m-0 L-l-0 L-l-0 
job-6568,5,11,4,327910,405132,405298,77222,166,328353,false,C-m-2 C-l-2 C-l-2 C-m-1 
job-6569,2,6,2,327949,405298,405325,77349,27,328034,false,L-s-0 L-s-0 
job-6571,3,9,8,328057,405298,405454,77241,156,328231,false,L-l-0 L-l-0 C-l-0 C-l-0 C-l-0 L-l-0 L-l-0 C-l-0 
job-6570,1,8,3,328003,405298,405729,77295,431,328436,false,L-m-0 L-m-0 L-m-0 
job-6573,2,10,5,328158,405729,405751,77571,22,328334,false,L-m-0 L-m-0 L-s-0 L-m-0 C-s-1 
job-6572,1,8,5,328111,405729,405753,77618,24,328226,false,L-l-0 L-l-0 L-l-0 L-l-0 L-l-0 
job-6575,6,10,3,328245,405751,405774,77506,23,328458,false,L-m-0 C-l-2 C-l-2 
job-6574,4,9,8,328207,405729,405777,77522,48,328497,false,C-l-0 C-l-0 C-l-0 C-l-1 C-l-1 C-l-1 C-m-0 C-m-0 
job-6577,3,6,4,328341,405751,405777,77410,26,328521,false,C-m-1 C-m-2 C-m-1 C-m-2 
job-6576,1,4,6,328292,405751,405826,77459,75,328515,false,L-l-0 L-s-0 L-l-0 L-m-0 L-s-0 L-m-0 
job-6578,5,12,5,328389,405774,405868,77385,94,328622,false,L-m-0 C-l-2 L-l-0 C-l-2 L-l-0 
job-6579,5,8,8,328436,405868,405885,77432,17,328507,false,L-l-0 C-l-0 C-l-1 C-l-1 C-l-0 L-l-0 C-m-0 L-m-0 
job-6580,2,12,4,328490,405885,406030,77395,145,328763,false,L-l-0 L-l-0 L-l-0 L-l-0 
job-6581,1,7,7,328540,406030,406047,77490,17,328661,false,L-s-0 L-l-0 L-l-0 L-l-0 L-l-0 L-l-0 L-l-0 
job-6583,5,4,4,328648,406030,406127,77382,97,328991,false,C-l-0 L-l-0 C-l-0 C-m-1 
job-6582,6,11,2,328598,406030,406206,77432,176,328782,false,C-m-0 L-m-0 
job-6584,1,12,3,328701,406206,406256,77505,50,328860,false,L-l-0 L-l-0 L-l-0 
job-6585,2,6,6,328748,406206,406305,77458,99,328993,false,L-l-0 L-m-0 L-l-0 L-m-0 L-m-0 L-m-0 
job-6587,6,7,8,328836,406305,406322,77469,17,329117,false,C-l-0 L-l-0 C-l-2 C-l-2 C-l-0 L-l-0 C-m-0 L-m-0 
job-6588,4,11,4,328879,406305,406324,77426,19,329187,false,C-s-1 C-l-1 C-l-1 C-l-1 
job-6586,1,5,1,328800,406305,406365,77505,60,328923,false,L-s-0 
job-6589,3,7,5,328930,406305,406482,77375,177,329318,false,L-s-0 C-m-1 C-m-2 C-m-1 C-m-2 
job-6590,5,7,3,328973,406482,406507,77509,25,329141,false,L-l-0 L-l-0 L-m-0 
job-6591,6,12,5,329033,406482,406510,77449,28,329278,false,C-m-0 C-l-1 C-l-1 C-l-0 C-l-0 
job-6592,2,9,3,329084,406507,406542,77423,35,329262,false,L-m-0 L-m-0 C-m-0 
job-6594,3,4,4,329189,406542,406552,77353,10,329337,false,L-l-0 L-l-0 L-s-0 L-l-0 
job-6593,1,5,1,329144,406542,406572,77398,30,329428,false,L-s-0 
job-6595,2,4,5,329252,406542,406589,77290,47,329397,false,L-m-0 L-m-0 L-m-0 L-m-0 L-l-0 
job-6597,6,11,8,329347,406589,406696,77242,107,329663,false,C-m-2 C-l-2 C-l-0 C-l-2 L-l-0 C-m-0 C-m-1 L-m-0 
job-6596,1,12,8,329292,406542,406753,77250,211,329684,false,C-l-0 C-l-1 L-l-0 C-l-1 C-l-1 C-l-1 C-l-0 C-l-0 
job-6598,3,12,7,329410,406696,406824,77286,128,329704,false,L-s-0 L-l-0 C-l-0 L-m-0 L-l-0 L-m-0 L-l-0 
job-6601,5,11,4,329557,406824,406835,77267,11,329794,false,C-l-0 C-l-1 C-l-0 C-l-1 
job-6600,2,8,6,329503,406824,406860,77321,36,329709,false,L-l-0 L-l-0 L-l-0 L-l-0 L-l-0 L-l-0 
job-6602,1,4,8,329597,406835,406868,77238,33,329821,false,C-s-1 C-s-1 L-s-0 C-s-1 L-s-0 L-s-0 C-s-1 L-s-0 
job-6599,2,4,4,329455,406824,406891,77369,67,329709,false,L-m-0 L-m-0 L-m-0 L-m-0 
job-6603,6,9,6,329635,406835,406939,77200,104,329868,false,C-l-0 C-l-2 C-l-1 C-l-2 C-l-1 C-l-0 
job-6604,5,7,4,329667,406860,406985,77193,125,329880,false,C-m-0 L-l-0 L-l-0 C-m-1 
job-6606,5,8,7,329746,406985,407017,77239,32,330028,false,L-l-0 C-l-1 C-l-0 L-m-0 C-l-0 C-l-1 L-l-0 
job-6605,2,9,1,329706,406985,407050,77279,65,329779,false,L-s-0 
job-6607,1,8,4,329801,407017,407126,77216,109,330202,false,L-m-0 L-m-0 L-m-0 L-m-0 
job-6608,4,10,1,329849,407126,407154,77277,28,330052,false,L-s-0 
job-6609,3,5,6,329892,407126,407427,77234,301,330287,false,L-l-0 L-l-0 L-m-0 L-m-0 L-l-0 L-l-0 
job-6610,4,10,3,329934,407427,407457,77493,30,330014,false,L-m-0 L-m-0 L-s-0 
job-6611,5,10,2,329988,407427,407471,77439,44,330048,false,L-l-0 L-l-0 
job-6613,4,10,4,330090,407427,407531,77337,104,330235,false,C-l-1 C-l-1 C-l-1 C-s-1 
job-6612,1,10,6,330039,407427,407532,77388,105,330247,false,L-l-0 C-l-0 L-l-0 C-l-0 C-l-0 C-l-0 
job-6614,5,9,6,330127,407457,407624,77330,167,330468,false,L-m-0 C-l-2 C-m-2 C-m-0 C-l-2 C-m-1 
job-6615,1,8,1,330173,407624,407849,77451,225,330470,false,L-s-0 
job-6616,2,10,2,330232,407849,407866,77617,17,330354,false,L-m-0 L-m-0 
job-6617,4,11,5,330283,407849,407872,77566,23,330484,false,L-l-0 L-s-0 L-m-0 L-l-0 L-l-0 
job-6618,1,11,7,330335,407849,408130,77514,281,330771,false,C-l-0 C-l-1 C-l-1 C-l-1 C-l-1 C-l-0 C-l-0 
job-6619,5,12,2,330401,408130,408288,77729,158,330772,false,L-l-0 L-l-0 
job-6620,3,8,5,330451,408288,408301,77837,13,330702,false,L-l-0 L-s-0 L-l-0 L-l-0 L-l-0 
job-6621,5,6,2,330499,408288,408352,77789,64,330840,false,L-m-0 C-m-0 
job-6623,4,5,5,330583,408288,408361,77705,73,330915,false,C-m-1 C-l-2 C-l-2 C-m-1 C-l-2 
job-6622,4,7,7,330541,408288,408406,77747,118,330717,false,C-l-0 C-l-1 C-l-1 C-l-0 C-l-1 C-l-0 C-s-1 
job-6624,6,4,7,330634,408361,408515,77727,154,331048,false,C-m-1 L-l-0 C-l-2 L-m-0 L-l-0 C-l-2 C-m-0 
job-6626,6,7,1,330732,408406,408524,77674,118,330953,false,C-l-0 
job-6625,4,7,3,330680,408361,408568,77681,207,331072,false,L-s-0 C-m-2 C-m-2 
job-6627,1,11,7,330780,408515,408786,77735,271,331314,false,L-l-0 L-l-0 C-l-0 C-l-0 L-l-0 L-l-0 C-l-0 
job-6629,3,12,7,330885,408786,408808,77901,22,330925,false,L-m-0 L-s-0 L-l-0 L-l-0 L-l-0 L-l-0 L-m-0 
job-6630,2,4,2,330943,408786,408812,77843,26,331092,false,C-s-1 L-m-0 
job-6628,1,4,1,330831,408786,408825,77955,39,331057,false,L-s-0 
job-6631,4,7,4,331002,408786,408913,77784,127,331169,false,C-l-0 C-l-0 C-l-0 C-s-2 
job-6632,1,8,5,331038,408786,408958,77748,172,331243,false,C-s-1 C-m-0 C-m-0 C-m-0 C-m-0 
job-6633,1,9,4,331087,408913,408970,77826,57,331353,false,L-s-0 L-m-0 L-m-0 L-m-0 
job-6634,3,11,1,331139,408913,409134,77774,221,331638,false,L-l-0 
job-6636,6,8,6,331243,409134,409150,77891,16,331348,false,L-l-0 C-l-0 C-l-1 L-l-0 C-l-0 C-l-1 
job-6635,5,12,1,331188,409134,409152,77946,18,331428,false,L-m-0 
job-6637,5,7,4,331293,409134,409161,77841,27,331457,false,C-m-1 C-l-2 C-l-2 C-m-0 
job-6638,5,12,2,331334,409150,409291,77816,141,331639,false,L-l-0 L-l-0 
job-6639,3,4,4,331377,409150,409346,77773,196,331606,false,L-m-0 L-s-0 C-m-0 C-m-1 
job-6640,5,7,7,331439,409161,409806,77722,645,332360,false,L-m-0 C-l-1 C-l-1 C-m-1 C-l-0 C-l-0 C-m-0 
job-6642,4,8,4,331542,409806,409891,78264,85,331906,false,L-s-0 C-l-0 C-l-0 C-l-0 
job-6641,6,11,3,331490,409806,409978,78316,172,331722,false,L-l-0 L-l-0 L-m-0 
job-6643,4,5,2,331580,409978,409998,78398,20,331865,false,L-m-0 L-m-0 
job-6644,1,11,8,331623,409978,410056,78355,78,331754,false,L-l-0 L-l-0 C-l-0 C-l-0 C-l-0 L-l-0 C-l-0 L-l-0 
job-6646,6,12,5,331734,410056,410068,78322,12,331851,false,L-m-0 C-l-0 L-l-0 L-l-0 C-l-0 
job-6645,3,8,1,331679,410056,410091,78377,35,331751,false,L-s-0 
job-6647,1,5,2,331783,410068,410155,78285,87,331998,false,L-s-0 L-m-0 
job-6648,1,5,6,331827,410068,410459,78241,391,332353,false,L-m-0 L-m-0 L-m-0 L-m-0 L-l-0 L-m-0 
job-6649,6,4,2,331884,410459,410544,78575,85,332224,false,L-l-0 L-l-0 
job-6650,4,8,4,331939,410459,410544,78520,85,332086,false,L-m-0 L-m-0 L-s-0 C-s-1 
job-6651,3,10,5,331987,410544,410574,78557,30,332059,false,L-l-0 L-l-0 L-l-0 C-s-2 L-l-0 
job-6652,6,5,4,332049,410544,410579,78495,35,332245,false,C-l-1 C-l-0 C-l-0 C-l-1 
job-6653,3,9,2,332104,410544,410632,78440,88,332192,false,C-m-2 C-m-2 
job-6654,1,12,7,332155,410632,410655,78477,23,332405,false,L-s-0 L-l-0 L-l-0 L-m-0 L-l-0 L-l-0 L-m-0 
job-6655,6,11,8,332196,410632,410666,78436,34,332465,false,C-l-0 C-l-2 C-l-1 C-l-2 C-l-0 C-m-1 C-l-1 C-m-0 
job-6656,1,12,8,332247,410655,410709,78408,54,332429,false,L-l-0 L-l-0 L-l-0 L-l-0 C-m-0 C-m-1 L-m-0 L-m-0 
job-6657,1,10,7,332314,410655,410728,78341,73,332630,false,L-s-0 C-m-2 C-s-2 C-m-2 C-s-0 C-s-1 C-m-2 
job-6658,6,4,2,332368,410709,410868,78341,159,332670,false,L-l-0 L-l-0 
job-6660,1,12,6,332486,410709,410882,78223,173,332791,false,C-m-1 C-l-1 C-l-1 C-m-1 C-l-1 C-l-1 
job-6659,4,8,7,332429,410709,410917,78280,208,332928,false,L-m-0 C-l-0 C-l-0 C-m-0 C-l-0 C-m-0 L-m-0 
job-6661,3,4,5,332537,410868,410925,78331,57,332859,false,L-l-0 C-m-1 L-l-0 L-l-0 C-m-1 
job-6662,5,9,8,332590,410917,411044,78327,127,332826,false,C-m-0 C-l-1 C-l-2 C-l-0 C-l-1 C-l-2 C-l-0 L-m-0 
job-6663,4,5,7,332630,410925,411081,78295,156,332982,false,C-m-1 L-l-0 C-s-1 C-m-1 L-l-0 L-l-0 L-s-0 
job-6667,5,5,4,332834,411044,411116,78210,72,333111,false,C-m-2 C-l-2 C-l-2 C-m-0 
job-6665,3,11,5,332728,411044,411129,78316,85,332839,false,C-l-1 C-l-1 C-l-1 L-m-0 C-l-1 
job-6664,1,7,2,332684,411044,411153,78360,109,332992,false,L-m-0 L-m-0 
job-6666,2,4,7,332777,411044,411209,78267,165,333102,false,C-l-0 L-m-0 C-l-0 C-l-0 C-l-0 C-l-0 C-l-0 
job-6668,1,10,4,332889,411116,411304,78227,188,333276,false,L-l-0 L-l-0 L-l-0 L-l-0 
job-6669,5,9,6,332943,411129,411333,78186,204,333335,false,C-m-0 C-l-1 C-l-1 C-m-1 C-l-2 C-l-2 
job-6670,6,6,5,333004,411209,411467,78205,258,333514,false,L-m-0 L-l-0 C-l-0 C-m-2 C-l-0 
job-6672,6,9,7,333111,411467,411504,78356,37,333435,false,C-m-1 C-l-1 C-l-0 C-l-2 C-l-1 C-l-0 C-l-2 
job-6671,6,6,3,333063,411467,411506,78404,39,333278,false,L-l-0 L-l-0 L-m-0 
job-6675,5,9,7,333285,411506,411522,78221,16,333397,false,C-m-1 C-l-2 L-l-0 C-m-2 C-l-2 L-l-0 L-m-0 
job-6673,1,10,5,333163,411504,411523,78341,19,333207,false,L-m-0 C-m-0 L-m-0 C-m-0 C-m-0 
job-6674,4,5,7,333225,411504,411536,78279,32,333295,false,L-s-0 C-l-0 C-l-1 C-l-1 C-l-1 C-l-0 C-l-0 
job-6677,1,11,5,333391,411522,411633,78131,111,333782,false,L-l-0 C-l-2 C-l-2 L-l-0 C-l-2 
job-6676,2,12,3,333344,411522,411637,78178,115,333576,false,L-l-0 L-l-0 L-m-0 
job-6678,2,8,1,333429,411637,411697,78208,60,333512,false,L-s-0 
job-6680,3,4,4,333517,411637,411713,78120,76,333637,false,L-m-0 C-m-0 L-m-0 C-m-0 
job-6679,2,6,7,333470,411637,411720,78167,83,333596,false,L-l-0 L-s-0 L-l-0 L-l-0 L-l-0 L-l-0 L-l-0 
job-6681,4,11,5,333564,411637,411854,78073,217,333833,false,C-m-1 C-l-1 C-l-1 C-m-1 C-l-1 
job-6682,5,5,1,333614,411637,411886,78023,249,334002,false,C-m-2 
job-6683,1,4,8,333659,411854,411892,78195,38,333801,false,C-m-2 C-m-2 L-m-0 L-m-0 L-m-0 L-m-0 C-m-2 L-m-0 
job-6684,1,6,4,333706,411854,412022,78148,168,333933,false,L-s-0 L-m-0 L-s-0 L-m-0 
job-6685,4,5,2,333765,412022,412085,78257,63,333922,false,L-m-0 L-m-0 
job-6687,1,8,3,333870,412022,412105,78152,83,334186,false,L-s-0 C-s-1 C-s-1 
job-6688,4,10,1,333917,412022,412144,78105,122,334262,false,C-s-2 
job-6689,2,10,7,333967,412022,412174,78055,152,334126,false,C-m-0 C-m-0 C-m-2 C-m-2 C-m-0 C-s-0 C-m-2 
job-6686,4,11,3,333812,412022,412192,78210,170,334249,false,L-l-0 L-l-0 L-l-0 
job-6690,1,12,1,334027,412144,412200,78117,56,334217,false,L-s-0 
job-6692,1,8,6,334126,412174,412223,78048,49,334195,false,C-m-0 L-m-0 L-m-0 C-m-0 C-m-0 L-m-0 
job-6693,1,11,2,334171,412174,412303,78003,129,334375,false,C-m-1 C-m-1 
job-6691,1,5,1,334076,412174,412369,78098,195,334336,false,L-m-0 
job-6694,3,6,7,334224,412174,412493,77950,319,334694,false,C-l-0 C-l-0 C-l-0 C-m-1 C-l-0 C-s-1 C-m-0 
job-6695,2,12,2,334268,412493,412626,78225,133,334411,false,L-m-0 L-m-0 
job-6698,6,12,7,334445,412626,412644,78181,18,334487,false,C-l-0 C-l-1 C-l-2 C-m-1 C-l-1 C-l-2 C-l-0 
job-6697,6,4,2,334382,412626,412649,78244,23,334434,false,L-m-0 L-l-0 
job-6696,1,10,5,334323,412493,412656,78170,163,334777,false,L-l-0 L-l-0 L-l-0 L-s-0 L-l-0 
job-6699,4,4,7,334492,412626,412704,78134,78,334749,false,C-m-2 C-m-0 C-s-0 C-m-2 C-m-0 C-s-2 C-s-1 
job-6701,1,12,5,334583,412644,412893,78061,249,335025,false,C-l-0 L-m-0 L-m-0 C-l-0 C-l-0 
job-6700,3,10,8,334543,412644,412987,78101,343,334978,false,C-l-1 C-l-1 C-l-2 C-l-2 C-l-2 C-l-1 C-l-2 C-l-1 
job-6702,5,7,5,334632,412893,413004,78261,111,334866,false,L-l-0 L-l-0 C-l-0 L-m-0 C-l-0 
job-6703,1,5,6,334686,413004,413062,78318,58,335002,false,L-m-0 L-m-0 L-m-0 L-m-0 L-m-0 L-m-0 
job-6705,5,7,7,334772,413004,413077,78232,73,334997,false,C-l-0 C-m-1 C-l-2 C-l-1 C-l-1 C-l-2 C-l-0 
job-6704,3,4,5,334722,413004,413154,78282,150,335097,false,L-s-0 L-l-0 L-l-0 L-l-0 L-l-0 
job-6706,6,10,7,334825,413077,413161,78252,84,334997,false,L-m-0 C-l-0 C-l-1 C-l-2 C-l-1 C-l-0 C-l-2 
job-6707,4,4,4,334882,413077,413360,78195,283,335447,false,C-m-0 C-m-1 C-m-0 C-m-1 
job-6708,2,12,4,334926,413360,413416,78434,56,335278,false,L-l-0 L-l-0 L-l-0 L-l-0 
job-6711,6,8,5,335074,413360,413436,78286,76,335323,false,C-l-0 C-l-2 C-l-0 C-m-1 C-l-2 
job-6710,4,8,6,335028,413360,413451,78332,91,335415,false,C-m-0 C-l-1 L-s-0 C-m-0 C-l-1 C-l-1 
job-6709,4,12,2,334973,413360,413557,78387,197,335399,false,L-m-0 L-m-0 
job-6713,5,8,8,335184,413451,413562,78267,111,335434,false,C-m-1 C-l-1 C-l-0 C-l-2 C-l-1 C-l-0 C-l-2 C-m-0 
job-6712,2,11,7,335118,413416,413784,78298,368,335630,false,C-m-2 L-l-0 C-m-1 C-m-2 L-l-0 L-l-0 L-l-0 
job-6715,5,11,4,335274,413784,413851,78510,67,335443,false,L-m-0 C-l-0 C-l-0 C-m-0 
job-6714,3,5,5,335222,413784,413921,78562,137,335385,false,L-s-0 L-l-0 L-l-0 L-l-0 L-l-0 
job-6716,1,4,6,335340,413851,413935,78511,84,335523,false,L-m-0 L-s-0 L-m-0 L-m-0 L-m-0 L-m-0 
job-6717,4,5,8,335389,413851,414074,78462,223,335683,false,C-l-0 C-l-2 C-l-0 C-l-2 C-l-0 C-m-0 C-l-2 C-m-0 
job-6718,3,7,8,335449,414074,414106,78625,32,335642,false,L-m-0 L-s-0 C-s-1 L-l-0 L-l-0 L-l-0 L-l-0 L-m-0 
job-6719,2,8,1,335501,414106,414258,78605,152,335824,false,L-s-0 
job-6720,1,9,2,335554,414106,414261,78552,155,335765,false,L-m-0 L-m-0 
job-6721,2,5,6,335604,414258,414302,78654,44,335661,false,L-l-0 L-m-0 L-m-0 L-l-0 L-l-0 L-l-0 
job-6722,1,4,8,335641,414258,414337,78617,79,335847,false,L-s-0 L-s-0 L-l-0 L-l-0 L-m-0 L-l-0 L-l-0 L-s-0 
job-6723,5,11,2,335686,414258,414357,78572,99,336079,false,C-l-0 C-l-0 
job-6724,1,6,5,335733,414337,414363,78604,26,335985,false,L-m-0 L-m-0 C-l-0 C-l-0 L-m-0 
job-6725,1,4,7,335765,414337,414401,78572,64,336080,false,L-s-0 L-m-0 L-s-0 L-m-0 L-s-0 L-m-0 L-s-0 
job-6726,6,4,2,335810,414337,414457,78527,120,336085,false,L-l-0 L-l-0 
job-6727,4,11,2,335865,414457,414470,78592,13,335941,false,L-m-0 L-m-0 
job-6728,4,9,5,335926,414457,414641,78531,184,336112,false,C-s-1 L-l-0 L-l-0 L-l-0 L-s-0 
job-6729,1,6,2,335983,414641,414746,78658,105,336287,false,L-s-0 L-s-0 
job-6730,4,10,1,336031,414746,414760,78715,14,336167,false,L-s-0 
job-6731,5,8,3,336069,414746,414802,78677,56,336221,false,L-l-0 L-m-0 L-l-0 
job-6732,3,7,4,336125,414746,414842,78621,96,336329,false,C-l-0 L-m-0 C-l-0 C-l-0 
job-6733,6,9,6,336168,414746,414924,78578,178,336355,false,C-m-1 C-l-1 C-l-2 C-m-0 C-l-2 C-l-1 
job-6734,6,6,3,336224,414924,414957,78700,33,336438,false,L-l-0 L-l-0 L-m-0 
job-6735,6,7,3,336271,414924,415390,78653,466,336784,false,C-l-0 C-l-0 C-m-0 
job-6736,5,5,7,336324,415390,415400,79066,10,336535,false,C-l-1 L-l-0 C-l-0 C-l-1 C-l-0 L-l-0 L-m-0 
job-6738,4,6,4,336421,415400,415417,78979,17,336574,false,C-s-1 L-m-0 L-s-0 L-m-0 
job-6737,1,6,8,336365,415400,415457,79035,57,336568,false,L-l-0 L-l-0 L-l-0 L-l-0 L-l-0 L-l-0 L-l-0 L-l-0 
job-6739,6,9,5,336474,415400,415665,78926,265,336901,false,C-m-0 C-l-2 C-l-0 C-l-2 C-l-0 
job-6740,6,11,7,336518,415665,415711,79147,46,336785,false,L-m-0 C-l-0 C-l-1 L-l-0 C-l-0 C-l-1 L-l-0 
job-6742,6,4,6,336639,415711,415804,79072,93,336951,false,L-m-0 C-l-1 L-l-0 C-m-1 C-l-1 L-l-0 
job-6741,4,5,3,336570,415665,415831,79095,166,336893,false,L-s-0 C-m-0 C-m-0 
job-6744,3,5,7,336737,415711,415853,78974,142,336993,false,C-s-2 C-l-2 C-l-2 C-s-1 C-l-2 C-l-2 C-m-2 
job-6743,5,4,1,336697,415711,416150,79014,439,337381,false,C-m-2 
job-6746,3,12,5,336840,416150,416290,79310,140,337188,false,L-l-0 L-l-0 L-l-0 C-s-1 L-l-0 
job-6745,4,12,3,336788,416150,416302,79362,152,337076,false,L-m-0 L-m-0 L-s-0 
job-6747,5,6,8,336879,416290,416302,79411,12,336920,false,C-l-0 L-l-0 C-l-0 C-l-1 C-l-1 L-l-0 C-l-2 C-l-2 
job-6748,2,4,1,336921,416302,416407,79381,105,337260,false,L-s-0 
job-6750,5,5,3,337005,416407,416600,79402,193,337480,false,C-l-2 C-l-2 C-m-0 
job-6749,6,9,7,336960,416302,416705,79342,403,337457,false,L-m-0 C-l-1 C-l-0 L-l-0 C-l-0 L-l-0 C-l-1 
job-6751,6,11,1,337055,416705,416735,79650,30,337267,false,L-m-0 
job-6753,5,8,2,337152,416705,416738,79553,33,337347,false,C-l-0 C-l-0 
job-6752,3,8,3,337108,416705,416747,79597,42,337198,false,L-l-0 L-l-0 L-l-0 
job-6755,1,12,4,337266,416735,416798,79469,63,337375,false,C-m-0 L-m-0 L-m-0 C-m-0 
job-6754,1,6,7,337215,416735,416833,79520,98,337424,false,L-l-0 C-l-0 C-l-0 L-s-0 L-s-0 L-l-0 L-l-0 
job-6756,2,9,3,337315,416833,416866,79518,33,337470,false,L-m-0 L-m-0 L-m-0 
job-6758,6,8,5,337418,416833,416952,79415,119,337678,false,C-m-0 C-l-2 C-l-1 C-l-1 C-l-2 
job-6760,5,12,3,337520,416952,416998,79432,46,337629,false,C-m-0 C-l-1 C-l-1 
job-6759,3,6,3,337468,416952,417043,79484,91,337565,false,L-m-0 L-s-0 L-m-0 
job-6757,5,7,4,337364,416833,417053,79469,220,337626,false,L-l-0 C-l-0 C-l-0 L-l-0 
job-6761,3,10,7,337577,416952,417185,79375,233,338098,false,C-m-1 C-l-2 C-m-1 C-l-2 C-l-2 C-l-2 C-m-0 
job-6763,4,10,4,337665,417185,417251,79520,66,337766,false,L-m-0 L-l-0 L-l-0 L-l-0 
job-6762,2,12,1,337620,417185,417438,79565,253,338117,false,L-s-0 
job-6764,3,11,5,337696,417438,417449,79742,11,337897,false,L-l-0 L-s-0 L-l-0 L-l-0 L-l-0 
job-6765,1,12,3,337738,417438,417517,79700,79,338084,false,L-m-0 L-m-0 C-s-1 
job-6766,2,5,7,337783,417438,417579,79655,141,338185,false,C-l-0 C-l-0 C-l-0 C-l-0 C-l-0 C-l-0 L-m-0 
job-6767,4,8,1,337824,417579,417629,79755,50,338095,false,L-s-0 
job-6768,5,4,2,337870,417579,417761,79709,182,338052,false,L-l-0 L-l-0 
job-6769,2,7,5,337926,417761,417812,79835,51,338115,false,L-l-0 L-l-0 L-l-0 L-l-0 L-l-0 
job-6771,5,8,2,338008,417812,417902,79804,90,338183,false,L-l-0 L-l-0 
job-6770,5,8,4,337972,417761,417908,79789,147,338190,false,C-m-0 C-l-0 C-l-0 L-m-0 
job-6772,6,7,7,338067,417902,418034,79835,132,338380,false,C-l-2 C-l-2 C-l-1 C-m-1 C-l-1 L-l-0 L-l-0 
job-6773,6,11,1,338112,417902,418412,79790,510,338713,false,C-m-2 
job-6774,2,7,8,338160,418412,418565,80252,153,338438,false,L-l-0 L-l-0 L-l-0 L-l-0 L-l-0 L-s-0 L-l-0 L-s-0 
job-6775,4,5,1,338207,418565,418591,80358,26,338440,false,L-s-0 
job-6776,6,6,3,338249,418565,418796,80316,231,338622,false,L-l-0 L-m-0 L-l-0 
job-6777,2,9,2,338298,418796,418824,80498,28,338486,false,L-m-0 L-m-0 
job-6778,6,11,5,338350,418796,418851,80446,55,338546,false,C-m-0 C-l-0 L-l-0 L-l-0 C-l-0 
job-6779,2,5,2,338401,418824,418890,80423,66,338531,false,L-s-0 C-m-0 
job-6780,3,7,3,338450,418890,418908,80440,18,338543,false,L-m-0 L-m-0 L-s-0 
job-6781,6,5,4,338503,418890,418986,80387,96,338771,false,C-l-0 L-l-0 C-l-0 L-l-0 
job-6782,1,8,2,338559,418986,418996,80427,10,338738,false,L-s-0 L-s-0 
job-6783,4,11,4,338614,418986,419062,80372,76,338766,false,L-l-0 L-m-0 L-l-0 L-m-0 
job-6785,6,11,2,338709,419062,419111,80353,49,339024,false,L-l-0 L-l-0 
job-6787,4,9,6,338810,419062,419125,80252,63,339076,false,C-l-0 C-l-0 C-l-1 C-l-1 C-l-1 C-l-0 
job-6784,2,10,2,338665,419062,419132,80397,70,338781,false,L-m-0 L-m-0 
job-6788,6,9,3,338862,419125,419180,80263,55,339206,false,C-m-0 L-l-0 L-l-0 
job-6786,1,9,3,338763,419062,419262,80299,200,339252,false,C-s-1 L-m-0 L-s-0 
job-6789,6,9,3,338916,419125,419289,80209,164,339299,false,C-m-1 C-l-0 C-l-0 
job-6790,2,7,4,338959,419262,419752,80303,490,339503,false,L-m-0 C-m-1 L-m-0 L-m-0 
job-6793,3,12,5,339116,419752,419852,80636,100,339479,false,L-m-0 C-l-0 C-l-0 C-l-0 C-l-0 
job-6794,5,11,6,339180,419852,419863,80672,11,339470,false,C-m-0 C-l-0 C-l-1 L-m-0 C-l-0 C-l-1 
job-6795,4,5,2,339223,419852,419873,80629,21,339316,false,C-m-1 C-m-1 
job-6791,6,9,2,339022,419752,419886,80730,134,339260,false,L-l-0 L-l-0 
job-6792,4,12,1,339065,419752,419899,80687,147,339379,false,L-s-0 
job-6797,3,6,5,339307,419863,419900,80556,37,339608,false,C-s-1 C-l-1 C-l-1 C-l-1 C-l-1 
job-6798,3,8,5,339359,419863,419983,80504,120,339522,false,C-l-0 C-l-0 C-l-0 C-s-2 C-l-0 
job-6799,5,7,8,339403,419983,419998,80580,15,339601,false,L-l-0 C-l-1 C-l-0 C-l-0 C-l-1 C-l-2 C-l-2 L-l-0 
job-6796,3,12,2,339270,419863,420059,80593,196,339517,false,L-m-0 L-m-0 
job-6800,6,9,2,339451,419983,420218,80532,235,339828,false,C-m-0 C-m-1 
job-6802,3,12,8,339541,420218,420250,80677,32,339853,false,L-m-0 L-l-0 L-l-0 L-l-0 C-m-0 L-l-0 C-m-0 L-m-0 
job-6801,1,5,3,339499,420218,420286,80719,68,339812,false,L-s-0 L-s-0 L-s-0 
job-6804,6,4,6,339633,420286,420304,80653,18,339930,false,C-m-0 L-l-0 C-l-1 C-l-1 L-l-0 L-m-0 
job-6803,6,11,4,339585,420218,420319,80633,101,339800,false,C-l-2 C-l-0 C-l-0 C-l-2 
job-6805,2,10,3,339680,420286,420329,80606,43,339786,false,L-s-0 C-m-0 L-m-0 
job-6806,1,8,8,339733,420286,420503,80553,217,340111,false,C-m-1 C-m-2 C-m-2 C-m-2 C-m-1 C-m-2 C-m-1 C-m-1 
job-6807,6,7,5,339784,420503,420536,80719,33,339837,false,L-m-0 C-l-0 L-l-0 L-l-0 C-l-0 
job-6808,6,12,1,339839,420503,420542,80664,39,340108,false,C-m-0 
job-6809,3,4,3,339874,420503,420689,80629,186,340230,false,L-s-0 C-m-1 C-m-1 
job-6810,1,7,7,339919,420689,420702,80770,13,340004,false,L-s-0 L-l-0 L-l-0 L-l-0 L-l-0 L-l-0 L-l-0 
job-6812,4,7,6,340018,420689,420733,80671,44,340073,false,C-l-1 C-l-1 C-l-1 C-l-2 C-l-2 C-l-2 
job-6811,5,4,4,339980,420689,420743,80709,54,340150,false,C-l-0 L-l-0 C-l-0 L-m-0 
job-6813,1,6,8,340059,420743,420779,80684,36,340343,false,L-l-0 L-l-0 L-l-0 L-l-0 L-l-0 L-l-0 L-l-0 L-l-0 
job-6814,2,6,1,340111,420743,420902,80632,159,340505,false,L-s-0 
job-6816,3,9,4,340202,420902,420942,80700,40,340293,false,L-l-0 L-l-0 L-l-0 L-l-0 
job-6815,3,11,3,340151,420743,420943,80592,200,340416,false,L-m-0 L-m-0 C-s-2 
job-6818,3,11,4,340295,420902,421012,80607,110,340554,false,C-l-2 C-l-2 C-l-2 C-l-2 
job-6817,6,9,5,340254,420902,421019,80648,117,340499,false,C-m-0 C-l-1 C-l-0 C-l-1 C-l-0 
job-6819,1,9,2,340352,421019,421116,80667,97,340553,false,L-m-0 L-m-0 
job-6820,3,7,8,340406,421019,421693,80613,674,341319,false,L-m-0 L-l-0 L-l-0 L-s-0 L-l-0 L-l-0 C-s-1 L-m-0 
job-6821,6,7,2,340447,421693,421744,81246,51,340537,false,L-l-0 L-l-0 
job-6824,3,5,3,340596,421744,421762,81148,18,340695,false,L-s-0 C-s-1 L-l-0 
job-6823,4,5,3,340542,421744,421769,81202,25,340807,false,L-l-0 L-l-0 L-m-0 
job-6822,2,11,2,340500,421693,421787,81193,94,340831,false,L-m-0 L-m-0 
job-6825,2,12,8,340642,421744,422079,81102,335,341182,false,C-l-0 C-l-0 C-l-1 C-l-0 C-l-1 C-l-1 C-l-0 C-l-1 
job-6826,4,5,7,340694,422079,422127,81385,48,340791,false,L-l-0 L-m-0 L-s-0 L-l-0 L-m-0 L-l-0 C-s-1 
job-6827,6,11,4,340733,422079,422276,81346,197,341186,false,C-l-2 C-l-0 C-l-0 C-l-2 
job-6828,2,5,1,340784,422276,422339,81492,63,341081,false,L-s-0 
job-6830,4,7,7,340871,422276,422359,81405,83,341174,false,L-l-0 C-l-1 C-l-0 C-l-0 C-l-1 C-l-1 C-l-0 
job-6831,6,5,3,340916,422276,422408,81360,132,341291,false,C-l-2 C-l-2 C-m-0 
job-6829,1,10,8,340825,422276,422442,81451,166,341247,false,L-s-0 L-l-0 L-l-0 L-l-0 L-l-0 L-m-0 L-m-0 L-m-0 
job-6833,1,12,8,341022,422359,422483,81337,124,341204,false,C-l-0 C-m-0 C-l-0 C-l-0 C-m-2 C-l-0 C-m-0 C-m-1 
job-6832,3,6,8,340975,422339,422524,81364,185,341418,false,C-s-1 L-s-0 C-s-0 C-m-1 C-m-2 C-m-2 C-s-2 C-m-1 
job-6834,2,6,4,341070,422359,422707,81289,348,341434,false,C-l-1 C-l-1 L-l-0 C-l-1 
job-6835,4,4,7,341137,422707,422721,81570,14,341260,false,L-l-0 L-m-0 L-s-0 L-l-0 L-m-0 L-l-0 C-s-1 
job-6836,5,5,6,341192,422707,422743,81515,36,341448,false,C-l-0 C-l-1 C-l-0 C-l-2 C-l-1 C-l-2 
job-6837,4,7,5,341248,422707,422774,81459,67,341321,false,C-m-1 C-s-2 C-m-0 C-m-0 C-m-1 
job-6838,3,12,1,341296,422707,422782,81411,75,341434,false,C-s-0 
job-6839,2,4,6,341345,422774,422786,81429,12,341613,false,L-l-0 L-l-0 L-l-0 L-l-0 L-l-0 L-l-0 
job-6841,6,12,5,341438,422774,422816,81336,42,341739,false,L-m-0 C-l-1 C-l-0 C-l-1 C-l-0 
job-6840,4,5,1,341393,422774,423050,81381,276,341836,false,L-s-0 
job-6842,3,12,2,341488,423050,423071,81562,21,341566,false,L-m-0 L-m-0 
job-6843,1,6,2,341536,423050,423465,81514,415,342127,false,L-s-0 L-m-0 
job-6845,1,7,4,341654,423465,423507,81811,42,341951,false,L-s-0 L-m-0 L-m-0 L-m-0 
job-6844,2,6,1,341595,423465,423528,81870,63,341684,false,L-s-0 
job-6847,4,6,5,341754,423507,423552,81753,45,341975,false,C-m-0 L-l-0 L-l-0 C-m-0 L-l-0 
job-6846,5,10,1,341708,423507,423583,81799,76,341831,false,L-m-0 
job-6848,4,11,2,341810,423507,423652,81697,145,342033,false,C-m-1 C-m-1 
job-6849,4,6,6,341868,423507,423824,81639,317,342289,false,C-l-0 C-l-0 C-l-0 C-l-1 C-l-1 C-l-1 
job-6850,2,6,2,341918,423824,423855,81906,31,342129,false,L-s-0 L-s-0 
job-6851,3,6,8,341969,423824,423972,81855,148,342300,false,C-m-0 L-l-0 L-l-0 L-l-0 L-l-0 L-m-0 C-m-0 L-m-0 
job-6853,5,10,7,342059,423972,423995,81913,23,342299,false,L-l-0 C-l-0 C-l-0 C-l-1 C-l-1 L-l-0 C-m-0 
job-6852,2,12,3,342011,423972,424019,81961,47,342097,false,L-m-0 L-m-0 L-s-0 
job-6854,6,11,6,342133,423995,424147,81862,152,342436,false,L-l-0 C-l-2 C-l-0 L-l-0 C-l-0 C-l-2 
job-6855,5,12,1,342177,424147,424206,81970,59,342483,false,L-m-0 
job-6856,5,6,2,342239,424147,424229,81908,82,342447,false,L-l-0 L-l-0 
job-6858,4,4,8,342350,424229,424265,81879,36,342452,false,L-l-0 L-l-0 L-m-0 C-l-0 C-l-0 L-l-0 C-l-0 L-m-0 
job-6857,1,4,1,342288,424229,424361,81941,132,342425,false,L-s-0 
job-6859,1,6,4,342410,424361,424375,81951,14,342587,false,L-m-0 L-m-0 L-m-0 L-m-0 
job-6861,6,10,5,342507,424361,424488,81854,127,342892,false,C-m-0 C-l-1 C-l-1 C-l-2 C-l-2 
job-6860,3,9,8,342461,424361,424620,81900,259,342963,false,L-l-0 C-l-0 C-l-0 C-l-0 C-l-0 L-l-0 L-l-0 L-l-0 
job-6862,1,9,2,342551,424620,424635,82069,15,342590,false,L-m-0 L-m-0 
job-6863,2,6,3,342598,424620,424682,82022,62,342721,false,L-s-0 L-m-0 L-m-0 
job-6864,3,11,8,342645,424620,424728,81975,108,342857,false,L-l-0 L-l-0 C-l-0 C-l-0 L-l-0 C-l-0 L-l-0 C-l-0 
job-6865,1,7,7,342689,424620,424777,81931,157,342928,false,L-s-0 C-l-1 C-l-1 C-l-1 C-l-1 C-l-1 C-l-1 
job-6866,5,11,2,342737,424620,425002,81883,382,343141,false,C-l-2 C-l-2 
job-6868,6,11,1,342853,425002,425023,82149,21,343089,false,C-m-0 
job-6867,4,11,7,342795,425002,425036,82207,34,343065,false,L-l-0 L-m-0 L-s-0 L-l-0 L-m-0 L-l-0 C-s-2 
job-6869,1,7,2,342906,425023,425076,82117,53,343103,false,C-s-1 C-s-1 
job-6872,5,7,7,343071,425036,425135,81965,99,343277,false,L-m-0 L-l-0 C-l-1 C-l-2 C-l-1 L-l-0 C-l-2 
job-6870,6,11,1,342960,425023,425208,82063,185,343406,false,C-m-0 
job-6871,3,9,3,343020,425023,425264,82003,241,343351,false,C-l-0 C-l-0 C-l-0 
job-6873,3,7,7,343117,425036,425360,81919,324,343739,false,L-s-0 C-l-0 C-m-2 C-m-1 C-m-2 L-m-0 C-m-1 
job-6874,5,6,1,343161,425360,425372,82199,12,343310,false,L-m-0 
job-6875,5,7,7,343202,425360,425392,82158,32,343487,false,C-m-0 L-l-0 C-l-0 C-l-1 C-l-1 L-l-0 C-l-0 
job-6876,4,7,3,343270,425360,425556,82090,196,343640,false,L-s-0 C-m-1 C-m-1 
job-6877,3,8,5,343320,425556,425578,82236,22,343494,false,L-l-0 L-s-0 L-l-0 L-l-0 L-l-0 
job-6878,1,6,3,343364,425556,425697,82192,141,343747,false,L-m-0 L-m-0 L-s-0 
job-6879,4,7,7,343416,425556,425910,82140,354,343907,false,C-l-0 C-l-1 L-m-0 C-l-0 C-l-1 C-l-1 C-l-0 
job-6880,6,7,6,343460,425910,425999,82450,89,343833,false,C-m-0 C-l-0 L-l-0 L-m-0 C-l-0 L-l-0 
job-6881,4,10,6,343509,425910,426055,82401,145,343897,false,L-s-0 C-l-2 C-l-2 C-m-1 C-l-2 C-m-1 
job-6882,5,4,5,343562,425999,426075,82437,76,343936,false,L-l-0 L-l-0 C-l-1 L-m-0 C-l-1 
job-6883,4,9,4,343607,425999,426200,82392,201,344036,false,C-s-1 C-l-0 C-l-0 C-l-0 
job-6884,2,7,3,343664,426200,426232,82536,32,343977,false,L-m-0 L-m-0 L-m-0 
job-6886,3,8,4,343777,426200,426269,82423,69,343946,false,C-l-0 C-l-0 C-l-0 C-l-0 
job-6885,4,6,6,343729,426200,426296,82471,96,343871,false,L-s-0 L-l-0 C-m-0 C-m-0 L-l-0 L-l-0 
job-6887,2,4,6,343820,426269,426309,82449,40,343972,false,C-s-1 L-m-0 L-m-0 C-s-1 L-m-0 L-m-0 
job-6889,1,7,6,343911,426269,426339,82358,70,344237,false,C-s-2 C-l-2 C-l-2 C-l-2 C-l-2 C-l-2 
job-6888,2,6,1,343869,426269,426345,82400,76,344135,false,C-s-2 
job-6890,3,10,5,343969,426339,426366,82370,27,344257,false,L-l-0 L-l-0 L-l-0 L-s-0 L-l-0 
job-6891,5,6,5,344021,426339,426426,82318,87,344244,false,C-l-0 C-l-1 C-l-1 L-m-0 C-l-0 
job-6893,5,10,3,344099,426426,426544,82327,118,344407,false,C-l-0 C-l-0 C-m-0 
job-6892,1,12,6,344065,426426,426624,82361,198,344430,false,L-m-0 L-l-0 L-l-0 L-m-0 L-l-0 L-l-0 
job-6894,3,8,1,344145,426624,426679,82479,55,344238,false,L-s-0 
job-6895,6,6,8,344200,426624,426874,82424,250,344608,false,L-l-0 C-l-1 C-l-0 C-l-0 C-l-1 L-l-0 C-m-0 L-m-0 
job-6896,5,9,7,344242,426874,426927,82632,53,344436,false,C-l-1 L-l-0 C-l-0 C-l-1 C-l-0 L-l-0 L-m-0 
job-6897,4,11,3,344286,426927,426947,82641,20,344394,false,L-m-0 L-m-0 L-s-0 
job-6898,2,6,5,344338,426927,426955,82589,28,344469,false,L-l-0 L-l-0 L-l-0 L-l-0 L-l-0 
job-6900,6,10,1,344455,426927,426969,82472,42,344706,false,C-m-0 
job-6901,2,5,6,344502,426927,427003,82425,76,344618,false,C-m-1 C-m-0 L-l-0 C-m-1 C-m-1 C-m-1 
job-6899,4,5,1,344396,426927,427036,82531,109,344553,false,C-s-1 
job-6902,1,4,1,344564,427036,427047,82472,11,344639,false,L-s-0 
job-6903,4,7,8,344616,427036,427079,82420,43,344701,false,L-m-0 L-l-0 C-l-0 C-l-0 C-l-0 L-l-0 L-l-0 L-m-0 
job-6904,1,11,8,344662,427036,427147,82374,111,345003,false,C-l-1 C-l-1 C-l-1 C-l-2 C-l-1 C-l-2 C-l-2 L-s-0 
job-6905,1,8,4,344704,427036,427163,82332,127,344967,false,C-m-0 C-m-0 C-l-2 C-m-0 
job-6906,6,4,8,344760,427147,427164,82387,17,344976,false,C-l-1 L-l-0 C-l-0 C-l-2 C-l-0 L-l-0 C-l-1 L-m-0 
job-6907,2,8,7,344802,427147,427191,82345,44,344972,false,C-m-0 C-l-2 L-m-0 L-s-0 C-l-2 C-s-1 L-s-0 
job-6909,3,9,7,344898,427164,427231,82266,67,345245,false,L-m-0 C-l-2 C-l-2 C-m-0 L-l-0 L-m-0 C-m-0 
job-6908,3,8,2,344849,427147,427248,82298,101,345100,false,C-m-1 C-m-1 
job-6910,3,6,7,344935,427231,427248,82296,17,345199,false,L-m-0 L-l-0 L-l-0 L-s-0 L-l-0 L-l-0 L-m-0 
job-6911,4,6,8,344980,427231,427252,82251,21,345227,false,C-l-0 C-l-2 C-l-0 C-l-2 C-l-2 C-m-0 C-l-0 C-m-0 
job-6912,5,10,3,345028,427231,427572,82203,341,345453,false,C-m-2 C-l-1 C-l-1 
job-6913,3,8,5,345080,427572,427604,82492,32,345241,false,L-l-0 L-s-0 L-l-0 L-l-0 L-l-0 
job-6914,5,9,3,345121,427572,427611,82451,39,345366,false,L-m-0 C-l-0 C-l-0 
job-6917,4,5,3,345253,427604,427677,82351,73,345551,false,L-l-0 L-l-0 L-l-0 
job-6916,2,7,8,345200,427572,427678,82372,106,345452,false,C-l-1 C-l-1 C-l-1 C-l-1 C-l-0 L-m-0 C-l-1 C-l-1 
job-6915,4,10,1,345162,427572,427707,82410,135,345513,false,C-s-1 
job-6918,6,5,6,345303,427611,427810,82308,199,345788,false,L-m-0 C-l-0 C-l-2 C-m-0 C-l-2 C-m-1 
job-6919,5,6,2,345345,427810,427881,82465,71,345488,false,L-l-0 L-l-0 
job-6920,2,7,1,345402,427881,427927,82479,46,345547,false,L-s-0 
job-6921,5,12,6,345464,427881,427956,82417,75,345636,false,L-m-0 C-l-0 C-l-0 C-m-0 L-l-0 L-l-0 
job-6922,6,10,1,345513,427956,427974,82443,18,345682,false,L-m-0 
job-6924,5,12,2,345622,427956,428122,82334,166,345822,false,C-m-0 L-l-0 
job-6923,3,11,2,345566,427956,428253,82390,297,346002,false,L-l-0 L-l-0 
job-6926,6,5,8,345726,428253,428285,82527,32,345836,false,C-l-0 L-l-0 C-l-0 C-l-2 C-l-1 L-l-0 C-l-2 C-l-1 
job-6925,5,9,1,345670,428253,428304,82583,51,345938,false,L-m-0 
job-6927,2,4,5,345781,428253,428585,82472,332,346306,false,L-s-0 L-m-0 L-s-0 C-s-1 C-s-1 
job-6928,2,4,1,345840,428585,428650,82745,65,346101,false,L-s-0 
job-6931,4,11,3,346000,428585,428700,82585,115,346306,false,C-l-1 C-l-1 C-l-1 
job-6929,2,9,6,345899,428585,428728,82686,143,346307,false,L-l-0 L-s-0 L-l-0 L-l-0 L-l-0 L-l-0 
job-6933,2,6,4,346109,428650,428749,82541,99,346450,false,C-s-2 C-s-1 C-s-1 C-s-2 
job-6932,2,4,5,346055,428650,428754,82595,104,346264,false,L-s-0 C-s-0 C-s-0 L-m-0 C-l-0 
job-6930,5,5,3,345944,428585,428767,82641,182,346260,false,L-m-0 C-l-0 C-l-0 
job-6934,1,5,8,346154,428650,428899,82496,249,346429,false,C-l-2 C-l-2 C-l-2 C-l-2 L-m-0 C-l-2 C-l-2 C-l-2 
job-6935,3,6,8,346197,428899,428909,82702,10,346344,false,L-m-0 L-l-0 L-s-0 L-l-0 L-l-0 L-l-0 C-s-1 L-m-0 
job-6936,1,9,7,346236,428899,428914,82663,15,346414,false,L-s-0 L-m-0 L-m-0 C-m-0 C-m-0 C-m-0 C-s-1 
job-6937,2,9,3,346287,428899,429136,82612,237,346669,false,C-m-2 C-m-2 C-m-2 
job-6940,5,9,4,346439,429136,429171,82697,35,346726,false,C-m-0 C-l-0 C-l-0 L-m-0 
job-6938,1,8,7,346341,429136,429192,82795,56,346605,false,L-s-0 L-s-0 L-l-0 L-l-0 L-l-0 L-l-0 L-l-0 
job-6939,1,6,2,346386,429136,429225,82750,89,346563,false,L-m-0 L-l-0 
job-6942,6,5,5,346540,429225,429369,82685,144,346787,false,L-l-0 L-l-0 C-l-0 L-m-0 C-l-0 
job-6943,3,10,8,346582,429369,429395,82787,26,346620,false,C-m-0 L-l-0 L-l-0 L-l-0 L-l-0 L-m-0 C-m-0 L-m-0 
job-6944,4,12,4,346633,429369,429429,82736,60,346967,false,C-s-1 C-l-0 C-l-0 C-l-0 
job-6945,1,9,5,346674,429369,429456,82695,87,346790,false,C-m-1 L-m-0 C-m-1 C-m-0 C-m-1 
job-6946,1,9,4,346718,429456,429512,82738,56,346803,false,L-l-0 L-l-0 L-l-0 L-l-0 
job-6947,6,10,2,346756,429456,429547,82700,91,347105,false,L-l-0 L-m-0 
job-6941,2,12,1,346480,429225,429548,82745,323,346897,false,L-s-0 
job-6948,6,8,6,346807,429456,429639,82649,183,347124,false,C-l-0 C-l-2 C-l-0 C-l-2 C-l-1 C-l-1 
job-6950,4,5,2,346904,429639,429657,82735,18,346974,false,L-l-0 L-l-0 
job-6949,4,9,3,346848,429639,429665,82791,26,347037,false,L-m-0 L-m-0 L-s-0 
job-6951,3,11,2,346956,429639,429771,82683,132,347242,false,L-l-0 C-s-1 
job-6952,6,6,4,347005,429639,430128,82634,489,347686,false,C-l-0 C-l-0 C-l-1 C-l-1 
job-6955,5,6,4,347150,430128,430261,82978,133,347524,false,C-l-1 C-l-0 C-l-0 C-l-1 
job-6956,6,10,6,347210,430261,430283,83051,22,347427,false,C-l-0 C-l-2 C-l-0 C-l-2 C-l-1 C-l-1 
job-6954,3,5,5,347109,430128,430317,83019,189,347405,false,L-s-0 L-m-0 L-m-0 C-m-0 C-m-0 
job-6953,1,11,4,347056,430128,430370,83072,242,347514,false,L-l-0 L-l-0 L-l-0 L-l-0 
job-6957,5,6,5,347250,430283,430487,83033,204,347704,false,C-m-1 C-l-0 C-l-1 C-l-1 C-l-0 
job-6960,3,11,2,347427,430487,430543,83060,56,347673,false,C-m-0 C-m-0 
job-6959,3,4,8,347370,430487,430551,83117,64,347653,false,L-m-0 C-l-0 C-l-0 C-l-0 C-l-0 L-m-0 L-s-0 L-l-0 
job-6961,1,7,8,347481,430487,430554,83006,67,347592,false,C-m-1 L-m-0 C-m-1 L-s-0 C-m-1 C-m-0 C-m-1 L-m-0 
job-6958,1,6,7,347306,430487,430566,83181,79,347486,false,L-l-0 L-l-0 L-l-0 L-l-0 L-l-0 L-l-0 L-l-0 
job-6962,1,10,6,347532,430487,430635,82955,148,347880,false,C-m-2 C-l-2 C-l-2 C-m-2 C-l-2 C-l-2 
job-6963,3,7,2,347577,430635,430888,83058,253,348127,false,L-m-0 L-m-0 
job-6964,1,12,5,347615,430888,430921,83273,33,347776,false,L-s-0 L-l-0 L-l-0 L-l-0 L-l-0 
job-6965,1,10,3,347686,430888,430995,83202,107,347821,false,L-m-0 L-m-0 L-m-0 
job-6967,2,9,4,347781,430995,431013,83214,18,348030,false,L-l-0 L-l-0 L-l-0 L-l-0 
job-6966,3,5,1,347728,430995,431014,83267,19,348010,false,L-s-0 
job-6969,1,9,6,347870,430995,431088,83125,93,348075,false,L-s-0 C-m-0 L-m-0 L-m-0 C-m-0 C-m-0 
job-6968,3,11,6,347819,430995,431092,83176,97,348026,false,L-m-0 C-l-2 C-l-2 C-l-2 C-l-2 L-l-0 
job-6970,1,4,3,347918,430995,431173,83077,178,348360,false,C-s-1 C-s-1 C-m-0 
job-6971,1,11,2,347967,431173,431245,83206,72,348229,false,L-m-0 L-m-0 
job-6972,3,5,1,348013,431245,431258,83232,13,348142,false,L-s-0 
job-6974,5,4,8,348124,431245,431295,83121,50,348355,false,C-m-2 C-l-1 C-l-1 C-l-2 C-l-0 C-l-2 C-l-0 C-m-1 
job-6973,2,11,8,348076,431245,431331,83169,86,348181,false,C-m-0 L-l-0 L-l-0 L-l-0 L-l-0 L-m-0 C-m-0 L-m-0 
job-6975,6,10,8,348181,431295,431492,83114,197,348635,false,C-l-0 C-l-1 C-l-0 C-l-2 C-l-1 C-m-2 C-l-2 C-m-1 
job-6976,2,6,6,348235,431492,431608,83257,116,348455,false,L-l-0 L-l-0 L-l-0 L-l-0 L-l-0 L-l-0 
job-6977,3,6,4,348281,431492,431709,83211,217,348637,false,L-s-0 L-m-0 C-s-1 L-m-0 
job-6978,2,8,3,348341,431492,431718,83151,226,348585,false,C-s-2 L-m-0 C-s-2 
job-6979,4,4,3,348389,431709,431737,83320,28,348668,false,L-l-0 L-m-0 L-l-0 
job-6980,3,7,7,348443,431709,431749,83266,40,348559,false,L-l-0 C-l-0 C-l-0 C-s-1 C-l-0 C-l-0 L-s-0 
job-6981,6,6,4,348480,431709,431873,83229,164,348811,false,C-l-1 C-l-2 C-l-2 C-l-1 
job-6982,3,4,7,348537,431709,432065,83172,356,349029,false,C-m-0 C-m-1 C-s-0 C-m-2 C-m-1 C-m-2 C-m-0 
job-6983,1,12,3,348594,432065,432150,83471,85,348754,false,L-l-0 L-l-0 L-l-0 
job-6984,5,9,6,348647,432065,432179,83418,114,348799,false,L-m-0 C-l-0 C-l-0 C-l-1 C-l-1 L-l-0 
job-6985,3,12,5,348700,432150,432185,83450,35,348925,false,L-s-0 L-l-0 L-l-0 L-m-0 C-s-1 
job-6986,5,4,5,348739,432179,432192,83440,13,349034,false,C-m-0 L-l-0 C-l-0 L-m-0 C-l-0 
job-6987,2,6,2,348792,432192,432227,83400,35,349101,false,L-s-0 L-s-0 
job-6988,5,6,1,348840,432192,432298,83352,106,348989,false,L-m-0 
job-6989,2,4,6,348895,432192,432613,83297,421,349554,false,L-l-0 L-l-0 L-l-0 L-m-0 L-l-0 L-l-0 
job-6990,4,12,2,348940,432613,432727,83673,114,349341,false,L-m-0 L-m-0 
job-6991,5,9,7,348992,432613,432980,83621,367,349438,false,C-m-0 L-l-0 C-l-1 C-l-0 C-l-1 L-l-0 C-l-0 
job-6994,4,7,6,349141,432980,433033,83839,53,349391,false,L-s-0 C-l-1 C-l-1 C-s-1 C-l-1 L-l-0 
job-6992,1,4,6,349046,432980,433053,83934,73,349170,false,L-m-0 L-m-0 L-m-0 L-m-0 L-m-0 L-m-0 
job-6995,1,12,4,349195,432980,433125,83785,145,349565,false,C-l-0 C-l-0 C-l-0 C-l-0 
job-6997,5,5,6,349285,433053,433151,83768,98,349534,false,C-m-0 C-m-1 C-l-1 L-m-0 C-l-1 C-m-2 
job-6996,3,4,5,349237,432980,433164,83743,184,349466,false,C-l-2 C-l-2 C-l-2 C-s-2 C-l-2 
job-6993,4,9,2,349087,432980,433279,83893,299,349456,false,L-l-0 L-l-0 
job-6998,2,9,5,349327,433279,433312,83952,33,349586,false,L-l-0 L-l-0 L-l-0 L-l-0 L-l-0 
job-6999,4,8,8,349377,433279,433371,83902,92,349492,false,L-s-0 C-l-1 C-m-0 C-l-1 C-l-1 L-m-0 C-m-0 L-m-0 
job-7000,6,10,8,349425,433312,433390,83887,78,349515,false,L-l-0 C-l-2 C-l-0 C-l-2 C-m-2 C-m-1 C-l-0 L-l-0 
job-7001,6,8,4,349471,433371,433445,83900,74,349830,false,L-m-0 C-l-1 C-l-1 C-m-0 
job-7002,5,10,7,349513,433390,433450,83877,60,349855,false,L-l-0 C-l-2 C-l-0 C-l-2 C-l-0 L-l-0 C-m-1 
job-7003,4,10,5,349562,433445,433472,83883,27,349675,false,L-s-0 L-m-0 L-m-0 C-m-0 C-m-0 
job-7006,3,7,7,349705,433450,433508,83745,58,349769,false,C-l-0 C-l-1 C-l-0 C-l-1 C-l-0 C-l-0 C-l-1 
job-7007,6,8,4,349754,433472,433572,83718,100,349959,false,L-m-0 C-l-2 C-l-2 C-m-0 
job-7005,2,7,4,349663,433450,433628,83787,178,349879,false,C-m-2 L-l-0 C-m-2 C-m-2 
job-7004,1,9,4,349612,433450,433636,83838,186,349865,false,L-l-0 L-l-0 L-l-0 L-l-0 
job-7008,6,12,4,349793,433628,433643,83835,15,349995,false,L-m-0 C-l-0 C-l-0 L-l-0 
job-7009,2,4,1,349835,433643,433677,83808,34,349945,false,L-s-0 
job-7013,4,4,6,350034,433677,433720,83643,43,350323,false,C-l-1 C-l-0 C-l-0 C-l-1 C-l-0 C-l-1 
job-7012,3,7,3,349985,433643,433740,83658,97,350138,false,C-m-0 C-m-0 C-s-0 
job-7010,1,7,5,349881,433643,433745,83762,102,350072,false,L-m-0 L-m-0 L-s-0 L-m-0 L-m-0 
job-7011,2,4,7,349926,433643,433812,83717,169,350114,false,L-l-0 L-l-0 L-m-0 L-l-0 L-l-0 L-l-0 L-l-0 
job-7014,4,11,3,350079,433677,433829,83598,152,350373,false,C-l-2 C-l-2 C-l-2 
job-7016,4,12,7,350175,433812,433844,83637,32,350215,false,L-s-0 L-l-0 L-m-0 C-m-0 L-l-0 L-l-0 L-m-0 
job-7015,2,11,4,350131,433677,433850,83546,173,350338,false,C-m-0 C-m-1 C-s-1 C-m-1 
job-7017,6,11,8,350225,433844,433987,83619,143,350443,false,L-l-0 C-l-0 C-l-1 C-l-1 C-l-0 L-m-0 L-l-0 C-m-0 
job-7018,6,5,6,350275,433987,434113,83712,126,350624,false,C-m-0 C-l-0 L-l-0 L-m-0 C-l-0 L-l-0 
job-7019,4,12,2,350326,433987,434119,83661,132,350475,false,L-s-0 C-s-2 
job-7020,1,6,1,350366,434113,434208,83747,95,350486,false,L-m-0 
job-7021,1,5,5,350430,434208,434463,83778,255,350798,false,L-m-0 L-m-0 L-m-0 L-m-0 L-m-0 
job-7022,6,11,5,350478,434208,434616,83730,408,351085,false,C-m-0 C-l-0 L-l-0 L-l-0 C-l-0 
job-7023,5,4,8,350533,434616,434746,84083,130,350857,false,L-l-0 C-l-0 C-l-1 C-l-1 C-l-0 L-l-0 C-m-0 L-m-0 
job-7024,3,6,7,350583,434616,434803,84033,187,350960,false,L-s-0 C-l-2 C-l-2 C-m-0 C-l-2 C-l-2 L-m-0 
job-7025,4,7,2,350646,434803,434840,84157,37,350757,false,L-m-0 L-m-0 
job-7026,6,12,1,350690,434803,434899,84113,96,350949,false,L-l-0 
job-7028,3,12,8,350791,434803,434910,84012,107,351039,false,C-l-0 C-l-0 C-l-0 C-l-1 C-l-1 C-l-1 C-l-1 C-l-0 
job-7027,2,8,4,350748,434803,435028,84055,225,351233,false,L-s-0 L-l-0 L-l-0 L-l-0 
job-7029,3,4,6,350830,434803,435112,83973,309,351224,false,C-m-0 C-l-2 C-l-2 C-m-0 C-l-2 C-l-2 
job-7030,1,8,6,350875,434803,435207,83928,404,351451,false,C-m-1 C-m-0 C-m-0 C-m-1 C-m-1 L-s-0 
job-7031,1,12,1,350927,435207,435217,84280,10,351026,false,L-s-0 
job-7033,4,9,6,351028,435207,435262,84179,55,351152,false,C-l-1 C-l-2 C-l-1 C-l-2 C-l-2 C-l-1 
job-7034,2,11,8,351084,435207,435298,84123,91,351385,false,C-s-0 L-l-0 C-m-0 C-s-1 C-l-0 C-m-0 C-s-2 L-m-0 
job-7032,5,9,5,350977,435207,435317,84230,110,351160,false,L-l-0 L-l-0 C-l-0 L-m-0 C-l-0 
job-7035,6,9,6,351138,435262,435325,84124,63,351481,false,C-m-2 C-l-1 C-l-1 C-m-1 C-l-2 C-l-2 
job-7037,2,8,7,351237,435325,435338,84088,13,351493,false,L-l-0 L-l-0 L-l-0 L-m-0 L-l-0 L-l-0 L-l-0 
job-7036,2,11,1,351188,435325,435360,84137,35,351431,false,L-s-0 
job-7038,3,11,6,351299,435325,435551,84026,226,351650,false,C-l-0 C-l-0 L-m-0 L-m-0 C-l-0 C-l-0 
job-7039,6,6,8,351350,435551,435596,84201,45,351674,false,L-l-0 C-l-0 C-l-0 C-l-1 C-l-1 L-l-0 C-m-0 L-m-0 
job-7040,2,12,7,351398,435551,435763,84153,212,351843,false,L-m-0 C-m-0 C-l-2 C-l-2 C-l-2 C-l-2 L-s-0 
job-7041,5,6,1,351447,435763,435858,84316,95,351669,false,L-m-0 
job-7042,3,6,2,351489,435858,435888,84369,30,351794,false,L-m-0 L-m-0 
job-7043,5,12,7,351531,435858,435970,84327,112,351752,false,C-m-0 L-l-0 C-l-1 C-l-0 C-l-1 L-l-0 C-l-0 
job-7044,5,7,7,351582,435970,436053,84388,83,351952,false,C-l-1 L-l-0 C-l-0 C-l-1 C-l-0 L-l-0 L-m-0 
job-7045,5,5,7,351632,436053,436063,84421,10,351842,false,C-l-1 L-l-0 C-l-0 C-l-1 C-l-0 L-l-0 L-m-0 
job-7046,1,9,5,351694,436063,436091,84369,28,351845,false,L-l-0 L-l-0 L-l-0 L-l-0 L-l-0 
job-7047,2,7,8,351753,436063,436112,84310,49,352010,false,C-s-2 L-m-0 L-s-0 L-m-0 L-m-0 L-s-0 C-s-2 L-m-0 
job-7049,5,12,4,351851,436063,436305,84212,242,352303,false,C-l-1 C-l-2 C-l-1 C-l-2 
job-7048,2,10,7,351806,436063,436325,84257,262,352307,false,C-m-0 C-l-0 C-l-0 C-m-0 C-l-0 C-l-0 C-m-0 
job-7050,3,9,6,351895,436325,436335,84430,10,352052,false,L-m-0 L-l-0 L-l-0 L-l-0 L-m-0 L-l-0 
job-7052,3,5,7,351991,436325,436382,84334,57,352121,false,C-l-0 C-l-2 C-l-2 C-l-0 C-l-2 C-l-0 C-l-2 
job-7053,3,12,7,352040,436325,436391,84285,66,352144,false,C-m-1 C-m-2 C-l-0 C-m-2 C-s-2 C-s-1 C-m-1 
job-7051,4,11,6,351939,436325,436398,84386,73,352254,false,L-s-0 C-l-1 C-m-0 C-m-0 C-l-1 C-l-1 
job-7054,1,12,7,352084,436335,436436,84251,101,352242,false,C-s-0 L-l-0 L-l-0 L-m-0 L-l-0 L-l-0 L-m-0 
job-7055,1,11,6,352130,436382,436471,84252,89,352382,false,C-l-2 C-l-0 C-l-0 C-l-2 C-l-0 C-l-2 
job-7056,4,7,5,352184,436436,436487,84252,51,352402,false,L-s-0 C-l-2 C-l-0 C-l-2 C-l-0 
job-7057,2,6,4,352239,436487,436499,84248,12,352484,false,L-m-0 L-m-0 L-m-0 L-m-0 
job-7058,6,9,2,352293,436487,436535,84194,48,352594,false,L-l-0 L-l-0 
job-7059,5,6,5,352346,436487,436665,84141,178,352785,false,C-m-0 C-l-1 C-l-0 C-l-0 C-l-1 
job-7060,5,11,5,352404,436665,436738,84261,73,352760,false,L-l-0 L-l-0 C-l-0 L-m-0 C-l-0 
job-7061,1,9,6,352462,436738,436931,84276,193,352773,false,L-s-0 L-l-0 L-l-0 L-l-0 L-l-0 L-l-0 
job-7062,6,8,4,352504,436738,436983,84234,245,352781,false,C-m-0 C-l-0 C-l-0 L-m-0 
job-7063,3,12,4,352555,436931,437002,84376,71,352656,false,L-l-0 L-l-0 L-l-0 L-l-0 
job-7065,4,8,7,352647,436931,437053,84284,122,352996,false,C-m-1 C-l-2 C-l-2 L-s-0 C-l-2 C-m-1 C-s-0 
job-7064,5,5,2,352594,436931,437056,84337,125,352743,false,C-l-1 C-l-1 
job-7068,2,10,2,352807,437056,437107,84249,51,353134,false,C-m-0 C-m-0 
job-7066,1,10,1,352698,437056,437143,84358,87,352886,false,L-s-0 
job-7067,2,10,7,352754,437056,437174,84302,118,353041,false,L-m-0 L-l-0 L-l-0 L-m-0 L-l-0 L-l-0 L-m-0 
job-7069,1,12,4,352854,437056,437308,84202,252,353186,false,C-l-0 C-l-0 C-l-0 C-m-0 
job-7071,1,12,5,352958,437308,437387,84350,79,353068,false,L-s-0 L-m-0 C-m-1 C-m-0 C-m-1 
job-7070,6,9,4,352913,437308,437399,84395,91,353231,false,L-m-0 L-l-0 L-l-0 C-m-0 
job-7072,5,10,3,352999,437387,437401,84388,14,353027,false,C-l-0 C-l-0 C-m-1 
job-7073,2,7,6,353056,437387,437424,84331,37,353290,false,C-m-0 C-m-1 L-s-0 L-m-0 L-s-0 C-l-0 
job-7074,2,8,1,353099,437387,437577,84288,190,353497,false,C-s-1 
job-7075,6,10,2,353153,437387,437789,84234,402,353588,false,C-l-1 C-l-1 
job-7077,5,8,6,353252,437789,437825,84537,36,353455,false,C-m-0 C-l-0 C-l-1 L-m-0 C-l-1 C-l-0 
job-7076,6,4,2,353203,437789,437860,84586,71,353451,false,L-l-0 L-l-0 
job-7078,5,6,7,353309,437825,438145,84516,320,353811,false,C-l-0 C-l-1 C-l-0 L-m-0 C-l-1 C-l-2 C-l-2 
job-7080,6,9,6,353419,438145,438170,84726,25,353510,false,L-m-0 L-l-0 L-l-0 C-m-0 C-l-1 C-l-1 
job-7081,5,11,4,353472,438145,438186,84673,41,353677,false,C-l-0 C-l-2 C-l-0 C-l-2 
job-7079,4,12,2,353364,437825,438230,84461,405,353969,false,L-s-0 C-s-2 
job-7082,2,11,2,353530,438230,438242,84700,12,353795,false,L-m-0 L-m-0 
job-7083,4,8,6,353574,438230,438290,84656,60,353908,false,C-s-1 L-l-0 L-m-0 L-l-0 L-s-0 L-l-0 
job-7084,6,12,7,353613,438230,438556,84617,326,354203,false,C-l-0 C-l-1 C-l-2 C-m-2 C-l-1 C-l-2 C-l-0 
job-7087,6,12,6,353745,438556,438666,84811,110,354018,false,L-l-0 C-l-0 C-l-1 L-l-0 C-l-0 C-l-1 
job-7086,4,6,2,353708,438556,438677,84848,121,354091,false,L-m-0 L-m-0 
job-7090,2,6,7,353916,438666,438722,84750,56,354265,false,C-l-0 C-l-0 C-l-0 C-s-2 C-l-0 C-l-0 C-l-0 
job-7088,3,8,1,353794,438666,438724,84872,58,353971,false,L-l-0 
job-7085,3,12,1,353658,438556,438747,84898,191,353998,false,L-s-0 
job-7089,4,6,3,353858,438666,438749,84808,83,353999,false,L-l-0 C-s-1 L-l-0 
job-7091,1,6,2,353954,438749,438765,84795,16,354067,false,L-s-0 L-s-0 
job-7092,6,6,2,354020,438749,438859,84729,110,354178,false,L-l-0 L-l-0 
job-7093,1,9,5,354068,438749,439813,84681,1064,355181,false,L-m-0 C-m-0 L-m-0 C-m-0 C-m-0 
job-7094,2,12,8,354131,439813,439869,85682,56,354470,false,L-m-0 L-s-0 L-l-0 L-l-0 L-l-0 L-l-0 C-s-1 L-m-0 
job-7095,3,6,3,354184,439813,440019,85629,206,354463,false,C-m-0 L-m-0 C-m-0 
job-7096,6,7,4,354252,440019,440063,85767,44,354497,false,L-m-0 L-l-0 L-l-0 C-m-0 
job-7097,1,9,7,354293,440019,440130,85726,111,354668,false,C-m-0 C-m-1 C-m-1 L-m-0 C-m-0 L-m-0 C-m-1 
job-7098,2,10,7,354344,440019,440367,85675,348,354771,false,C-m-2 C-l-0 C-m-2 C-m-2 C-l-0 C-l-0 C-l-0 
job-7099,1,7,7,354389,440367,440383,85978,16,354649,false,L-s-0 L-l-0 L-l-0 L-l-0 L-l-0 L-l-0 L-l-0 
job-7100,2,4,7,354439,440367,440407,85928,40,354553,false,L-s-0 C-s-1 L-l-0 L-m-0 C-s-1 L-m-0 L-m-0 
job-7102,5,7,2,354529,440407,440484,85878,77,354821,false,L-l-0 L-l-0 
job-7101,1,6,1,354486,440407,440604,85921,197,354721,false,L-s-0 
job-7104,3,9,8,354632,440604,440664,85972,60,354769,false,C-s-2 L-l-0 L-l-0 C-s-1 L-l-0 L-m-0 L-l-0 L-m-0 
job-7103,3,7,1,354579,440604,440666,86025,62,354720,false,L-s-0 
job-7105,2,4,7,354679,440604,440829,85925,225,354946,false,C-l-0 C-l-0 L-m-0 C-l-0 C-l-0 C-l-0 C-l-0 
job-7106,2,4,4,354733,440829,440840,86096,11,354979,false,L-m-0 L-m-0 L-m-0 L-m-0 
job-7108,3,4,4,354831,440829,441031,85998,202,355077,false,L-l-0 L-l-0 L-l-0 L-l-0 
job-7107,2,4,1,354785,440829,441039,86044,210,355167,false,L-s-0 
job-7111,6,9,6,354986,441039,441055,86053,16,355285,false,C-l-1 C-l-0 C-l-2 C-l-2 C-l-1 C-l-0 
job-7109,4,12,2,354885,441031,441059,86146,28,355035,false,L-m-0 L-m-0 
job-7110,3,12,6,354936,441031,441106,86095,75,355023,false,C-m-0 L-l-0 L-l-0 C-m-0 L-l-0 L-l-0 
job-7112,1,10,1,355034,441106,441131,86072,25,355190,false,L-s-0 
job-7113,6,5,8,355084,441106,441220,86022,114,355418,false,L-l-0 C-l-1 C-l-2 C-l-2 C-l-1 L-l-0 C-m-0 L-m-0 
job-7114,6,7,2,355143,441106,441264,85963,158,355459,false,C-l-0 C-l-0 
job-7115,5,6,6,355197,441220,441345,86023,125,355387,false,L-m-0 C-l-1 L-l-0 C-m-0 C-l-1 L-l-0 
job-7116,3,4,3,355237,441264,441362,86027,98,355389,false,L-s-0 C-m-0 L-m-0 
job-7117,4,5,1,355298,441264,441407,85966,143,355644,false,C-s-1 
job-7118,1,12,5,355354,441362,441460,86008,98,355666,false,L-s-0 L-l-0 L-l-0 L-l-0 L-l-0 
job-7119,6,6,7,355394,441362,441756,85968,394,356017,false,C-l-0 C-l-2 L-m-0 C-l-0 C-l-2 C-l-1 C-l-1 
job-7120,1,6,6,355438,441756,441948,86318,192,355795,false,L-l-0 L-l-0 L-l-0 L-l-0 L-l-0 L-l-0 
job-7121,6,9,5,355489,441756,441986,86267,230,355865,false,C-m-0 C-l-0 L-l-0 L-m-0 C-l-0 
job-7122,1,9,4,355542,441986,442061,86444,75,355684,false,L-l-0 L-l-0 L-l-0 L-l-0 
job-7123,5,10,7,355601,441986,442457,86385,471,356275,false,C-m-0 C-l-0 C-l-1 C-l-0 C-l-1 L-l-0 L-m-0 
job-7125,4,10,8,355710,442457,442682,86747,225,355973,false,L-s-0 C-l-2 C-l-2 C-l-2 C-m-1 C-s-1 C-s-0 C-m-1 
job-7124,5,10,7,355660,442457,442691,86797,234,355977,false,C-l-1 L-l-0 C-l-0 C-l-1 C-l-0 L-l-0 L-m-0 
job-7126,5,9,8,355754,442691,442935,86937,244,356018,false,L-l-0 C-l-0 C-l-1 C-l-1 C-l-0 L-l-0 C-m-0 L-m-0 
job-7127,2,10,6,355801,442935,443093,87134,158,356070,false,L-m-0 L-l-0 L-l-0 L-m-0 L-l-0 L-l-0 
job-7128,3,7,4,355867,442935,443215,87068,280,356160,false,L-s-0 L-l-0 C-s-1 L-m-0 
job-7129,5,4,3,355927,443215,443241,87288,26,356032,false,L-l-0 L-l-0 L-m-0 
job-7130,1,6,4,355977,443241,443289,87264,48,356083,false,L-m-0 L-m-0 L-m-0 L-m-0 
job-7131,4,10,7,356025,443241,443316,87216,75,356174,false,C-l-0 C-l-0 L-l-0 L-l-0 C-l-0 L-l-0 L-s-0 
job-7132,2,5,2,356079,443289,443316,87210,27,356189,false,L-m-0 L-m-0 
job-7133,1,4,4,356138,443316,443354,87178,38,356427,false,L-s-0 L-s-0 L-s-0 L-s-0 
job-7134,1,12,8,356187,443316,443459,87129,143,356404,false,L-m-0 L-m-0 L-l-0 L-l-0 L-l-0 C-m-0 L-l-0 C-m-0 
job-7135,2,10,7,356242,443459,443490,87217,31,356433,false,L-m-0 L-l-0 L-l-0 L-m-0 L-l-0 L-l-0 L-m-0 
job-7136,1,6,2,356289,443459,443490,87170,31,356351,false,L-s-0 L-l-0 
job-7137,3,11,8,356344,443459,443525,87115,66,356539,false,C-l-0 C-l-0 C-l-1 C-l-0 C-l-1 C-l-1 C-l-0 C-l-1 
job-7138,2,4,5,356391,443459,443632,87068,173,356700,false,L-s-0 C-m-0 C-m-0 C-m-0 C-m-0 
job-7139,4,9,7,356444,443459,443814,87015,355,356864,false,C-m-1 C-l-2 C-l-2 C-m-1 C-l-2 C-m-2 C-m-2 
job-7141,5,9,7,356558,443814,443844,87256,30,356702,false,L-l-0 L-l-0 C-l-1 C-l-0 C-l-0 C-l-1 L-m-0 
job-7140,2,5,2,356489,443814,443849,87325,35,356623,false,L-s-0 L-s-0 
job-7142,2,4,6,356604,443814,443908,87210,94,356799,false,L-m-0 C-l-0 C-s-1 C-s-1 C-l-1 L-l-0 
job-7143,3,7,2,356650,443908,443959,87258,51,356741,false,L-m-0 L-m-0 
job-7144,6,8,2,356703,443908,443963,87205,55,356768,false,L-l-0 L-l-0 
job-7147,5,4,1,356861,443959,443972,87098,13,357080,false,C-m-0 
job-7145,2,10,2,356770,443959,443988,87189,29,356977,false,L-m-0 L-m-0 
job-7146,4,4,2,356815,443959,443991,87144,32,356948,false,L-s-0 L-m-0 
job-7148,5,9,6,356914,443959,444041,87045,82,357174,false,C-l-0 C-l-2 C-l-0 C-l-1 C-l-1 C-l-2 
job-7152,6,7,5,357117,444041,444090,86924,49,357464,false,C-l-0 C-l-0 C-l-1 C-l-2 C-l-1 
job-7149,3,4,7,356960,443959,444105,86999,146,357229,false,C-m-2 C-m-0 C-s-1 C-m-1 C-m-2 C-s-2 C-m-1 
job-7150,3,7,4,357014,444041,444126,87027,85,357127,false,L-l-0 L-l-0 L-l-0 C-m-0 
job-7151,6,9,1,357065,444041,444286,86976,245,357332,false,L-m-0 
job-7154,1,9,8,357220,444286,444299,87066,13,357457,false,C-m-0 L-l-0 L-l-0 L-l-0 L-l-0 L-l-0 C-m-0 C-m-0 
job-7153,1,6,5,357174,444286,444350,87112,64,357406,false,L-m-0 L-m-0 L-m-0 L-m-0 L-m-0 
job-7155,1,10,3,357273,444286,444399,87013,113,357653,false,C-m-1 C-m-1 C-m-1 
job-7156,3,4,1,357313,444399,444411,87086,12,357458,false,L-s-0 
job-7157,5,10,2,357356,444399,444415,87043,16,357562,false,L-l-0 L-l-0 
job-7158,2,5,8,357403,444399,444451,86996,52,357474,false,C-m-0 L-m-0 L-m-0 L-l-0 C-m-0 C-m-0 C-m-0 L-m-0 
job-7159,1,11,5,357446,444451,444469,87005,18,357608,false,L-s-0 L-l-0 L-l-0 L-l-0 L-l-0 
job-7160,6,11,6,357486,444451,444704,86965,253,357747,false,L-m-0 C-l-0 C-l-1 C-m-0 C-l-0 C-l-1 
job-7162,1,8,1,357566,444704,444725,87138,21,357708,false,L-s-0 
job-7161,3,8,4,357535,444704,444727,87169,23,357671,false,L-l-0 L-l-0 L-l-0 L-l-0 
job-7163,4,10,8,357604,444704,444771,87100,67,357889,false,L-m-0 C-l-1 C-l-0 C-l-0 C-l-1 C-l-0 C-l-1 L-m-0 
job-7164,1,10,8,357652,444704,444805,87052,101,357836,false,C-s-1 C-l-2 C-l-2 C-l-2 C-l-2 C-m-0 C-m-0 C-m-0 
job-7166,3,12,4,357752,444805,444826,87053,21,357920,false,L-l-0 L-l-0 L-l-0 L-l-0 
job-7165,3,9,2,357711,444771,444829,87060,58,358012,false,L-m-0 L-m-0 
job-7167,5,8,7,357792,444805,444859,87013,54,357866,false,C-m-0 C-l-2 C-l-1 C-l-1 C-l-0 C-l-2 C-l-0 
job-7168,1,11,1,357838,444859,444900,87021,41,358126,false,L-s-0 
job-7169,6,12,4,357890,444859,445098,86969,239,358151,false,L-m-0 L-l-0 L-l-0 C-m-0 
job-7170,4,7,7,357933,445098,445112,87165,14,358004,false,L-l-0 L-m-0 L-s-0 L-l-0 L-m-0 L-l-0 C-s-1 
job-7171,1,12,2,357985,445098,445276,87113,178,358364,false,C-m-0 C-m-0 
job-7172,1,9,8,358034,445276,445308,87242,32,358118,false,L-m-0 L-l-0 L-l-0 L-l-0 L-l-0 L-m-0 L-l-0 L-m-0 
job-7173,3,10,1,358083,445276,445336,87193,60,358213,false,L-s-0 
job-7174,2,9,7,358148,445276,445711,87128,435,358743,false,C-l-0 C-l-0 C-l-0 C-m-1 C-l-0 C-l-0 C-m-1 
job-7175,6,4,3,358192,445711,445721,87519,10,358369,false,L-l-0 L-l-0 L-m-0 
job-7178,5,8,6,358365,445721,445802,87356,81,358565,false,L-l-0 C-l-1 C-l-0 C-l-0 C-l-1 L-l-0 
job-7177,2,5,5,358299,445721,446136,87422,415,358866,false,L-m-0 L-m-0 L-m-0 L-m-0 L-s-0 
job-7176,1,5,1,358249,445721,446298,87472,577,358858,false,L-s-0 
job-7179,3,7,7,358425,446298,446319,87873,21,358459,false,L-s-0 L-l-0 L-l-0 L-m-0 L-l-0 L-l-0 L-m-0 
job-7180,1,4,6,358475,446298,446334,87823,36,358704,false,C-s-2 L-m-0 L-m-0 C-s-2 C-s-2 L-s-0 
job-7181,5,10,3,358516,446298,446384,87782,86,358892,false,C-m-0 C-l-1 C-l-1 
job-7182,2,12,8,358565,446298,446400,87733,102,358727,false,C-l-2 C-l-2 C-l-2 C-l-1 C-l-2 C-m-1 C-m-1 C-m-0 
job-7185,6,9,7,358704,446400,446427,87696,27,359000,false,C-l-0 C-l-2 C-l-1 C-l-2 C-l-1 C-l-0 C-m-0 
job-7183,6,10,1,358613,446400,446455,87787,55,358918,false,L-m-0 
job-7184,2,5,7,358651,446400,446589,87749,189,359074,false,L-l-0 L-l-0 L-m-0 L-l-0 L-l-0 L-l-0 L-l-0 
job-7187,4,6,7,358812,446589,446655,87777,66,359165,false,L-m-0 C-s-1 L-l-0 L-s-0 L-l-0 L-l-0 L-m-0 
job-7186,5,11,5,358766,446427,446669,87661,242,359267,false,C-m-0 C-l-1 C-l-0 C-l-0 C-l-1 
job-7188,5,8,1,358865,446655,446677,87790,22,358896,false,L-m-0 
job-7190,4,11,3,358967,446677,446743,87710,66,359102,false,L-l-0 L-m-0 C-m-0 
job-7189,3,5,3,358920,446655,446757,87735,102,359183,false,L-s-0 C-m-0 L-m-0 
job-7191,1,8,4,359019,446757,446767,87738,10,359216,false,L-m-0 L-m-0 L-m-0 L-m-0 
job-7192,4,10,7,359067,446757,446995,87690,238,359554,false,C-l-0 C-l-0 L-l-0 L-l-0 C-l-0 L-l-0 L-s-0 
job-7193,5,10,6,359131,446757,447054,87626,297,359666,false,C-m-0 C-l-1 C-l-1 C-m-1 C-l-2 C-l-2 
job-7194,1,9,5,359183,447054,447235,87871,181,359398,false,L-l-0 L-l-0 L-l-0 L-l-0 L-l-0 
job-7195,4,7,1,359229,447235,447267,88006,32,359262,false,L-s-0 
job-7196,5,12,5,359277,447235,447337,87958,102,359607,false,L-m-0 L-l-0 C-l-0 C-l-0 L-l-0 
job-7197,4,11,4,359335,447337,447350,88002,13,359465,false,L-l-0 L-l-0 L-s-0 L-l-0 
job-7198,2,6,8,359378,447337,447705,87959,368,359993,false,L-m-0 L-m-0 L-m-0 C-m-0 C-m-0 C-m-0 L-m-0 C-m-0 
job-7199,1,5,4,359417,447705,447736,88288,31,359611,false,L-m-0 L-m-0 L-m-0 L-m-0 
job-7200,2,6,3,359455,447736,447749,88281,13,359562,false,L-m-0 L-m-0 L-m-0 
job-7202,4,7,2,359547,447736,447772,88189,36,359690,false,C-m-0 C-m-0 
job-7201,3,6,5,359502,447736,447789,88234,53,359737,false,L-l-0 L-l-0 L-l-0 L-s-0 L-l-0 
job-7203,5,6,4,359583,447736,448075,88153,339,359994,false,C-l-0 C-l-1 C-l-1 C-l-0 
job-7204,3,8,6,359637,448075,448215,88438,140,359972,false,L-m-0 L-l-0 L-l-0 L-l-0 L-m-0 L-l-0 
job-7205,1,7,2,359699,448215,448298,88516,83,359918,false,L-s-0 L-s-0 
job-7207,2,12,5,359803,448215,448408,88412,193,360214,false,L-l-0 L-l-0 L-m-0 L-l-0 L-l-0 
job-7206,5,7,1,359753,448215,448488,88462,273,360319,false,L-m-0 
job-7208,6,10,3,359849,448215,448495,88366,280,360277,false,C-l-1 C-m-0 C-l-1 
job-7210,1,10,3,359936,448488,448538,88552,50,360009,false,L-m-0 C-m-0 C-m-0 
job-7211,1,9,5,359984,448538,448568,88554,30,360293,false,L-l-0 L-l-0 L-l-0 L-l-0 L-l-0 
job-7209,3,8,1,359904,448488,448586,88584,98,360213,false,L-s-0 
job-7212,6,10,5,360024,448538,448632,88514,94,360400,false,C-l-1 C-l-2 C-l-2 L-m-0 C-l-1 
job-7213,5,10,4,360077,448538,448703,88461,165,360386,false,C-m-1 C-l-0 C-l-0 C-m-0 
job-7214,1,10,4,360116,448703,448881,88587,178,360321,false,L-l-0 L-l-0 L-l-0 L-l-0 
job-7216,6,6,5,360187,448881,448902,88694,21,360304,false,C-m-0 L-l-0 C-l-0 L-l-0 C-l-0 
job-7215,5,7,1,360149,448881,448979,88732,98,360330,false,L-m-0 
job-7217,2,9,2,360233,448902,449004,88669,102,360343,false,L-s-0 L-m-0 
job-7219,2,9,8,360327,448902,449029,88575,127,360602,false,C-s-1 C-l-2 C-l-2 C-l-2 C-l-2 C-m-0 C-m-0 C-m-0 
job-7218,2,7,8,360287,448902,449055,88615,153,360621,false,L-s-0 L-l-0 L-l-0 L-l-0 L-l-0 L-l-0 C-s-1 L-l-0 
job-7220,2,4,3,360377,449029,449227,88652,198,360839,false,L-s-0 C-s-1 L-m-0 
job-7221,2,6,6,360424,449227,449300,88803,73,360595,false,L-l-0 L-l-0 L-l-0 L-l-0 L-l-0 L-l-0 
job-7222,2,11,1,360464,449300,449352,88836,52,360550,false,L-s-0 
job-7223,5,12,1,360510,449300,449503,88790,203,360817,false,L-m-0 
job-7224,4,12,3,360564,449503,449544,88939,41,360733,false,L-m-0 L-m-0 L-s-0 
job-7225,6,12,1,360610,449503,449566,88893,63,360925,false,L-l-0 
job-7226,2,9,6,360659,449503,449614,88844,111,361035,false,L-l-0 C-m-2 L-l-0 C-m-2 L-l-0 C-m-2 
job-7228,5,10,3,360748,449503,449620,88755,117,361078,false,C-l-0 C-m-1 C-l-0 
job-7229,6,11,1,360785,449503,449653,88718,150,361141,false,C-l-2 
job-7227,5,6,3,360704,449503,449696,88799,193,361171,false,C-m-0 C-l-1 C-l-1 
job-7230,1,10,7,360832,449653,449738,88821,85,361150,false,L-m-0 L-m-0 C-l-1 C-m-0 L-m-0 C-l-1 C-m-0 
job-7232,6,5,8,360937,449738,449792,88801,54,361046,false,C-l-0 C-l-2 C-l-0 C-l-1 C-l-1 C-l-2 C-m-0 L-m-0 
job-7231,5,4,2,360884,449738,449801,88854,63,361091,false,L-l-0 L-l-0 
job-7233,1,5,7,360982,449792,449826,88810,34,361025,false,L-l-0 L-m-0 L-m-0 L-m-0 L-m-0 L-m-0 L-l-0 
job-7234,1,11,1,361031,449826,449852,88795,26,361209,false,L-s-0 
job-7236,6,10,3,361138,449826,450045,88688,219,361422,false,C-l-0 C-l-0 C-m-1 
job-7235,6,5,6,361083,449826,450218,88743,392,361540,false,L-m-0 C-l-1 L-l-0 C-m-0 C-l-1 L-l-0 
job-7238,6,6,4,361251,450218,450261,88967,43,361359,false,C-m-0 C-l-2 C-l-2 C-m-1 
job-7237,5,7,7,361201,450218,450271,89017,53,361274,false,C-l-1 L-l-0 C-l-0 C-l-1 C-l-0 L-l-0 L-m-0 
job-7240,4,5,8,361359,450271,450282,88912,11,361521,false,C-s-1 C-l-1 L-s-0 C-l-1 C-l-1 L-l-0 L-l-0 L-l-0 
job-7239,1,4,5,361306,450271,450323,88965,52,361600,false,L-m-0 L-m-0 L-m-0 L-m-0 L-m-0 
job-7241,2,6,6,361410,450271,450720,88861,449,361884,false,C-l-0 C-l-0 L-m-0 C-l-0 C-l-0 C-l-0 
job-7242,3,10,2,361468,450720,450766,89252,46,361575,false,L-m-0 L-m-0 
job-7244,5,6,4,361556,450720,450800,89164,80,361713,false,C-l-1 C-l-0 C-l-0 C-l-1 
job-7243,6,7,3,361520,450720,450869,89200,149,361929,false,L-l-0 L-l-0 C-m-0 
job-7245,2,9,2,361614,450800,451021,89186,221,362107,false,L-s-0 C-m-0 
job-7247,5,7,4,361729,451021,451039,89292,18,361935,false,C-l-2 C-l-1 C-l-1 C-l-2 
job-7246,6,5,6,361683,451021,451042,89338,21,361877,false,C-m-0 C-l-0 L-l-0 L-m-0 C-l-0 L-l-0 
job-7248,3,10,6,361786,451021,451055,89235,34,362048,false,C-s-2 C-m-2 L-s-0 C-m-2 C-m-1 C-m-1 
job-7249,6,8,1,361850,451039,451169,89189,130,362142,false,C-l-1 
job-7250,3,11,1,361916,451169,451186,89253,17,362006,false,L-s-0 
job-7251,2,12,3,361971,451169,451315,89198,146,362349,false,L-l-0 L-l-0 L-l-0 
job-7252,2,7,4,362028,451315,451339,89287,24,362149,false,L-m-0 L-m-0 L-m-0 L-m-0 
job-7254,3,12,5,362120,451315,451405,89195,90,362331,false,C-l-1 C-l-1 C-l-1 C-l-1 C-s-2 
job-7255,4,12,4,362159,451405,451461,89246,56,362371,false,C-s-2 L-m-0 L-m-0 C-s-0 
job-7253,4,8,5,362084,451315,451467,89231,152,362421,false,C-s-1 L-s-0 L-l-0 L-l-0 L-l-0 
job-7256,1,9,5,362217,451405,451729,89188,324,362688,false,C-l-0 C-l-0 C-l-0 C-l-0 C-l-0 
job-7257,5,10,8,362262,451729,451773,89467,44,362492,false,L-l-0 C-l-0 C-l-1 C-l-1 C-l-0 L-l-0 C-m-0 L-m-0 
job-7258,3,5,6,362310,451729,451783,89419,54,362475,false,C-m-0 C-l-2 C-l-2 C-l-2 C-l-2 L-m-0 
job-7259,4,12,3,362365,451729,452051,89364,322,362793,false,L-s-0 C-m-1 C-m-1 
job-7262,3,10,5,362517,452051,452069,89534,18,362661,false,C-l-0 L-m-0 C-l-0 C-l-0 C-l-0 
job-7261,4,11,3,362466,452051,452096,89585,45,362680,false,L-l-0 L-l-0 L-l-0 
job-7263,6,10,6,362565,452051,452121,89486,70,362902,false,C-m-1 C-l-1 C-l-1 C-m-0 C-l-2 C-l-2 
job-7260,3,4,1,362414,452051,452200,89637,149,362759,false,L-s-0 
job-7264,2,12,1,362606,452121,452262,89515,141,362790,false,L-m-0 
job-7266,2,6,3,362710,452200,452268,89490,68,362802,false,L-s-0 C-s-2 C-s-2 
job-7265,6,6,5,362657,452121,452276,89464,155,362950,false,L-l-0 C-l-0 L-m-0 L-l-0 C-l-0 
job-7267,1,10,4,362754,452200,452557,89446,357,363115,false,C-m-0 C-m-0 L-s-0 C-m-0 
job-7268,4,4,8,362802,452557,452577,89755,20,362836,false,L-m-0 L-l-0 L-l-0 L-l-0 C-m-0 L-s-0 L-m-0 C-m-0 
job-7269,3,4,7,362853,452557,452585,89704,28,362928,false,C-l-1 C-l-0 C-l-1 C-l-0 C-l-1 C-l-0 C-l-0 
job-7270,5,4,8,362907,452577,452704,89670,127,363209,false,C-m-1 L-l-0 L-l-0 C-l-2 C-l-2 C-m-0 C-m-2 L-m-0 
job-7271,4,11,7,362957,452704,452759,89747,55,363050,false,L-l-0 L-m-0 L-s-0 L-l-0 L-m-0 L-l-0 C-s-2 
job-7273,4,8,3,363059,452704,452872,89645,168,363389,false,C-l-0 C-l-0 C-l-0 
job-7274,5,4,8,363111,452759,452894,89648,135,363337,false,C-m-1 L-l-0 C-l-1 L-l-0 C-l-1 C-l-2 L-m-0 C-m-0 
job-7272,1,6,7,363014,452704,452900,89690,196,363358,false,C-l-2 C-l-2 C-l-2 C-l-2 C-l-2 C-l-2 C-l-2 
job-7275,3,6,7,363160,452894,452905,89734,11,363402,false,L-m-0 L-m-0 L-l-0 L-l-0 L-l-0 L-l-0 C-l-2 
job-7276,1,11,8,363210,452894,452979,89684,85,363486,false,L-s-0 C-l-1 C-l-1 C-l-1 C-l-1 C-m-0 C-m-0 L-m-0 
job-7277,1,7,4,363248,452894,452995,89646,101,363463,false,L-m-0 C-s-1 C-s-1 C-m-0 
job-7278,4,12,3,363296,452979,453040,89683,61,363498,false,L-s-0 C-m-0 L-m-0 
job-7280,6,6,6,363394,453040,453072,89646,32,363545,false,L-m-0 L-l-0 C-l-1 C-m-0 C-l-1 L-l-0 
job-7279,1,11,1,363349,453040,453561,89691,521,364045,false,L-s-0 
job-7283,5,6,4,363536,453561,453614,90025,53,363800,false,C-l-0 C-l-1 C-l-1 C-l-0 
job-7281,1,10,4,363447,453561,453622,90114,61,363674,false,L-l-0 L-l-0 L-l-0 L-l-0 
job-7282,6,6,2,363496,453561,453923,90065,362,363986,false,L-m-0 L-l-0 
job-7284,1,6,8,363604,453923,453998,90319,75,363872,false,L-l-0 L-l-0 L-l-0 L-l-0 L-l-0 L-l-0 L-l-0 L-l-0 
job-7285,4,9,2,363654,453923,453998,90269,75,364021,false,L-m-0 L-m-0 
job-7286,4,9,3,363712,453923,454134,90211,211,364134,false,L-s-0 C-m-0 C-m-0 
job-7287,3,6,6,363765,454134,454151,90369,17,363933,false,L-m-0 L-l-0 L-l-0 L-m-0 L-l-0 L-l-0 
job-7288,1,11,8,363808,454134,454334,90326,200,364231,false,C-m-0 C-l-1 C-l-1 C-l-1 C-l-1 C-m-0 L-s-0 L-m-0 
job-7289,3,8,5,363867,454334,454346,90467,12,363965,false,L-l-0 L-s-0 L-l-0 L-l-0 L-l-0 
job-7290,5,6,5,363910,454334,454523,90424,189,364307,false,C-l-0 C-l-1 C-l-0 L-m-0 C-l-1 
job-7291,6,7,7,363949,454523,454545,90574,22,364195,false,L-m-0 C-l-0 C-l-1 L-l-0 C-l-0 C-l-1 L-l-0 
job-7293,6,10,3,364057,454523,454553,90466,30,364218,false,C-l-2 C-l-2 C-m-0 
job-7294,3,8,7,364125,454523,454575,90398,52,364366,false,C-s-1 C-m-2 C-s-0 C-m-2 C-m-1 C-s-2 C-m-1 
job-7295,1,11,3,364185,454575,454590,90390,15,364274,false,L-l-0 L-l-0 L-l-0 
job-7292,4,8,1,364003,454523,454613,90520,90,364306,false,L-s-0 
job-7296,1,8,7,364227,454575,454663,90348,88,364592,false,L-m-0 L-m-0 L-m-0 C-s-1 L-m-0 L-l-0 C-s-1 
job-7297,1,6,4,364267,454663,454682,90396,19,364575,false,L-m-0 L-m-0 L-m-0 L-m-0 
job-7300,6,12,3,364408,454682,454719,90274,37,364526,false,C-l-2 C-l-2 L-m-0 
job-7299,6,4,4,364345,454663,454727,90318,64,364615,false,C-l-0 C-l-0 C-l-1 C-l-1 
job-7298,4,11,7,364309,454663,454738,90354,75,364422,false,C-s-0 C-m-2 L-l-0 C-m-2 L-l-0 L-l-0 L-s-0 
job-7301,2,11,3,364474,454719,454749,90245,30,364540,false,C-s-1 L-m-0 L-m-0 
job-7302,2,7,6,364527,454719,454851,90192,132,364831,false,L-m-0 C-l-2 C-l-2 C-l-2 C-l-2 C-l-2 
job-7304,1,10,8,364644,454851,454977,90207,126,364950,false,L-l-0 L-m-0 L-l-0 L-l-0 C-m-0 L-m-0 C-m-1 L-m-0 
job-7303,3,10,4,364601,454719,455006,90118,287,364931,false,C-m-0 C-m-1 C-m-0 C-m-1 
job-7305,6,10,4,364710,454977,455037,90267,60,364955,false,L-m-0 L-l-0 L-l-0 C-m-2 
job-7306,2,7,4,364762,455006,455105,90244,99,364963,false,C-m-2 L-s-0 L-s-0 L-m-0 
job-7309,5,10,5,364925,455105,455219,90180,114,365286,false,L-m-0 L-l-0 L-l-0 C-m-0 C-m-1 
job-7308,2,8,6,364870,455006,455238,90136,232,365226,false,C-l-0 C-l-0 C-l-0 C-l-0 C-l-0 C-l-0 
job-7307,3,11,8,364823,455006,455274,90183,268,365316,false,C-l-2 C-l-2 C-l-1 C-l-1 C-l-1 C-l-1 C-l-2 C-l-2 
job-7311,6,10,3,365008,455274,455344,90266,70,365222,false,C-m-2 C-l-1 C-l-1 
job-7310,5,4,7,364961,455238,455380,90277,142,365350,false,C-m-0 L-l-0 C-l-0 C-m-1 C-l-0 L-l-0 L-m-0 
job-7312,1,7,2,365065,455380,455430,90315,50,365387,false,L-s-0 L-s-0 
job-7313,4,6,3,365119,455380,455442,90261,62,365386,false,L-l-0 L-l-0 L-l-0 
job-7314,4,5,4,365167,455380,455721,90213,341,365717,false,L-m-0 C-m-0 L-m-0 C-m-0 
job-7317,6,12,4,365320,455721,455766,90401,45,365477,false,C-l-1 C-l-1 C-l-2 C-l-2 
job-7316,2,11,8,365276,455721,455787,90445,66,365525,false,L-l-0 L-l-0 C-l-0 C-l-0 C-l-0 L-l-0 C-l-0 L-l-0 
job-7318,5,7,5,365369,455766,455853,90397,87,365671,false,C-m-0 C-l-2 C-l-1 C-l-2 C-l-1 
job-7315,2,6,4,365216,455721,455889,90505,168,365568,false,L-m-0 L-m-0 L-m-0 L-m-0 
job-7320,3,5,6,365462,455853,455942,90391,89,365725,false,L-l-0 C-l-0 C-l-0 C-l-0 C-l-0 L-l-0 
job-7321,6,9,1,365506,455889,455946,90383,57,365571,false,L-m-0 
job-7319,2,7,3,365413,455853,455960,90440,107,365552,false,L-l-0 L-l-0 L-l-0 
job-7323,6,8,7,365608,455942,455989,90334,47,365920,false,C-l-0 C-l-0 C-l-1 C-m-1 C-l-1 L-l-0 C-m-2 
job-7322,4,8,6,365561,455889,456006,90328,117,365893,false,L-s-0 C-l-2 C-m-0 C-m-0 C-l-2 C-l-2 
job-7324,2,10,3,365665,455946,456232,90281,286,366108,false,L-m-0 C-m-1 C-m-2 
job-7325,5,7,2,365727,456232,456296,90505,64,366026,false,L-l-0 L-l-0 
job-7327,5,12,7,365853,456232,456304,90379,72,365971,false,C-m-0 C-l-1 C-l-0 C-l-2 C-l-1 C-l-2 C-l-0 
job-7326,2,9,3,365787,456232,456370,90445,138,366108,false,L-m-0 L-m-0 L-l-0 
job-7328,2,8,2,365916,456370,456398,90454,28,366141,false,L-s-0 L-s-0 
job-7329,5,7,1,365955,456370,456582,90415,212,366270,false,L-m-0 
job-7330,6,11,2,366007,456582,456600,90575,18,366295,false,L-l-0 L-l-0 
job-7331,5,8,8,366057,456582,456767,90525,185,366300,false,C-m-0 C-l-0 C-l-0 C-l-1 C-l-1 C-l-2 C-l-2 L-m-0 
job-7332,5,9,8,366114,456767,456802,90653,35,366319,false,L-l-0 C-l-0 C-l-1 C-l-1 C-l-0 L-l-0 C-m-0 L-m-0 
job-7334,2,9,5,366214,456767,456819,90553,52,366393,false,L-s-0 C-l-2 C-l-2 C-l-2 C-l-2 
job-7333,2,4,6,366158,456767,456833,90609,66,366296,false,C-l-0 L-s-0 L-m-0 C-m-0 C-l-1 L-l-0 
job-7335,1,8,4,366259,456833,456852,90574,19,366462,false,L-m-0 L-m-0 L-m-0 L-m-0 
job-7336,3,12,5,366313,456833,456903,90520,70,366425,false,L-s-0 L-l-0 L-l-0 L-l-0 L-l-0 
job-7337,5,7,3,366370,456833,457118,90463,285,366694,false,C-l-1 C-m-0 C-l-1 
job-7338,6,7,6,366431,457118,457204,90687,86,366698,false,C-m-0 C-l-0 L-l-0 L-m-0 C-l-0 L-l-0 
job-7339,4,7,1,366485,457204,457259,90719,55,366817,false,L-s-0 
job-7343,5,12,4,366671,457204,457313,90533,109,366916,false,C-l-2 C-l-1 C-l-1 C-l-2 
job-7344,2,8,8,366725,457204,457318,90479,114,366863,false,C-s-1 C-m-2 C-l-1 C-l-2 C-m-2 C-m-2 C-s-1 C-m-2 
job-7342,2,5,6,366634,457204,457325,90570,121,367003,false,C-m-0 C-m-0 L-m-0 C-m-0 C-m-0 C-l-0 
job-7341,5,9,2,366579,457204,457351,90625,147,366813,false,C-l-0 C-l-0 
job-7340,6,8,3,366530,457204,457356,90674,152,366817,false,L-l-0 L-m-0 L-l-0 
job-7345,2,12,3,366772,457204,457641,90432,437,367427,false,C-s-2 C-m-1 C-m-1 
job-7346,1,9,6,366829,457641,457651,90812,10,367012,false,L-s-0 L-l-0 L-l-0 L-l-0 L-l-0 L-l-0 
job-7348,1,5,7,366922,457641,457736,90719,95,367028,false,C-s-0 L-m-0 L-m-0 C-s-0 L-m-0 L-s-0 C-s-0 
job-7347,1,8,2,366869,457641,457740,90772,99,367256,false,L-m-0 L-m-0 
job-7349,2,4,7,366977,457641,457790,90664,149,367341,false,C-l-0 C-l-0 C-l-0 C-s-1 C-l-0 C-l-0 C-l-0 
job-7350,2,6,4,367009,457790,457805,90781,15,367134,false,L-m-0 L-m-0 L-m-0 L-m-0 
job-7351,3,12,3,367050,457790,457808,90740,18,367247,false,L-l-0 L-l-0 L-l-0 
job-7352,5,8,6,367117,457790,457848,90673,58,367455,false,C-l-0 C-l-1 C-l-1 C-l-2 C-l-0 C-l-2 
job-7353,1,11,3,367168,457848,457860,90680,12,367209,false,L-l-0 L-l-0 L-l-0 
job-7354,2,11,2,367223,457848,457895,90625,47,367438,false,L-s-0 L-l-0 
job-7355,5,5,5,367289,457848,458024,90559,176,367529,false,L-m-0 C-l-0 C-l-1 C-l-1 C-l-0 
job-7356,4,10,2,367341,457848,458123,90507,275,367659,false,C-m-0 C-m-0 
job-7357,5,12,2,367387,458123,458147,90736,24,367641,false,L-l-0 L-l-0 
job-7358,5,12,5,367450,458123,458316,90673,193,367690,false,C-l-1 C-l-1 C-l-0 L-m-0 C-l-0 
job-7359,1,6,3,367493,458316,458443,90823,127,367773,false,L-m-0 L-m-0 L-m-0 
job-7361,5,9,4,367585,458443,458465,90858,22,367855,false,L-l-0 C-l-0 L-l-0 C-l-0 
job-7360,5,4,1,367538,458443,458646,90905,203,367882,false,L-m-0 
job-7362,1,10,7,367639,458443,458662,90804,219,368135,false,L-m-0 C-l-0 C-l-0 L-m-0 L-l-0 L-l-0 L-s-0 
job-7363,5,4,1,367681,458662,458675,90981,13,367827,false,L-m-0 
job-7365,5,12,5,367768,458662,458713,90894,51,368089,false,C-l-1 C-l-0 C-l-0 C-l-1 L-l-0 
job-7364,2,11,4,367725,458662,458731,90937,69,367996,false,L-l-0 L-m-0 L-l-0 L-l-0 
job-7367,5,12,6,367860,458731,458814,90871,83,368161,false,L-m-0 L-l-0 C-l-0 C-m-1 C-l-0 L-l-0 
job-7366,2,9,1,367824,458731,458816,90907,85,368070,false,L-s-0 
job-7368,4,7,8,367919,458731,458977,90812,246,368268,false,C-l-2 C-l-1 C-l-2 C-l-2 C-l-1 C-l-1 C-m-0 C-m-0 
job-7369,6,8,8,367964,458977,459019,91013,42,368261,false,L-l-0 C-l-0 C-l-0 C-l-1 C-l-1 L-l-0 C-m-0 L-m-0 
job-7370,4,11,5,368020,459019,459032,90999,13,368070,false,L-m-0 L-l-0 L-l-0 L-l-0 L-m-0 
job-7371,5,8,2,368063,459019,459192,90956,173,368363,false,C-l-0 C-l-0 
job-7374,5,12,5,368194,459192,459225,90998,33,368435,false,C-m-0 C-l-0 C-l-0 C-l-1 C-l-1 
job-7375,6,11,8,368248,459225,459236,90977,11,368325,false,C-l-1 C-l-1 C-l-2 C-l-2 C-l-0 C-m-2 C-l-0 C-m-1 
job-7373,4,8,4,368148,459192,459277,91044,85,368313,false,L-s-0 C-s-1 L-m-0 L-m-0 
job-7376,6,5,7,368300,459236,459282,90936,46,368361,false,C-l-2 C-l-2 C-l-1 C-m-0 C-l-0 C-l-1 C-l-0 
job-7377,6,6,7,368357,459282,459294,90925,12,368403,false,L-m-0 C-l-1 C-l-0 C-l-2 C-l-1 C-l-0 C-l-2 
job-7372,2,8,5,368101,459192,459314,91091,122,368248,false,L-l-0 L-l-0 L-l-0 L-l-0 L-l-0 
job-7378,6,4,4,368401,459294,459395,90893,101,368689,false,L-m-0 C-l-0 C-l-0 C-m-0 
job-7379,1,7,3,368451,459395,459461,90944,66,368691,false,L-m-0 L-m-0 L-m-0 
job-7380,6,10,5,368497,459395,459495,90898,100,368812,false,C-m-0 C-l-0 L-l-0 L-l-0 C-l-0 
job-7381,3,12,6,368540,459495,459512,90955,17,368746,false,L-m-0 L-l-0 L-l-0 L-l-0 L-m-0 L-l-0 
job-7382,2,9,6,368588,459495,459568,90907,73,368708,false,L-s-0 C-l-0 C-l-0 C-l-0 C-l-0 C-l-0 
job-7383,3,7,3,368651,459568,459581,90917,13,368717,false,L-m-0 L-m-0 L-s-0 
job-7384,2,9,7,368694,459568,459601,90874,33,368779,false,L-l-0 L-l-0 L-l-0 C-s-1 L-l-0 L-l-0 L-m-0 
job-7385,2,6,2,368730,459601,459620,90871,19,368773,false,L-s-0 L-s-0 
job-7386,2,8,3,368786,459601,459625,90815,24,368826,false,L-m-0 L-m-0 L-m-0 
job-7387,4,4,7,368830,459601,459747,90771,146,369234,false,L-l-0 C-l-1 L-l-0 C-l-1 C-l-1 L-l-0 C-s-1 
job-7388,2,7,3,368882,459747,459761,90865,14,369124,false,L-m-0 L-m-0 L-m-0 
job-7390,3,4,2,368971,459747,459766,90776,19,369160,false,L-s-0 C-s-1 
job-7389,5,11,2,368927,459747,459770,90820,23,369173,false,L-l-0 L-l-0 
job-7391,3,5,8,369023,459747,460080,90724,333,369491,false,C-l-1 C-l-0 C-l-1 C-l-0 C-l-1 C-l-1 C-l-0 C-l-0 
job-7392,3,9,3,369078,460080,460133,91002,53,369237,false,L-m-0 L-m-0 L-s-0 
job-7393,1,8,4,369132,460080,460140,90948,60,369447,false,L-m-0 L-l-0 L-l-0 L-l-0 
job-7394,4,6,2,369185,460140,460198,90955,58,369402,false,L-m-0 L-m-0 
job-7395,5,12,1,369232,460140,460232,90908,92,369594,false,L-l-0 
job-7396,3,4,6,369276,460140,460262,90864,122,369503,false,L-l-0 C-l-0 C-l-0 C-l-0 C-l-0 L-l-0 
job-7397,4,5,4,369323,460140,460273,90817,133,369607,false,L-s-0 C-l-1 C-l-1 C-l-1 
job-7398,5,8,1,369378,460262,460311,90884,49,369629,false,L-m-0 
job-7399,4,9,2,369425,460262,460330,90837,68,369720,false,L-l-0 L-l-0 
job-7400,3,7,8,369476,460262,460404,90786,142,369792,false,C-l-2 C-l-2 C-l-2 L-m-0 C-l-2 L-l-0 C-m-0 C-m-0 
job-7401,6,7,7,369526,460330,460419,90804,89,369860,false,C-l-1 C-l-1 C-l-0 C-m-2 C-l-0 L-l-0 C-m-1 
job-7402,2,10,2,369572,460419,460495,90847,76,369672,false,L-m-0 L-m-0 
job-7405,5,12,1,369704,460495,460580,90791,85,369842,false,L-l-0 
job-7403,2,4,2,369622,460495,460604,90873,109,369735,false,L-s-0 L-s-0 
job-7404,3,6,2,369666,460495,460620,90829,125,370028,false,L-m-0 L-m-0 
job-7407,4,12,8,369800,460620,460670,90820,50,369877,false,L-m-0 L-m-0 L-l-0 L-l-0 L-l-0 C-m-2 C-s-0 C-m-2 
job-7406,1,4,2,369759,460620,460704,90861,84,370021,false,L-s-0 L-s-0 
job-7411,6,10,8,369997,460704,460728,90707,24,370088,false,C-l-0 C-l-2 C-l-1 C-l-0 C-l-1 C-m-1 C-l-2 C-m-0 
job-7413,4,4,6,370093,460728,460763,90635,35,370217,false,C-l-0 C-l-1 C-l-0 C-l-1 C-l-0 C-l-1 
job-7412,4,11,7,370039,460728,460769,90689,41,370168,false,C-m-0 C-m-1 C-m-0 C-m-2 C-m-2 C-s-0 C-m-1 
job-7408,2,6,1,369843,460704,460774,90861,70,370072,false,L-s-0 
job-7409,5,12,1,369895,460704,460789,90809,85,370104,false,L-m-0 
job-7410,4,7,3,369946,460704,460809,90758,105,370307,false,L-l-0 L-l-0 L-l-0 
job-7414,1,7,2,370132,460789,460925,90657,136,370394,false,L-s-0 L-s-0 
job-7417,6,11,3,370281,460925,460969,90644,44,370595,false,C-l-2 C-l-2 C-m-0 
job-7416,5,11,3,370222,460925,460994,90703,69,370501,false,L-l-0 L-l-0 C-m-1 
job-7415,4,8,5,370173,460789,461012,90616,223,370429,false,L-m-0 C-l-0 C-l-0 L-m-0 C-l-0 
job-7419,6,10,4,370388,460994,461098,90606,104,370518,false,C-m-0 C-l-1 C-l-1 L-l-0 
job-7418,1,9,2,370342,460994,461409,90652,415,370787,false,L-l-0 L-l-0 
job-7421,5,8,8,370492,461409,461424,90917,15,370630,false,C-l-2 C-l-1 C-l-0 C-l-1 C-l-0 L-l-0 C-l-2 L-l-0 
job-7420,5,5,1,370440,461409,461437,90969,28,370551,false,L-m-0 
job-7422,3,12,7,370535,461409,461446,90874,37,370623,false,C-m-0 C-s-1 L-s-0 C-m-1 C-m-1 L-m-0 C-m-0 
job-7423,1,12,8,370587,461424,461704,90837,280,371074,false,L-l-0 L-l-0 C-l-0 C-l-0 C-l-0 C-l-0 L-l-0 L-l-0 
job-7424,4,7,3,370637,461704,461723,91067,19,370786,false,L-l-0 L-l-0 L-l-0 
job-7425,6,8,7,370683,461704,461781,91021,77,371028,false,C-l-0 C-l-0 C-l-1 L-m-0 C-l-1 C-l-2 C-l-2 
job-7426,6,12,5,370721,461781,461797,91060,16,370924,false,L-m-0 C-l-0 L-l-0 L-l-0 C-l-0 
job-7427,4,10,5,370765,461781,461862,91016,81,370972,false,L-s-0 C-l-2 C-l-2 C-s-1 C-l-2 
job-7428,3,9,2,370807,461781,461981,90974,200,371129,false,C-m-0 C-m-0 
job-7430,5,12,6,370903,461981,462083,91078,102,371218,false,L-m-0 C-l-0 C-l-0 C-m-0 L-l-0 L-l-0 
job-7429,2,9,1,370848,461981,462405,91133,424,371386,false,L-s-0 
job-7431,6,7,3,370956,462405,462434,91449,29,371256,false,L-l-0 L-l-0 L-m-0 
job-7432,3,9,7,371006,462405,462510,91399,105,371399,false,C-m-2 C-l-0 C-l-0 C-m-2 C-l-0 C-l-0 L-s-0 
job-7433,6,8,8,371058,462434,462535,91376,101,371250,false,L-l-0 C-l-2 C-l-1 C-l-2 C-l-1 C-m-0 L-l-0 L-m-0 
job-7434,1,7,5,371115,462535,462545,91420,10,371327,false,L-l-0 L-l-0 L-l-0 L-l-0 L-l-0 
job-7436,6,8,7,371217,462535,462571,91318,36,371552,false,C-m-0 C-l-1 C-l-1 C-l-2 C-l-0 C-l-0 C-l-2 
job-7435,6,11,2,371166,462535,462595,91369,60,371262,false,L-m-0 L-l-0 
job-7437,3,12,6,371271,462535,462614,91264,79,371506,false,C-m-1 C-m-2 L-s-0 C-m-1 C-m-2 C-s-1 
job-7438,2,7,8,371319,462614,462625,91295,11,371432,false,L-l-0 L-l-0 L-l-0 L-l-0 L-l-0 L-s-0 L-l-0 L-s-0 
job-7441,5,10,5,371474,462614,462649,91140,35,371654,false,C-m-0 C-l-1 C-l-0 C-l-1 C-l-0 
job-7440,1,9,4,371424,462614,462691,91190,77,371720,false,L-m-0 C-m-0 L-m-0 C-m-0 
job-7442,4,11,2,371519,462691,462735,91172,44,371751,false,L-s-0 L-m-0 
job-7439,3,9,1,371374,462614,462740,91240,126,371682,false,L-m-0 
job-7445,6,4,2,371667,462735,462859,91068,124,372062,false,C-l-0 C-l-0 
job-7443,1,6,6,371572,462691,462904,91119,213,371791,false,L-l-0 L-l-0 L-m-0 L-l-0 L-l-0 L-l-0 
job-7444,6,6,2,371621,462691,462980,91070,289,372163,false,L-l-0 C-m-0 
job-7446,3,4,5,371709,462980,463003,91271,23,371848,false,L-s-0 L-l-0 L-l-0 L-l-0 L-l-0 
job-7447,6,8,4,371768,462980,463013,91212,33,371929,false,L-m-0 C-l-2 C-l-2 C-m-0 
job-7448,3,10,2,371815,462980,463124,91165,144,372054,false,C-m-1 C-m-1 
job-7449,1,11,7,371861,463124,463149,91263,25,372180,false,L-m-0 L-l-0 L-l-0 L-s-0 L-l-0 L-l-0 L-m-0 
job-7450,2,7,8,371905,463124,463153,91219,29,371965,false,C-s-0 C-l-1 C-l-1 C-l-1 C-l-1 C-l-1 C-l-1 L-m-0 
job-7451,4,12,5,371962,463124,463274,91162,150,372297,false,C-m-2 C-l-0 C-l-0 C-m-2 C-l-0 
job-7452,1,6,7,372010,463274,463305,91264,31,372054,false,L-l-0 L-l-0 L-l-0 L-l-0 L-l-0 L-l-0 L-l-0 
job-7454,4,10,4,372104,463274,463313,91170,39,372422,false,C-m-0 L-m-0 L-m-0 C-m-0 
job-7453,4,12,1,372060,463274,463603,91214,329,372418,false,L-s-0 
job-7455,6,6,1,372157,463603,463618,91446,15,372281,false,L-m-0 
job-7457,2,10,4,372230,463603,463640,91373,37,372359,false,C-m-0 L-m-0 C-m-0 C-m-0 
job-7456,3,11,6,372195,463603,463646,91408,43,372243,false,L-s-0 L-l-0 L-l-0 C-s-2 L-l-0 L-l-0 
job-7459,5,6,8,372345,463640,463654,91295,14,372432,false,C-m-1 C-l-1 C-l-2 C-l-2 C-l-1 C-m-0 C-m-2 L-m-0 
job-7458,2,9,4,372286,463603,463686,91317,83,372595,false,C-l-0 C-l-0 C-l-0 C-l-0 
job-7460,2,5,5,372397,463686,463705,91289,19,372649,false,L-l-0 L-l-0 L-l-0 L-l-0 L-l-0 
job-7461,4,8,2,372453,463686,463825,91233,139,372884,false,L-m-0 L-m-0 
job-7462,5,10,6,372495,463686,463830,91191,144,372853,false,C-l-2 C-l-0 C-l-1 C-l-2 C-l-1 C-l-0 
job-7463,6,4,3,372537,463686,463842,91149,156,372914,false,C-m-2 C-m-0 C-m-1 
job-7466,3,10,5,372681,463825,463897,91144,72,373019,false,C-s-2 L-m-0 C-s-1 L-m-0 C-s-0 
job-7464,5,10,2,372591,463825,463923,91234,98,372793,false,L-l-0 L-l-0 
job-7465,4,9,1,372633,463825,463930,91192,105,372832,false,L-s-0 
job-7467,3,7,7,372732,463830,464045,91098,215,373225,false,C-l-0 C-l-0 C-l-0 C-l-1 C-l-0 C-l-1 C-l-1 
job-7468,6,6,7,372784,463923,464215,91139,292,373253,false,C-m-1 L-l-0 C-l-2 C-m-0 C-l-2 L-l-0 L-m-0 
job-7469,1,12,3,372834,464215,464248,91381,33,373020,false,L-l-0 L-l-0 L-l-0 
job-7470,1,4,3,372884,464248,464321,91364,73,372962,false,L-s-0 L-s-0 L-s-0 
job-7473,2,12,6,373026,464321,464388,91295,67,373125,false,C-s-0 C-m-0 L-s-0 C-s-1 C-m-0 C-s-2 
job-7472,6,5,8,372975,464248,464390,91273,142,373182,false,L-l-0 C-l-1 C-l-0 C-l-2 C-l-1 C-l-2 L-l-0 C-l-0 
job-7474,6,8,5,373056,464390,464427,91334,37,373306,false,C-l-1 L-l-0 L-l-0 C-m-0 C-l-1 
job-7475,5,9,8,373104,464427,464441,91323,14,373409,false,C-l-0 C-l-1 C-l-0 C-l-2 C-l-1 L-l-0 C-l-2 L-l-0 
job-7471,4,12,2,372916,464248,464539,91332,291,373323,false,L-m-0 L-m-0 
job-7477,3,12,2,373211,464441,464546,91230,105,373572,false,L-s-0 C-s-1 
job-7478,5,5,8,373269,464539,464558,91270,19,373569,false,C-m-2 C-l-1 C-l-2 C-l-2 C-l-1 L-m-0 C-m-1 C-m-0 
job-7476,1,12,8,373151,464441,464578,91290,137,373571,false,L-l-0 C-l-0 C-l-0 C-l-0 C-l-0 L-l-0 L-l-0 L-l-0 
job-7479,2,12,7,373313,464539,464579,91226,40,373355,false,C-m-0 L-m-0 C-l-1 C-m-1 C-l-2 C-s-2 C-m-2 
job-7482,6,9,8,373459,464579,464600,91120,21,373735,false,C-l-0 C-l-2 C-l-0 C-m-2 C-l-1 C-l-2 C-l-1 C-m-1 
job-7481,4,8,5,373417,464579,464647,91162,68,373746,false,C-m-0 L-m-0 L-s-0 C-m-0 L-m-0 
job-7483,1,10,2,373523,464600,464665,91077,65,373722,false,C-m-1 C-m-1 
job-7480,6,7,2,373369,464579,464751,91210,172,373640,false,L-l-0 L-l-0 
job-7485,2,4,7,373635,464751,464774,91116,23,373943,false,L-l-0 L-s-0 L-l-0 L-l-0 L-l-0 L-l-0 L-l-0 
job-7486,3,7,2,373683,464774,464788,91091,14,373898,false,L-m-0 L-m-0 
job-7484,1,11,1,373576,464751,464803,91175,52,373706,false,L-s-0 
job-7487,3,4,3,373732,464774,465040,91042,266,374189,false,L-l-0 L-l-0 L-s-0 
job-7490,5,10,6,373880,465040,465088,91160,48,373967,false,L-l-0 C-l-1 C-l-0 C-l-1 C-l-0 L-l-0 
job-7488,4,6,1,373786,465040,465107,91254,67,373895,false,L-s-0 
job-7489,4,8,1,373835,465040,465152,91205,112,374130,false,L-m-0 
job-7492,5,8,4,373983,465152,465319,91169,167,374181,false,C-m-2 L-l-0 L-l-0 L-m-0 
job-7491,5,10,4,373922,465040,465369,91118,329,374433,false,C-m-1 C-l-2 C-l-2 C-m-0 
job-7493,6,6,3,374033,465319,465393,91286,74,374251,false,L-m-0 L-l-0 L-l-0 
job-7494,3,6,2,374084,465369,465512,91285,143,374321,false,L-s-0 C-s-1 
job-7495,6,11,3,374139,465512,465522,91373,10,374315,false,L-l-0 L-l-0 L-m-0 
job-7496,6,10,1,374199,465512,465747,91313,235,374577,false,C-m-0 
job-7497,6,8,2,374252,465747,465768,91495,21,374497,false,L-l-0 L-l-0 
job-7498,6,5,8,374300,465747,465816,91447,69,374630,false,C-l-0 C-l-1 C-l-1 C-l-2 C-l-0 C-m-0 C-l-2 L-m-0 
job-7499,2,6,5,374350,465747,465856,91397,109,374481,false,L-m-0 C-s-1 L-s-0 C-s-1 C-m-0 
job-7500,6,11,6,374403,465816,466190,91413,374,374829,false,L-m-0 C-m-0 C-l-0 L-l-0 C-l-0 L-l-0 
job-7501,6,11,4,374439,466190,466324,91751,134,374750,false,L-m-0 L-l-0 L-l-0 C-m-0 
job-7503,1,8,5,374533,466324,466336,91791,12,374565,false,C-l-0 C-l-0 C-l-0 C-l-0 C-l-0 
job-7502,4,7,6,374491,466324,466344,91833,20,374810,false,L-m-0 L-s-0 L-l-0 L-l-0 L-m-0 L-l-0 
job-7504,6,6,5,374578,466324,466416,91746,92,374683,false,C-l-2 C-l-1 C-l-0 C-l-2 C-l-1 
job-7505,3,12,3,374624,466416,466481,91792,65,374887,false,L-m-0 L-m-0 L-s-0 
job-7506,5,10,8,374682,466416,466496,91734,80,374820,false,C-l-1 L-l-0 C-l-0 C-l-2 C-l-1 L-l-0 C-l-0 C-l-2 
job-7507,5,4,3,374721,466416,466508,91695,92,374837,false,C-m-2 C-m-1 C-m-0 
job-7510,4,10,3,374859,466508,466556,91649,48,374991,false,C-l-0 C-l-0 C-l-0 
job-7508,6,4,2,374769,466496,466575,91727,79,374965,false,L-l-0 L-l-0 
job-7509,1,6,8,374810,466508,466616,91698,108,374978,false,L-s-0 L-m-0 L-m-0 L-s-0 L-m-0 L-m-0 C-s-1 L-m-0 
job-7511,5,6,8,374913,466556,466714,91643,158,375309,false,C-m-2 C-l-1 C-l-0 C-l-2 C-l-1 C-l-2 C-l-0 C-m-0 
job-7513,1,6,8,375017,466714,466822,91697,108,375300,false,L-m-0 L-l-0 L-l-0 L-l-0 L-l-0 L-l-0 L-m-0 L-l-0 
job-7514,6,9,3,375065,466822,466832,91757,10,375300,false,L-l-0 L-l-0 C-m-0 
job-7512,3,8,2,374960,466714,466849,91754,135,375320,false,L-m-0 L-m-0 
job-7515,2,4,8,375119,466822,466851,91703,29,375250,false,L-s-0 C-m-0 L-s-0 L-m-0 C-m-1 C-m-1 C-m-1 C-m-1 
job-7516,5,7,2,375170,466822,466951,91652,129,375559,false,C-l-0 C-l-0 
job-7517,2,10,1,375214,466951,467137,91737,186,375421,false,L-s-0 
job-7518,1,7,2,375266,466951,467179,91685,228,375684,false,L-m-0 L-m-0 
job-7519,5,7,3,375321,467137,467235,91816,98,375429,false,L-l-0 L-m-0 L-l-0 
job-7520,2,10,3,375362,467235,467247,91873,12,375528,false,L-m-0 L-m-0 L-m-0 
job-7521,5,7,8,375414,467235,467292,91821,57,375515,false,C-l-2 C-l-1 C-l-0 C-l-0 C-l-1 L-l-0 C-l-2 L-l-0 
job-7522,3,11,4,375471,467292,467302,91821,10,375663,false,L-l-0 L-l-0 L-l-0 L-l-0 
job-7523,1,5,7,375521,467292,467451,91771,159,375865,false,L-s-0 L-m-0 L-s-0 L-m-0 L-m-0 L-m-0 L-s-0 
job-7524,1,5,1,375571,467451,467496,91880,45,375804,false,L-s-0 
job-7525,2,4,3,375631,467496,467511,91865,15,375853,false,L-m-0 L-m-0 L-m-0 
job-7526,2,11,7,375672,467496,467521,91824,25,375741,false,C-s-0 L-l-0 L-m-0 L-s-0 L-l-0 L-l-0 L-l-0 
job-7527,3,9,8,375728,467496,467563,91768,67,376048,false,C-l-1 C-l-0 C-l-1 C-l-0 C-l-1 C-l-1 C-l-0 C-l-0 
job-7528,3,7,5,375789,467496,467677,91707,181,376118,false,C-l-2 C-l-2 C-l-2 C-s-1 C-l-2 
job-7529,5,10,5,375836,467677,467732,91841,55,376096,false,L-l-0 L-l-0 C-l-0 L-m-0 C-l-0 
job-7530,5,9,4,375880,467677,467747,91797,70,376156,false,C-l-2 C-l-1 C-l-1 C-l-2 
job-7531,3,10,8,375928,467677,467910,91749,233,376294,false,C-m-2 C-m-2 C-m-0 L-s-0 C-m-0 C-m-1 L-m-0 C-m-1 
job-7532,5,6,4,375967,467910,467948,91943,38,376043,false,L-m-0 L-l-0 L-l-0 C-m-0 
job-7533,5,9,2,376022,467910,468090,91888,180,376422,false,C-l-0 C-l-0 
job-7535,1,9,5,376121,468090,468122,91969,32,376196,false,L-l-0 L-l-0 L-l-0 L-l-0 L-l-0 
job-7536,4,4,8,376165,468090,468150,91925,60,376405,false,L-m-0 C-l-1 C-l-1 C-l-0 C-l-1 C-l-0 C-l-0 L-m-0 
job-7534,1,6,2,376066,468090,468192,92024,102,376327,false,L-s-0 L-s-0 
job-7537,4,6,4,376217,468090,468426,91873,336,376675,false,C-s-1 C-l-2 C-l-2 C-l-2 
job-7538,3,6,6,376253,468426,468452,92173,26,376292,false,L-m-0 L-l-0 L-l-0 L-m-0 L-l-0 L-l-0 
job-7539,5,12,4,376301,468426,468599,92125,173,376732,false,C-l-0 C-l-2 C-l-0 C-l-2 
job-7540,2,6,8,376343,468599,468617,92256,18,376545,false,L-l-0 L-s-0 L-l-0 L-l-0 L-l-0 L-s-0 L-l-0 L-l-0 
job-7541,3,8,6,376392,468599,468716,92207,117,376703,false,L-m-0 C-l-0 C-l-0 L-m-0 C-l-0 C-l-0 
job-7542,3,8,6,376451,468599,468734,92148,135,376712,false,C-m-0 C-l-2 C-l-2 C-m-0 C-l-2 C-l-2 
job-7543,4,10,4,376513,468716,468744,92203,28,376809,false,L-s-0 L-l-0 L-l-0 L-l-0 
job-7545,1,11,8,376602,468716,468880,92114,164,377037,false,C-m-0 C-s-0 C-s-2 C-m-1 C-m-2 C-m-2 C-s-1 C-m-1 
job-7544,4,5,8,376552,468716,468881,92164,165,376878,false,C-l-0 C-l-1 C-l-1 C-l-0 C-l-0 L-m-0 C-l-1 L-m-0 
job-7546,3,9,7,376656,468880,468985,92224,105,376982,false,C-s-1 L-l-0 L-l-0 L-s-0 L-l-0 L-l-0 C-s-2 
job-7547,4,4,2,376704,468985,469042,92281,57,376953,false,L-m-0 L-m-0 
job-7549,4,5,4,376789,469042,469121,92253,79,377118,false,C-m-0 L-m-0 L-m-0 C-m-0 
job-7548,4,8,8,376741,468985,469158,92244,173,377052,false,C-s-1 C-l-1 C-l-1 C-l-1 L-l-0 L-l-0 L-l-0 L-s-0 
job-7550,3,10,4,376838,469042,469248,92204,206,377257,false,C-l-0 C-l-0 C-l-0 C-l-0 
job-7551,5,12,3,376879,469248,469281,92369,33,377092,false,L-l-0 L-m-0 L-l-0 
job-7552,5,12,6,376938,469248,469386,92310,138,377196,false,C-l-0 C-l-0 C-l-1 C-l-2 C-l-1 C-l-2 
job-7554,2,10,8,377031,469248,469449,92217,201,377236,false,C-m-0 C-m-2 C-m-0 C-m-1 C-m-2 C-m-1 C-m-1 C-m-0 
job-7553,2,8,6,376985,469248,469527,92263,279,377435,false,L-s-0 C-l-2 C-l-1 L-m-0 C-l-0 L-l-0 
job-7555,4,10,7,377071,469527,469652,92456,125,377207,false,L-l-0 L-m-0 L-s-0 L-l-0 L-m-0 L-l-0 C-s-1 
job-7556,5,5,3,377123,469527,469727,92404,200,377594,false,C-l-1 C-m-0 C-l-1 
job-7557,5,4,4,377170,469727,469746,92557,19,377469,false,L-m-0 L-l-0 L-l-0 C-m-0 
job-7558,5,5,6,377222,469727,469886,92505,159,377598,false,C-l-2 C-l-0 C-l-0 C-l-2 C-l-1 C-l-1 
job-7560,3,7,1,377318,469886,469978,92568,92,377522,false,L-m-0 
job-7559,2,4,1,377267,469886,470042,92619,156,377502,false,L-s-0 
job-7561,2,6,3,377379,469978,470055,92599,77,377572,false,L-m-0 L-m-0 L-s-0 
job-7562,6,11,8,377428,469978,470125,92550,147,377837,false,L-l-0 C-l-2 C-l-1 C-l-1 C-l-0 L-l-0 C-l-2 C-l-0 
job-7563,1,11,7,377492,470125,470155,92633,30,377725,false,L-m-0 L-l-0 L-l-0 L-s-0 L-l-0 L-l-0 L-m-0 
job-7564,6,9,6,377540,470125,470157,92585,32,377779,false,C-m-0 L-m-0 C-l-0 C-l-0 C-l-2 C-l-2 
job-7565,1,8,8,377590,470125,470320,92535,195,377957,false,C-l-1 C-l-1 C-l-1 C-m-0 C-l-1 C-l-1 C-l-1 C-m-0 
job-7568,5,12,6,377744,470320,470339,92576,19,377769,false,L-m-0 C-l-1 C-l-0 C-m-0 C-l-0 C-l-1 
job-7566,3,5,3,377640,470320,470372,92680,52,377885,false,L-l-0 L-l-0 L-l-0 
job-7567,2,11,2,377693,470320,470515,92627,195,377929,false,L-s-0 L-l-0 
job-7569,1,9,1,377794,470515,470528,92721,13,378012,false,L-s-0 
job-7571,6,8,2,377892,470515,470598,92623,83,378070,false,L-l-0 L-m-0 
job-7570,1,8,2,377844,470515,470657,92671,142,377992,false,L-m-0 L-m-0 
job-7572,5,5,4,377943,470515,470682,92572,167,378241,false,C-m-0 L-l-0 C-l-0 C-l-0 
job-7573,3,8,6,377984,470657,470732,92673,75,378069,false,L-m-0 L-l-0 L-l-0 L-s-0 C-m-0 L-m-0 
job-7574,5,9,8,378037,470682,470831,92645,149,378392,false,C-l-0 C-l-1 C-l-1 C-l-2 C-l-0 L-l-0 C-l-2 C-m-0 
job-7575,6,10,4,378073,470831,470844,92758,13,378219,false,L-m-0 L-l-0 L-l-0 C-m-0 
job-7576,6,10,5,378131,470831,470922,92700,91,378330,false,C-l-1 C-l-0 C-l-1 C-m-1 C-l-0 
job-7577,5,5,2,378180,470922,470944,92742,22,378215,false,L-l-0 L-l-0 
job-7579,6,8,1,378297,470922,471081,92625,159,378685,false,C-m-1 
job-7578,6,9,4,378239,470922,471103,92683,181,378624,false,L-m-0 C-l-0 C-l-0 C-m-0 
job-7580,4,9,4,378353,471103,471115,92750,12,378371,false,L-l-0 L-l-0 L-s-0 L-l-0 
job-7581,5,5,2,378397,471103,471237,92706,134,378589,false,L-m-0 C-m-0 
job-7582,6,9,2,378446,471237,471294,92791,57,378566,false,L-l-0 L-l-0 
job-7583,4,5,4,378501,471237,471310,92736,73,378695,false,L-m-0 L-m-0 L-s-0 C-s-1 
job-7585,3,12,8,378581,471237,471351,92656,114,378948,false,C-l-1 C-l-1 C-l-1 C-s-0 C-l-1 C-m-2 C-s-2 C-m-2 
job-7584,4,7,8,378538,471237,471411,92699,174,378765,false,C-l-0 C-l-2 C-m-0 C-l-2 C-l-2 C-l-0 C-l-0 C-m-0 
job-7586,1,7,8,378641,471294,471466,92653,172,379086,false,L-l-0 L-l-0 L-l-0 L-l-0 L-l-0 L-l-0 C-m-1 C-m-2 
job-7587,2,5,6,378690,471466,471599,92776,133,379102,false,L-l-0 L-l-0 L-l-0 L-l-0 L-l-0 L-l-0 
job-7589,1,10,7,378789,471599,471669,92810,70,378939,false,L-m-0 L-l-0 L-l-0 L-m-0 L-l-0 L-l-0 L-m-0 
job-7588,4,8,1,378733,471599,471682,92866,83,379040,false,L-s-0 
job-7590,5,10,7,378839,471599,471725,92760,126,379213,false,C-l-0 C-l-1 C-l-0 C-m-0 C-l-1 C-l-2 C-l-2 
job-7591,4,6,5,378891,471599,471768,92708,169,379103,false,C-m-1 C-m-2 C-m-2 C-m-1 L-l-0 
job-7593,4,4,2,379012,471768,471785,92756,17,379123,false,L-m-0 L-m-0 
job-7592,5,10,2,378955,471768,471794,92813,26,379223,false,L-l-0 L-l-0 
job-7595,4,4,5,379119,471768,471845,92649,77,379431,false,C-m-0 C-l-1 C-l-1 C-m-0 C-l-1 
job-7594,3,9,1,379069,471768,471890,92699,122,379443,false,L-s-0 
job-7596,4,4,2,379166,471768,472019,92602,251,379623,false,C-m-1 C-m-1 
job-7597,5,8,5,379215,472019,472058,92804,39,379486,false,L-l-0 L-l-0 C-l-0 L-m-0 C-l-0 
job-7598,4,8,7,379260,472019,472126,92759,107,379429,false,L-s-0 C-l-2 C-l-1 C-l-2 C-l-2 C-l-1 C-l-1 
job-7599,5,12,1,379305,472126,472178,92821,52,379417,false,L-m-0 
job-7600,4,5,2,379359,472126,472222,92767,96,379736,false,L-l-0 L-l-0 
job-7602,6,12,7,379470,472222,472280,92752,58,379698,false,L-l-0 C-l-1 C-l-0 L-l-0 C-l-1 C-l-0 L-m-0 
job-7603,6,8,1,379520,472222,472299,92702,77,379772,false,C-m-0 
job-7604,5,9,8,379574,472280,472349,92706,69,379766,false,L-l-0 C-l-0 C-l-1 C-l-1 C-l-0 L-l-0 C-m-1 L-m-0 
job-7601,3,5,1,379420,472222,472373,92802,151,379681,false,L-s-0 
job-7607,4,12,3,379734,472373,472416,92639,43,379842,false,L-s-0 C-m-1 C-m-1 
job-7606,3,8,7,379683,472349,472418,92666,69,379997,false,L-l-0 L-l-0 L-l-0 C-l-0 C-l-0 C-l-0 C-l-0 
job-7605,3,8,2,379629,472349,472513,92720,164,379843,false,L-m-0 L-m-0 
job-7608,4,6,4,379773,472373,472598,92600,225,380132,false,C-s-1 C-l-1 C-l-1 C-l-1 
job-7609,4,9,4,379820,472598,472646,92778,48,380154,false,L-l-0 L-l-0 L-s-0 L-l-0 
job-7610,4,12,6,379867,472598,472800,92731,202,380099,false,L-m-0 C-l-2 C-l-2 C-s-0 C-l-2 L-m-0 
job-7611,1,10,2,379920,472800,472900,92880,100,380168,false,L-m-0 L-m-0 
job-7612,2,6,1,379973,472900,472993,92927,93,380106,false,L-s-0 
job-7613,3,4,5,380028,472900,473023,92872,123,380360,false,L-l-0 L-l-0 L-l-0 L-m-0 L-l-0 
job-7617,3,11,5,380216,473023,473049,92807,26,380300,false,C-s-1 C-l-0 C-l-0 C-l-0 C-l-0 
job-7618,6,7,8,380266,473049,473079,92783,30,380348,false,C-l-0 C-l-1 C-l-1 C-l-2 C-l-2 C-m-1 C-l-0 C-m-0 
job-7615,3,5,5,380125,473023,473111,92898,88,380401,false,L-l-0 L-l-0 L-s-0 L-l-0 L-l-0 
job-7621,6,7,4,380394,473079,473115,92685,36,380609,false,C-m-0 C-l-2 C-l-2 C-m-1 
job-7619,4,9,1,380306,473049,473119,92743,70,380474,false,C-s-1 
job-7620,3,6,8,380354,473079,473139,92725,60,380542,false,C-l-0 C-l-1 C-l-0 C-l-0 C-l-1 C-l-1 C-l-0 C-l-1 
job-7616,6,6,1,380164,473023,473153,92859,130,380318,false,L-m-0 
job-7614,1,8,1,380070,473023,473166,92953,143,380476,false,L-s-0 
job-7622,6,8,8,380441,473139,473367,92698,228,380755,false,C-l-0 C-l-2 C-l-1 C-l-2 C-l-0 L-l-0 C-l-1 L-l-0 
job-7625,5,6,6,380603,473367,473445,92764,78,380843,false,C-l-0 C-l-1 C-l-0 C-l-2 C-l-1 C-l-2 
job-7623,1,7,3,380497,473367,473499,92870,132,380767,false,L-m-0 L-m-0 L-m-0 
job-7624,3,6,4,380543,473367,473580,92824,213,380787,false,L-m-0 L-l-0 L-l-0 L-l-0 
job-7628,2,8,6,380731,473580,473764,92849,184,380939,false,C-l-0 C-l-0 C-l-0 L-m-0 C-l-0 C-l-0 
job-7627,1,11,6,380681,473580,473796,92899,216,380994,false,L-m-0 L-l-0 L-l-0 L-m-0 L-l-0 L-l-0 
job-7630,4,5,6,380838,473764,473819,92926,55,380943,false,C-l-0 C-l-1 C-l-1 C-l-0 C-l-1 C-l-0 
job-7626,3,12,1,380641,473580,473851,92939,271,381197,false,L-s-0 
job-7629,2,8,3,380786,473764,473851,92978,87,381107,false,C-s-1 L-m-0 C-s-1 
job-7632,6,8,3,380929,473851,473878,92922,27,381220,false,L-l-0 L-l-0 L-m-0 
job-7631,6,10,3,380884,473764,473880,92880,116,381199,false,C-m-0 C-l-2 C-l-2 
job-7633,3,5,6,380972,473851,473974,92879,123,381244,false,L-s-0 C-l-0 C-l-0 C-s-2 C-l-0 C-l-0 
job-7634,1,10,6,381030,473851,474080,92821,229,381519,false,L-s-0 C-m-0 C-m-0 C-s-2 C-m-1 C-m-1 
job-7635,4,12,6,381090,474080,474118,92990,38,381301,false,L-m-0 L-s-0 L-l-0 L-l-0 L-m-0 L-l-0 
job-7636,1,7,1,381124,474080,474150,92956,70,381428,false,C-s-1 
job-7637,4,9,4,381173,474150,474162,92977,12,381412,false,L-l-0 L-l-0 L-s-0 L-l-0 
job-7639,4,7,5,381272,474150,474233,92878,83,381646,false,C-s-0 C-l-2 C-l-2 L-m-0 C-l-2 
job-7640,3,4,8,381326,474150,474234,92824,84,381524,false,L-m-0 C-l-0 C-l-0 C-l-1 C-l-1 C-l-0 C-l-0 C-l-1 
job-7638,1,4,1,381227,474150,474251,92923,101,381382,false,L-m-0 
job-7641,6,9,1,381381,474233,474255,92852,22,381548,false,L-l-0 
job-7642,6,8,6,381439,474233,474350,92794,117,381678,false,C-m-1 C-l-2 C-m-2 C-m-0 C-l-2 L-l-0 
job-7643,4,7,6,381476,474234,474398,92758,164,381938,false,L-m-0 C-l-0 C-l-0 C-s-1 C-l-0 L-s-0 
job-7644,2,7,2,381523,474398,474450,92875,52,381852,false,L-s-0 L-s-0 
job-7646,5,6,4,381616,474398,474476,92782,78,381696,false,L-m-0 L-l-0 L-l-0 C-m-0 
job-7647,3,7,5,381672,474398,474544,92726,146,381951,false,C-l-0 C-m-0 C-l-0 C-l-0 C-l-0 
job-7645,1,10,1,381571,474398,474764,92827,366,381967,false,L-m-0 
job-7648,2,5,1,381724,474764,474806,93040,42,381943,false,L-s-0 
job-7649,4,6,6,381786,474764,475144,92978,380,382407,false,C-s-1 L-l-0 L-l-0 L-m-0 L-l-0 L-m-0 
job-7650,1,10,7,381840,475144,475154,93304,10,381964,false,L-m-0 L-l-0 L-l-0 L-m-0 L-l-0 L-l-0 L-m-0 
job-7651,2,10,6,381878,475144,475204,93266,60,381950,false,L-s-0 C-m-0 C-m-0 C-m-1 C-m-1 C-m-0 
job-7652,4,10,6,381935,475144,475224,93209,80,382090,false,C-m-1 C-m-2 C-l-1 C-m-2 C-l-1 C-l-1 
job-7653,3,6,2,381980,475204,475229,93224,25,382260,false,L-s-0 C-m-1 
job-7654,4,11,8,382043,475204,475237,93161,33,382271,false,L-l-0 L-l-0 C-l-2 C-l-2 C-l-2 L-m-0 L-l-0 L-m-0 
job-7656,5,5,5,382132,475229,475245,93097,16,382378,false,C-l-0 C-l-0 C-l-1 C-m-0 C-l-1 
job-7655,1,7,1,382086,475229,475342,93143,113,382394,false,L-s-0 
job-7657,5,4,2,382177,475229,475381,93052,152,382417,false,C-m-2 C-m-1 
job-7658,4,5,4,382220,475342,475384,93122,42,382434,false,L-s-0 L-l-0 L-l-0 L-l-0 
job-7659,6,8,7,382274,475342,475428,93068,86,382626,false,L-m-0 C-l-0 C-l-1 C-l-2 C-l-0 C-l-1 C-l-2 
job-7660,1,9,7,382320,475381,475443,93061,62,382454,false,C-m-1 L-m-0 L-m-0 C-m-1 C-m-0 C-m-0 C-m-1 
job-7661,3,6,4,382375,475381,475584,93006,203,382688,false,C-m-2 C-m-0 C-m-2 C-m-0 
job-7662,2,6,5,382426,475584,475673,93158,89,382803,false,L-l-0 L-l-0 L-l-0 L-l-0 L-l-0 
job-7663,6,10,1,382482,475673,475693,93191,20,382738,false,L-m-0 
job-7664,4,6,7,382532,475673,475802,93141,129,382806,false,C-l-0 C-l-0 L-l-0 L-l-0 C-l-0 L-l-0 L-s-0 
job-7665,2,8,7,382579,475673,475830,93094,157,382884,false,C-l-1 C-l-1 L-m-0 C-l-1 C-l-1 C-l-1 C-l-1 
job-7666,6,8,6,382622,475693,476055,93071,362,383117,false,C-m-0 C-l-2 L-m-0 C-m-1 C-l-2 C-m-2 
job-7667,3,7,4,382675,476055,476138,93380,83,383008,false,L-l-0 L-l-0 L-l-0 L-l-0 
job-7668,1,12,7,382729,476055,476166,93326,111,382896,false,C-l-0 C-l-0 C-l-0 L-m-0 C-l-0 L-m-0 L-s-0 
job-7669,1,9,3,382765,476166,476176,93401,10,382870,false,L-m-0 L-m-0 L-m-0 
job-7670,5,6,7,382823,476166,476255,93343,89,383013,false,C-m-0 L-l-0 C-l-1 C-l-1 C-l-0 L-l-0 C-l-0 
job-7672,3,8,4,382918,476255,476294,93337,39,383038,false,L-l-0 L-m-0 L-l-0 L-l-0 
job-7671,2,11,3,382874,476255,476313,93381,58,382951,false,L-m-0 L-m-0 L-s-0 
job-7673,4,12,5,382971,476255,476449,93284,194,383272,false,C-m-1 C-l-0 C-l-0 C-m-1 C-l-0 
job-7675,4,6,3,383071,476449,476479,93378,30,383131,false,L-s-0 C-m-0 C-m-0 
job-7676,5,12,6,383124,476449,476498,93325,49,383349,false,C-l-1 C-l-1 C-l-0 C-l-2 C-l-0 C-l-2 
job-7674,3,6,6,383027,476449,476508,93422,59,383234,false,L-m-0 L-l-0 L-l-0 L-m-0 L-l-0 L-l-0 
job-7677,1,12,7,383172,476498,476553,93326,55,383289,false,C-l-0 L-m-0 L-s-0 C-s-1 C-l-0 C-l-0 C-l-0 
job-7678,1,9,5,383222,476553,476576,93331,23,383384,false,L-l-0 L-l-0 L-l-0 L-l-0 L-l-0 
job-7679,5,6,7,383277,476553,476578,93276,25,383596,false,C-l-0 C-l-0 C-l-1 C-l-2 C-l-1 C-l-2 L-m-0 
job-7680,2,5,6,383323,476553,476881,93230,328,383813,false,L-s-0 C-l-2 C-l-0 L-m-0 C-l-1 L-s-0 
job-7681,3,7,5,383371,476881,476973,93510,92,383685,false,L-l-0 L-s-0 L-l-0 L-l-0 L-l-0 
job-7682,1,9,1,383429,476973,477115,93544,142,383581,false,L-s-0 
job-7683,5,4,3,383481,477115,477134,93634,19,383544,false,L-l-0 L-l-0 L-m-0 
job-7684,6,7,3,383537,477115,477135,93578,20,383693,false,C-l-0 C-l-0 C-m-0 
job-7685,1,10,1,383598,477135,477297,93537,162,383995,false,L-s-0 
job-7686,6,5,3,383643,477297,477324,93654,27,383716,false,L-l-0 L-l-0 L-m-0 
job-7688,4,8,8,383760,477297,477418,93537,121,383949,false,C-l-0 C-l-2 C-l-0 C-l-2 C-m-0 C-l-0 C-l-2 C-m-0 
job-7687,1,4,6,383713,477297,477560,93584,263,384059,false,L-s-0 L-m-0 L-m-0 L-s-0 L-s-0 L-s-0 
job-7689,1,7,5,383802,477560,477575,93758,15,383894,false,L-l-0 L-l-0 L-l-0 L-l-0 L-l-0 
job-7690,3,12,8,383852,477560,477617,93708,57,384207,false,L-l-0 C-l-0 C-l-0 L-s-0 C-l-0 L-m-0 C-l-0 L-m-0 
job-7692,2,9,7,383962,477560,477631,93598,71,384171,false,C-s-0 C-l-1 C-l-1 C-m-0 C-l-1 C-l-1 C-l-1 
job-7691,6,9,1,383898,477560,477724,93662,164,384284,false,C-m-0 
job-7693,3,6,5,383998,477560,477793,93562,233,384356,false,C-l-2 C-l-2 C-l-2 C-s-1 C-l-2 
job-7694,2,4,6,384052,477560,477895,93508,335,384551,false,C-s-0 C-m-1 L-m-0 C-m-1 C-m-1 C-m-1 
job-7695,5,9,3,384111,477793,477902,93682,109,384507,false,L-l-0 L-m-0 L-l-0 
job-7697,5,11,2,384219,477793,477939,93574,146,384433,false,C-l-0 C-l-0 
job-7698,4,12,5,384263,477895,477940,93632,45,384464,false,C-m-0 C-l-1 C-m-0 C-l-1 C-l-1 
job-7701,5,7,3,384414,477902,477955,93488,53,384485,false,C-l-2 C-l-2 L-l-0 
job-7702,6,7,4,384474,477940,477965,93466,25,384542,false,C-m-0 C-l-1 C-l-0 C-l-1 
job-7699,2,12,3,384310,477902,477979,93592,77,384576,false,L-m-0 L-m-0 C-l-0 
job-7703,3,12,5,384533,477940,477992,93407,52,384683,false,C-m-2 C-m-1 C-m-2 C-m-1 C-l-0 
job-7704,5,4,7,384582,477965,478003,93383,38,384730,false,C-m-0 C-l-2 C-l-0 C-l-1 C-l-2 L-l-0 C-l-1 
job-7696,3,10,1,384169,477793,478008,93624,215,384660,false,L-s-0 
job-7700,5,10,1,384357,477902,478050,93545,148,384777,false,L-l-0 
job-7705,2,12,1,384628,478050,478189,93422,139,384866,false,L-s-0 
job-7706,6,4,1,384672,478189,478209,93517,20,384921,false,L-m-0 
job-7708,1,12,7,384777,478189,478303,93412,114,385085,false,C-l-0 C-l-0 C-l-0 L-l-0 C-l-0 L-l-0 L-l-0 
job-7709,6,6,8,384825,478303,478317,93478,14,385095,false,L-m-0 C-l-2 C-l-0 C-l-2 C-l-0 L-l-0 L-l-0 C-m-0 
job-7707,2,4,3,384730,478189,478334,93459,145,385028,false,L-s-0 L-s-0 L-m-0 
job-7710,2,12,7,384882,478303,478428,93421,125,385246,false,C-l-1 C-l-1 C-m-0 C-m-1 C-l-1 C-l-1 C-m-1 
job-7711,2,12,3,384937,478428,478468,93491,40,385117,false,L-m-0 L-m-0 L-s-0 
job-7712,5,7,4,384998,478428,478531,93430,103,385137,false,L-l-0 C-l-0 C-l-0 L-l-0 
job-7713,6,6,7,385054,478428,478550,93374,122,385474,false,C-m-2 C-l-1 C-l-2 C-m-0 C-l-1 C-l-2 C-m-1 
job-7716,5,6,4,385186,478550,478699,93364,149,385522,false,C-l-0 C-l-0 C-l-1 C-l-1 
job-7718,6,6,6,385290,478699,478739,93409,40,385349,false,C-l-0 C-l-2 C-l-0 C-l-1 C-l-1 C-l-2 
job-7715,4,4,2,385140,478550,478767,93410,217,385447,false,L-m-0 L-m-0 
job-7717,1,11,2,385242,478699,478797,93457,98,385480,false,L-s-0 C-s-1 
job-7714,1,8,6,385100,478550,478823,93450,273,385421,false,L-l-0 L-l-0 L-l-0 L-l-0 L-l-0 L-l-0 
job-7719,1,4,3,385331,478699,479138,93368,439,385971,false,C-s-0 C-s-1 L-s-0 
job-7720,4,10,5,385388,479138,479203,93750,65,385473,false,L-m-0 L-l-0 L-l-0 L-l-0 L-m-0 
job-7723,3,8,1,385557,479138,479205,93581,67,385664,false,C-s-2 
job-7722,6,4,1,385501,479138,479210,93637,72,385763,false,C-m-0 
job-7721,4,8,1,385446,479138,479221,93692,83,385594,false,L-s-0 
job-7725,3,6,7,385651,479210,479242,93559,32,385958,false,L-m-0 L-l-0 L-l-0 C-s-1 L-l-0 L-l-0 L-m-0 
job-7724,6,4,4,385608,479138,479251,93530,113,385896,false,C-l-0 C-l-0 C-l-1 C-l-1 
job-7726,5,11,7,385701,479242,479450,93541,208,386064,false,C-m-1 L-l-0 L-l-0 C-m-0 C-l-2 C-l-2 L-m-0 
job-7728,4,7,7,385807,479450,479502,93643,52,386097,false,L-s-0 C-l-2 C-l-2 L-l-0 C-l-2 L-l-0 L-l-0 
job-7727,4,5,2,385752,479450,479519,93698,69,385870,false,L-m-0 L-m-0 
job-7729,5,4,5,385857,479450,479542,93593,92,386173,false,C-m-0 C-l-1 C-l-0 C-l-0 C-l-1 
job-7731,3,8,6,385954,479542,479567,93588,25,386278,false,L-s-0 L-l-0 L-l-0 C-s-1 L-l-0 L-l-0 
job-7732,2,12,5,386002,479542,479605,93540,63,386344,false,C-s-2 C-l-0 C-l-0 C-l-0 C-l-0 
job-7730,1,5,6,385909,479542,479618,93633,76,386027,false,L-m-0 L-m-0 L-m-0 L-m-0 L-m-0 L-m-0 
job-7733,6,12,2,386057,479542,479620,93485,78,386366,false,C-l-1 C-l-1 
job-7734,2,4,5,386105,479605,479648,93500,43,386432,false,L-l-0 L-l-0 L-l-0 L-l-0 L-l-0 
job-7735,5,10,3,386159,479605,479816,93446,211,386374,false,C-m-0 C-l-0 C-l-0 
job-7736,1,12,5,386210,479816,479847,93606,31,386478,false,L-s-0 L-l-0 L-l-0 L-l-0 L-l-0 
job-7738,6,7,6,386285,479816,479848,93531,32,386385,false,C-m-2 C-l-1 C-l-2 C-m-1 C-l-1 C-l-2 
job-7737,5,7,4,386251,479816,479850,93565,34,386387,false,L-m-0 C-l-0 C-l-0 C-m-0 
job-7739,6,8,8,386342,479848,479910,93506,62,386414,false,L-l-0 L-l-0 C-l-1 C-l-2 C-l-1 C-m-2 C-l-2 C-m-1 
job-7740,3,11,4,386396,479848,479981,93452,133,386583,false,L-m-0 C-s-2 L-s-0 C-m-0 
job-7741,6,8,4,386440,479981,480013,93541,32,386737,false,L-m-0 L-l-0 L-l-0 C-m-0 
job-7742,1,6,4,386482,480013,480070,93531,57,386824,false,L-m-0 L-m-0 L-m-0 L-m-0 
job-7743,1,11,8,386545,480013,480252,93468,239,387049,false,L-l-0 C-l-0 C-l-0 C-l-0 C-l-0 L-l-0 L-l-0 L-l-0 
job-7744,5,7,1,386598,480013,480284,93415,271,387122,false,C-m-0 
job-7745,2,4,1,386652,480284,480516,93632,232,387117,false,L-s-0 
job-7746,6,6,2,386699,480284,480536,93585,252,387156,false,L-l-0 L-l-0 
job-7748,2,5,8,386797,480516,480547,93719,31,386901,false,L-m-0 L-m-0 L-m-0 C-m-0 C-m-0 C-m-0 L-m-0 C-m-0 
job-7747,4,6,1,386752,480516,480590,93764,74,386993,false,L-s-0 
job-7749,1,8,7,386851,480516,480627,93665,111,387243,false,C-l-1 C-l-1 C-l-1 C-l-1 C-l-1 C-l-1 C-s-1 
job-7750,4,5,6,386896,480590,480630,93694,40,387171,false,L-s-0 L-l-0 L-m-0 L-m-0 L-l-0 L-l-0 
job-7752,5,5,5,386987,480590,480639,93603,49,387067,false,C-m-0 C-l-2 C-l-0 C-l-2 C-l-0 
job-7751,1,7,2,386930,480590,480662,93660,72,387220,false,C-s-1 C-s-2 
job-7753,1,12,8,387041,480590,480900,93549,310,387566,false,C-m-1 C-l-2 C-l-0 C-l-0 C-l-2 C-m-0 C-m-1 C-m-0 
job-7754,2,12,2,387099,480900,480965,93801,65,387309,false,L-m-0 L-m-0 
job-7755,6,9,8,387144,480900,481055,93756,155,387391,false,C-l-0 L-l-0 C-l-0 C-l-2 C-l-1 L-l-0 C-l-2 C-l-1 
job-7756,2,7,1,387214,480965,481089,93751,124,387449,false,L-s-0 
job-7757,6,10,6,387267,481055,481175,93788,120,387518,false,L-m-0 C-l-1 L-l-0 C-m-0 C-l-1 L-l-0 
job-7758,3,6,7,387322,481175,481195,93853,20,387439,false,L-s-0 L-l-0 L-l-0 L-m-0 L-l-0 L-l-0 L-m-0 
job-7759,5,11,5,387379,481175,481205,93796,30,387498,false,C-l-0 C-l-1 C-l-0 C-m-0 C-l-1 
job-7760,4,6,2,387435,481195,481211,93760,16,387705,false,L-m-0 L-m-0 
job-7761,3,9,2,387487,481195,481313,93708,118,387666,false,L-s-0 C-m-0 
job-7763,5,6,7,387593,481313,481343,93720,30,387678,false,L-m-0 C-l-1 C-l-1 C-l-2 C-l-0 C-l-2 C-l-0 
job-7762,2,4,7,387544,481313,481349,93769,36,387582,false,L-s-0 L-s-0 L-l-0 L-l-0 L-l-0 L-l-0 L-l-0 
job-7765,6,7,8,387692,481343,481378,93651,35,387813,false,C-m-2 C-l-2 C-l-1 C-l-2 C-l-1 L-m-0 C-m-0 C-m-1 
job-7764,1,11,7,387638,481343,481473,93705,130,387772,false,L-l-0 C-l-0 C-l-0 L-m-0 C-l-0 C-l-0 L-l-0 
job-7766,5,8,4,387756,481378,481744,93622,366,388225,false,L-m-0 L-l-0 L-l-0 C-m-0 
job-7768,6,12,2,387850,481744,481758,93894,14,388083,false,C-l-0 C-l-0 
job-7767,4,5,8,387812,481744,481766,93932,22,388062,false,L-l-0 L-m-0 L-l-0 L-l-0 C-m-0 L-s-0 L-m-0 C-m-0 
job-7769,6,4,1,387911,481744,481840,93833,96,388155,false,C-m-1 
job-7770,4,6,4,387966,481840,481859,93874,19,388003,false,L-l-0 L-l-0 L-s-0 L-l-0 
job-7771,6,7,4,388023,481840,481882,93817,42,388363,false,L-m-0 C-l-1 C-l-1 C-m-0 
job-7773,6,6,7,388123,481882,482040,93759,158,388569,false,L-l-0 C-l-0 C-l-1 C-m-0 C-l-1 L-l-0 C-l-0 
job-7774,5,9,1,388178,482040,482053,93862,13,388241,false,L-l-0 
job-7775,5,5,6,388219,482040,482064,93821,24,388328,false,L-m-0 C-l-1 C-l-0 C-l-0 C-l-1 L-l-0 
job-7772,1,9,3,388070,481882,482071,93812,189,388476,false,L-m-0 L-m-0 L-m-0 
job-7776,3,6,4,388268,482040,482272,93772,232,388769,false,C-l-2 C-l-2 C-l-2 C-l-2 
job-7777,3,9,1,388317,482272,482434,93955,162,388573,false,L-s-0 
job-7778,5,7,1,388364,482272,482766,93908,494,389107,false,L-m-0 
job-7780,6,6,7,388454,482766,482780,94312,14,388653,false,C-m-0 C-l-1 C-l-0 L-l-0 C-l-0 C-l-1 L-l-0 
job-7779,6,10,1,388415,482766,482871,94351,105,388526,false,L-m-0 
job-7781,1,8,8,388507,482766,482907,94259,141,388904,false,C-s-1 L-m-0 L-s-0 C-s-1 C-m-0 C-m-0 L-s-0 L-m-0 
job-7783,4,8,4,388607,482907,482944,94300,37,388873,false,L-s-0 L-l-0 L-l-0 L-l-0 
job-7782,3,9,5,388555,482766,482951,94211,185,389013,false,C-s-2 C-l-2 C-l-2 C-l-2 C-l-2 
job-7784,4,11,4,388655,482907,482996,94252,89,388929,false,L-m-0 C-m-0 L-m-0 C-m-0 
job-7785,1,9,7,388711,482907,483023,94196,116,388887,false,C-m-1 C-l-1 C-l-1 C-m-1 C-l-1 C-l-1 C-m-1 
job-7786,3,8,1,388759,483023,483476,94264,453,389350,false,L-s-0 
job-7788,5,10,5,388875,483476,483489,94601,13,389057,false,C-l-0 C-l-1 C-l-1 C-m-0 C-l-0 
job-7787,1,12,6,388817,483476,483537,94659,61,389117,false,L-m-0 L-l-0 L-l-0 L-m-0 L-l-0 L-l-0 
job-7789,5,10,3,388924,483476,483590,94552,114,389327,false,C-m-1 C-l-2 C-l-2 
job-7791,2,12,3,389034,483537,483618,94503,81,389163,false,L-s-0 C-l-2 L-m-0 
job-7790,3,4,3,388984,483537,483618,94553,81,389354,false,L-m-0 L-m-0 C-m-1 
job-7792,6,8,3,389084,483590,483630,94506,40,389397,false,L-l-0 L-l-0 C-l-2 
job-7794,6,8,8,389191,483630,483658,94439,28,389296,false,L-l-0 C-l-2 C-l-0 C-l-1 C-l-0 L-l-0 C-l-1 C-l-2 
job-7793,2,12,3,389136,483630,483927,94494,297,389595,false,L-m-0 L-m-0 L-s-0 
job-7795,2,4,1,389228,483927,484193,94699,266,389787,false,L-s-0 
job-7796,1,10,3,389273,484193,484222,94920,29,389478,false,L-m-0 L-m-0 L-m-0 
job-7797,4,11,3,389327,484193,484327,94866,134,389497,false,L-l-0 L-l-0 L-l-0 
job-7798,4,11,2,389386,484193,484335,94807,142,389697,false,L-s-0 C-s-1 
job-7799,5,4,6,389431,484193,484412,94762,219,389788,false,C-l-0 C-l-1 C-l-0 C-l-2 C-l-1 C-l-2 
job-7800,6,4,2,389471,484193,484709,94722,516,390255,false,C-m-1 C-m-0 
job-7801,6,4,4,389517,484709,484736,95192,27,389604,false,L-m-0 L-l-0 L-l-0 C-m-0 
job-7802,2,9,2,389571,484736,484747,95165,11,389833,false,L-m-0 L-m-0 
job-7804,6,12,6,389676,484736,484822,95060,86,389861,false,L-l-0 C-l-0 C-l-1 C-m-0 C-l-0 C-l-1 
job-7805,6,5,4,389721,484736,484919,95015,183,390130,false,C-m-2 C-l-2 C-l-2 C-m-1 
job-7803,5,8,1,389629,484736,484922,95107,186,389907,false,L-l-0 
job-7806,5,4,6,389786,484822,485115,95036,293,390092,false,L-m-0 C-l-1 L-l-0 C-l-1 C-l-0 C-l-0 
job-7807,3,8,3,389829,485115,485282,95286,167,390235,false,L-m-0 L-m-0 L-s-0 
job-7809,4,10,5,389935,485282,485310,95347,28,390124,false,L-l-0 L-l-0 L-m-0 L-m-0 L-l-0 
job-7810,1,11,5,390000,485282,485319,95282,37,390200,false,C-s-1 C-l-0 C-l-0 C-l-0 C-l-0 
job-7808,1,4,2,389877,485282,485370,95405,88,390236,false,L-s-0 L-s-0 
job-7811,5,5,4,390056,485282,485421,95226,139,390399,false,C-l-2 C-l-1 C-l-1 C-l-2 
job-7812,6,5,3,390117,485282,485466,95165,184,390521,false,C-m-2 C-m-0 C-m-1 
job-7813,2,9,8,390168,485421,485470,95253,49,390258,false,L-l-0 L-l-0 L-l-0 C-m-0 C-m-1 L-l-0 L-l-0 C-m-2 
job-7815,5,8,3,390272,485421,485532,95149,111,390530,false,C-l-0 C-l-0 C-l-1 
job-7814,4,11,3,390224,485421,485605,95197,184,390646,false,L-s-0 L-m-0 L-m-0 
job-7818,4,7,6,390418,485605,485632,95187,27,390550,false,C-l-0 C-l-2 C-l-0 C-l-2 C-l-0 C-l-2 
job-7817,3,5,8,390365,485605,485633,95240,28,390496,false,L-m-0 L-l-0 L-l-0 L-l-0 L-l-0 C-m-0 L-m-0 C-m-0 
job-7816,2,4,2,390311,485605,485640,95294,35,390614,false,L-s-0 L-s-0 
job-7819,3,7,2,390466,485605,485715,95139,110,390653,false,C-m-1 C-m-1 
job-7820,4,5,3,390508,485715,485727,95207,12,390758,false,L-l-0 L-l-0 L-l-0 
job-7822,5,12,8,390607,485727,485760,95120,33,390927,false,L-l-0 C-l-1 C-l-2 C-l-2 C-l-1 L-l-0 C-m-0 C-m-1 
job-7821,3,9,6,390556,485715,485784,95159,69,390831,false,L-m-0 C-l-0 C-l-0 L-m-0 C-l-0 C-l-0 
job-7823,6,5,1,390664,485727,485865,95063,138,391031,false,C-m-2 
job-7825,3,7,7,390790,485865,485875,95075,10,390936,false,L-m-0 L-l-0 L-l-0 L-m-0 L-l-0 L-l-0 C-s-1 
job-7824,1,10,1,390714,485865,485908,95151,43,390784,false,L-s-0 
job-7826,4,10,1,390842,485865,486105,95023,240,391092,false,C-s-2 
job-7827,1,9,5,390896,486105,486179,95209,74,391233,false,L-l-0 L-l-0 L-l-0 L-l-0 L-l-0 
job-7829,2,6,7,391002,486105,486329,95103,224,391319,false,L-s-0 L-m-0 L-m-0 C-s-2 L-m-0 L-m-0 C-s-2 
job-7828,2,7,1,390940,486105,486392,95165,287,391273,false,L-s-0 
job-7831,1,7,4,391110,486392,486479,95282,87,391460,false,L-m-0 C-l-0 L-m-0 L-m-0 
job-7830,2,12,3,391064,486105,486485,95041,380,391509,false,C-l-0 C-l-0 C-l-0 
job-7832,5,5,8,391175,486392,486607,95217,215,391549,false,L-m-0 L-l-0 C-l-2 C-l-1 C-l-1 C-l-0 C-l-2 L-l-0 
job-7835,4,9,7,391344,486607,486648,95263,41,391638,false,C-m-0 C-l-1 C-l-1 C-m-1 C-m-0 C-l-1 C-m-1 
job-7834,6,5,4,391281,486607,486680,95326,73,391584,false,L-m-0 L-l-0 C-l-0 C-l-0 
job-7837,5,4,3,391439,486648,486689,95209,41,391694,false,C-m-1 C-l-1 C-l-1 
job-7836,6,11,1,391392,486648,486694,95256,46,391732,false,C-m-0 
job-7833,1,8,7,391232,486607,486742,95375,135,391369,false,L-s-0 L-s-0 L-l-0 L-l-0 L-l-0 L-l-0 L-l-0 
job-7838,2,9,6,391483,486648,486815,95165,167,391689,false,C-m-0 C-s-1 C-s-2 C-m-1 C-l-1 L-m-0 
job-7839,2,8,1,391524,486815,486894,95291,79,391822,false,L-s-0 
job-7840,6,9,8,391579,486815,486925,95236,110,391937,false,L-l-0 C-l-1 C-l-2 C-l-2 C-l-1 L-l-0 C-m-0 L-m-0 
job-7842,1,8,8,391682,486815,486971,95133,156,391901,false,L-m-0 C-m-1 C-m-1 L-s-0 L-m-0 C-m-0 C-m-1 C-m-0 
job-7843,6,10,7,391732,486925,486998,95193,73,391810,false,C-m-2 L-l-0 C-l-1 C-m-0 C-l-1 L-l-0 L-m-0 
job-7844,4,12,8,391775,486971,487006,95196,35,392024,false,C-s-1 C-l-2 C-s-2 C-l-2 C-l-2 C-m-1 L-s-0 C-m-1 
job-7841,4,6,3,391626,486815,487059,95189,244,391885,false,C-l-0 C-l-0 C-l-0 
job-7846,6,6,1,391879,487059,487131,95180,72,392232,false,C-m-0 
job-7845,6,9,5,391822,486998,487143,95176,145,392204,false,L-m-0 L-l-0 C-l-1 C-l-1 L-l-0 
job-7848,6,8,7,391980,487143,487320,95163,177,392212,false,L-m-0 C-l-0 C-l-1 L-l-0 C-l-1 L-l-0 C-l-0 
job-7849,6,4,4,392019,487320,487403,95301,83,392358,false,L-m-0 L-l-0 L-l-0 C-m-0 
job-7847,1,12,1,391930,487143,487451,95213,308,392329,false,L-s-0 
job-7850,5,6,2,392062,487320,487461,95258,141,392311,false,C-l-0 C-l-0 
job-7853,5,6,6,392230,487451,487496,95221,45,392532,false,C-m-1 C-l-2 L-l-0 C-m-0 C-l-2 L-l-0 
job-7851,5,6,2,392115,487320,487550,95205,230,392522,false,C-l-1 C-l-1 
job-7852,4,5,1,392168,487403,487572,95235,169,392486,false,L-m-0 
job-7854,6,6,7,392285,487496,487647,95211,151,392692,false,C-m-0 C-l-2 C-l-0 C-l-2 C-l-0 L-l-0 L-l-0 
job-7855,5,5,2,392348,487496,487656,95148,160,392805,false,C-m-2 C-m-1 
job-7857,5,4,7,392466,487656,487702,95190,46,392630,false,L-l-0 C-l-0 C-l-1 L-m-0 C-l-1 L-l-0 C-l-0 
job-7856,3,11,1,392403,487656,487874,95253,218,392728,false,L-s-0 
job-7858,2,8,6,392519,487874,487897,95355,23,392700,false,L-l-0 L-l-0 L-l-0 L-l-0 L-l-0 L-l-0 
job-7859,3,12,3,392568,487897,487907,95329,10,392588,false,L-m-0 L-m-0 L-s-0 
job-7860,4,5,8,392613,487897,487979,95284,82,392702,false,L-l-0 L-l-0 C-l-0 C-l-0 C-l-0 L-l-0 C-m-0 C-m-0 
job-7861,6,4,2,392656,487897,487981,95241,84,392752,false,C-l-1 C-l-1 
job-7862,4,4,2,392698,487979,488013,95281,34,392988,false,L-m-0 L-m-0 
job-7865,6,9,8,392846,487981,488060,95135,79,393104,false,C-l-0 C-l-2 C-l-0 C-l-1 C-l-2 C-m-1 C-l-1 C-m-2 
job-7863,1,7,6,392739,487979,488078,95240,99,393028,false,L-l-0 L-l-0 L-l-0 L-l-0 L-l-0 L-l-0 
job-7864,6,10,1,392795,487979,488083,95184,104,392959,false,C-m-0 
job-7866,5,4,8,392894,488060,488207,95166,147,393220,false,C-l-2 C-l-1 C-l-0 C-l-1 C-l-0 L-l-0 C-l-2 L-m-0 
job-7867,4,9,6,392950,488207,488238,95257,31,393249,false,L-m-0 L-s-0 L-l-0 L-l-0 L-m-0 L-l-0 
job-7868,2,11,6,392999,488207,488275,95208,68,393216,false,C-m-0 C-l-1 C-l-1 C-m-0 C-l-1 C-l-1 
job-7870,1,10,8,393096,488207,488395,95111,188,393527,false,C-l-0 C-l-0 C-m-2 C-l-0 C-l-0 C-m-0 C-m-2 C-m-1 
job-7869,1,11,2,393048,488207,488408,95159,201,393469,false,C-m-1 C-m-1 
job-7871,3,11,5,393150,488207,488436,95057,229,393614,false,C-l-2 C-l-2 C-l-2 C-m-2 C-l-2 
job-7872,4,4,7,393191,488395,488464,95204,69,393411,false,C-m-1 L-l-0 C-m-2 L-m-0 L-l-0 L-l-0 L-m-0 
job-7873,6,4,6,393241,488436,488503,95195,67,393436,false,C-l-1 C-l-2 C-l-0 C-l-2 C-l-1 C-l-0 
job-7874,2,6,8,393284,488436,488549,95152,113,393564,false,C-s-2 L-s-0 L-s-0 C-m-1 C-m-1 C-m-2 C-s-2 C-m-2 
job-7875,6,5,7,393335,488503,488730,95168,227,393821,false,C-l-0 C-l-1 C-l-0 L-m-0 C-l-1 L-l-0 L-l-0 
job-7876,5,7,6,393387,488730,488775,95343,45,393434,false,L-m-0 C-l-0 C-l-0 C-m-0 L-l-0 L-l-0 
job-7877,3,6,7,393429,488730,488864,95301,134,393634,false,L-s-0 C-l-1 C-l-1 C-m-0 C-l-1 C-l-1 L-m-0 
job-7879,4,10,5,393529,488864,488939,95335,75,393694,false,L-s-0 L-l-0 L-l-0 L-m-0 L-l-0 
job-7878,1,9,2,393478,488864,488940,95386,76,393629,false,L-m-0 L-m-0 
job-7881,5,12,3,393637,488864,489060,95227,196,394130,false,C-m-0 C-l-1 C-l-1 
job-7880,5,11,4,393575,488864,489129,95289,265,393903,false,C-l-2 C-l-0 C-l-0 C-l-2 
job-7882,1,5,4,393695,489129,489181,95434,52,394043,false,L-m-0 L-m-0 L-m-0 L-m-0 
job-7884,6,6,1,393804,489129,489208,95325,79,394169,false,C-m-0 
job-7883,4,12,3,393747,489129,489279,95382,150,393988,false,L-l-0 L-l-0 L-m-0 
job-7886,6,10,1,393894,489279,489364,95385,85,394079,false,L-m-0 
job-7885,4,8,1,393854,489279,489365,95425,86,394011,false,L-s-0 
job-7887,5,8,5,393949,489279,489426,95330,147,394167,false,L-l-0 L-l-0 C-l-0 C-m-0 C-l-0 
job-7889,3,8,4,394067,489426,489486,95359,60,394140,false,L-m-0 L-l-0 L-l-0 L-l-0 
job-7888,2,11,2,394005,489426,489538,95421,112,394354,false,L-m-0 L-m-0 
job-7890,5,10,8,394134,489426,489598,95292,172,394523,false,C-m-0 C-l-2 C-l-0 C-l-1 C-l-1 C-l-2 C-l-0 C-m-1 
job-7891,5,6,4,394192,489538,489723,95346,185,394565,false,L-m-0 L-l-0 L-l-0 C-m-2 
job-7892,6,10,3,394242,489598,489728,95356,130,394442,false,C-m-0 C-l-0 C-l-0 
job-7893,1,8,6,394296,489723,489887,95427,164,394706,false,L-m-0 C-m-0 C-m-0 L-m-0 L-m-0 L-m-0 
job-7894,1,4,7,394345,489887,489989,95542,102,394608,false,L-m-0 L-m-0 L-m-0 L-m-0 L-m-0 L-m-0 L-m-0 
job-7895,6,5,2,394394,489989,490019,95595,30,394636,false,L-l-0 L-l-0 
job-7896,1,12,8,394450,489989,490055,95539,66,394716,false,L-s-0 C-l-0 C-l-0 C-l-0 C-l-0 L-m-0 C-s-1 L-m-0 
job-7897,3,7,2,394518,490055,490075,95537,20,394656,false,L-m-0 L-m-0 
job-7899,6,11,4,394618,490075,490147,95457,72,394888,false,L-m-0 C-l-0 C-l-0 C-m-1 
job-7898,6,11,7,394568,490055,490188,95487,133,394852,false,C-m-0 C-l-1 L-l-0 C-l-2 C-l-1 L-l-0 C-l-2 
job-7900,2,9,4,394677,490188,490214,95511,26,394773,false,L-l-0 L-l-0 L-l-0 L-l-0 
job-7901,1,4,7,394725,490188,490262,95463,74,394897,false,L-l-0 L-s-0 L-l-0 L-s-0 L-s-0 L-s-0 L-l-0 
job-7902,3,10,4,394774,490188,490349,95414,161,395141,false,L-m-0 C-m-1 L-m-0 C-m-1 
job-7904,4,8,7,394879,490349,490377,95470,28,395032,false,C-m-0 L-s-0 L-m-0 C-m-0 L-l-0 L-l-0 L-l-0 
job-7905,4,7,6,394926,490349,490512,95423,163,395360,false,C-l-0 C-l-0 C-l-1 C-l-1 C-l-0 C-l-1 
job-7906,2,12,7,394974,490512,490528,95538,16,395054,false,L-s-0 L-l-0 L-l-0 C-m-0 L-l-0 L-l-0 C-m-0 
job-7903,1,6,4,394821,490349,490530,95528,181,395142,false,L-m-0 L-m-0 L-m-0 L-m-0 
job-7908,3,5,6,395077,490512,490576,95435,64,395333,false,C-l-1 C-l-1 C-l-1 C-m-0 C-l-1 L-m-0 
job-7907,5,4,2,395025,490512,490596,95487,84,395174,false,C-l-0 C-l-0 
job-7910,2,10,7,395166,490576,490600,95410,24,395470,false,L-m-0 L-l-0 L-l-0 C-l-0 L-l-0 L-l-0 L-m-0 
job-7909,4,8,1,395120,490512,490624,95392,112,395516,false,C-s-1 
job-7911,1,7,6,395221,490576,490677,95355,101,395545,false,L-s-0 C-s-2 C-s-2 L-s-0 L-l-0 L-m-0 
job-7912,6,8,4,395260,490677,490695,95417,18,395309,false,L-m-0 L-l-0 L-l-0 C-m-0 
job-7913,5,10,6,395315,490677,490736,95362,59,395473,false,C-l-2 C-l-1 C-l-0 C-l-2 C-l-1 C-l-0 
job-7914,1,5,6,395361,490736,490795,95375,59,395468,false,L-m-0 L-m-0 L-m-0 L-m-0 L-m-0 L-m-0 
job-7915,2,7,2,395418,490795,490834,95377,39,395493,false,L-s-0 L-s-0 
job-7916,3,7,4,395470,490795,490848,95325,53,395589,false,L-l-0 L-l-0 L-l-0 L-l-0 
job-7917,1,12,5,395517,490795,490982,95278,187,395888,false,C-l-0 C-l-0 C-l-0 C-l-0 L-m-0 
job-7919,3,6,3,395623,490982,491012,95359,30,395677,false,L-m-0 L-l-0 L-l-0 
job-7918,4,9,2,395575,490795,491020,95220,225,395974,false,C-s-1 L-m-0 
job-7920,1,11,4,395678,491012,491320,95334,308,396024,false,L-m-0 L-l-0 L-l-0 L-m-0 
job-7921,4,8,3,395729,491320,491413,95591,93,396010,false,L-l-0 L-l-0 L-l-0 
job-7922,3,5,4,395769,491413,491424,95644,11,395921,false,L-l-0 L-l-0 L-l-0 L-l-0 
job-7924,6,11,4,395881,491413,491448,95532,35,396092,false,C-l-0 C-l-1 C-l-0 C-l-1 
job-7925,6,11,3,395932,491413,491471,95481,58,396276,false,C-l-2 C-l-2 C-m-0 
job-7923,1,11,2,395826,491413,491614,95587,201,396112,false,L-m-0 L-m-0 
job-7926,4,9,3,395987,491413,491943,95426,530,396793,false,L-s-0 C-s-1 L-m-0 
job-7927,5,4,5,396041,491943,491956,95902,13,396075,false,L-l-0 L-l-0 C-l-0 L-m-0 C-l-0 
job-7929,5,5,7,396148,491956,492039,95808,83,396311,false,L-l-0 L-l-0 C-l-0 C-l-2 C-l-0 C-l-2 L-m-0 
job-7928,4,5,5,396094,491943,492065,95849,122,396347,false,C-s-1 C-l-1 C-l-1 L-s-0 C-l-1 
job-7930,2,12,3,396208,492039,492071,95831,32,396494,false,L-l-0 L-l-0 L-l-0 
job-7931,3,12,5,396254,492039,492092,95785,53,396525,false,C-m-0 L-m-0 L-m-0 L-l-0 C-m-0 
job-7932,1,6,7,396309,492039,492132,95730,93,396411,false,L-m-0 C-m-1 C-m-1 C-m-0 C-m-1 C-m-1 C-m-1 
job-7933,5,12,2,396357,492132,492146,95775,14,396644,false,L-l-0 L-l-0 
job-7937,5,6,3,396548,492146,492236,95598,90,396638,false,C-m-0 C-l-0 C-l-0 
job-7934,1,4,2,396406,492146,492253,95740,107,396768,false,L-s-0 L-s-0 
job-7936,3,5,3,396494,492146,492281,95652,135,396906,false,C-s-1 L-m-0 L-m-0 
job-7935,5,10,2,396447,492146,492412,95699,266,396909,false,L-l-0 L-l-0 
job-7938,3,6,6,396599,492412,492429,95813,17,396860,false,L-m-0 L-l-0 L-l-0 L-m-0 L-l-0 L-l-0 
job-7940,5,8,7,396705,492412,492484,95707,72,396966,false,C-m-1 C-l-1 C-l-0 C-l-2 C-l-1 C-l-2 C-l-0 
job-7939,3,4,3,396656,492412,492507,95756,95,396760,false,L-s-0 C-m-0 C-m-0 
job-7941,6,8,7,396752,492484,492558,95732,74,396901,false,L-l-0 C-l-2 C-l-0 L-l-0 C-l-0 C-l-2 L-m-0 
job-7942,3,12,7,396799,492484,492665,95685,181,397195,false,C-m-1 C-l-1 C-l-1 C-m-1 C-l-1 C-l-1 C-s-1 
job-7944,6,7,5,396891,492665,492689,95774,24,396951,false,L-m-0 L-l-0 L-l-0 C-m-0 C-m-1 
job-7943,2,6,2,396848,492558,492699,95710,141,397207,false,L-s-0 C-m-1 
job-7945,1,10,6,396923,492665,492739,95742,74,397185,false,L-s-0 C-m-0 C-s-1 L-m-0 C-m-0 L-m-0 
job-7946,4,8,2,396969,492739,492765,95770,26,397208,false,L-m-0 L-m-0 
job-7947,6,8,5,397017,492739,492893,95722,154,397371,false,L-l-0 C-l-1 L-l-0 C-m-0 C-l-1 
job-7948,6,8,3,397066,492893,492950,95827,57,397128,false,L-l-0 L-l-0 L-m-0 
job-7949,5,11,6,397123,492893,492980,95770,87,397333,false,C-l-1 C-l-0 C-l-0 C-l-2 C-l-1 C-l-2 
job-7950,2,9,4,397176,492950,493069,95774,119,397413,false,L-s-0 C-l-0 C-l-1 C-l-2 
job-7951,1,10,3,397226,493069,493094,95843,25,397423,false,L-m-0 L-m-0 L-m-0 
job-7952,3,8,6,397279,493069,493100,95790,31,397463,false,L-s-0 L-l-0 L-l-0 C-s-1 L-l-0 L-l-0 
job-7953,6,11,1,397334,493069,493178,95735,109,397715,false,C-m-0 
job-7954,5,10,4,397381,493178,493193,95797,15,397513,false,L-m-0 L-l-0 L-l-0 C-m-0 
job-7955,1,12,3,397431,493193,493245,95762,52,397767,false,L-l-0 L-l-0 L-l-0 
job-7956,4,12,5,397487,493245,493258,95758,13,397516,false,L-m-0 L-l-0 L-l-0 L-l-0 L-m-0 
job-7957,4,11,8,397542,493245,493412,95703,167,397913,false,C-s-1 C-m-1 C-l-1 C-s-0 C-l-1 L-s-0 C-m-1 C-l-1 
job-7958,3,10,7,397584,493245,493525,95661,280,398051,false,C-s-2 C-l-0 C-l-0 C-m-0 C-l-0 C-l-0 C-m-0 
job-7959,3,6,5,397634,493525,493554,95891,29,397819,false,L-s-0 L-l-0 L-l-0 L-l-0 L-l-0 
job-7961,4,7,2,397729,493525,493599,95796,74,397895,false,C-m-0 C-m-0 
job-7960,4,10,2,397691,493525,493636,95834,111,397814,false,L-m-0 L-m-0 
job-7962,4,7,8,397784,493525,494066,95741,541,398487,false,C-l-2 C-l-1 C-l-2 C-l-1 C-l-1 C-m-1 C-l-2 C-m-1 
job-7963,2,6,4,397830,494066,494128,96236,62,397965,false,L-m-0 L-m-0 L-m-0 L-m-0 
job-7964,3,9,3,397875,494066,494297,96191,231,398281,false,L-l-0 L-l-0 L-l-0 
job-7966,6,7,6,397980,494297,494354,96317,57,398116,false,L-m-0 L-l-0 C-l-1 C-m-0 C-l-1 L-l-0 
job-7965,2,11,1,397930,494297,494401,96367,104,398326,false,L-s-0 
job-7967,2,8,1,398031,494401,494412,96370,11,398145,false,L-s-0 
job-7968,4,9,3,398087,494401,494420,96314,19,398194,false,L-l-0 L-l-0 L-l-0 
job-7969,1,8,6,398137,494401,494527,96264,126,398263,false,C-s-1 L-s-0 L-m-0 C-s-1 L-m-0 L-m-0 
job-7970,2,4,3,398185,494527,494556,96342,29,398421,false,L-m-0 L-m-0 L-m-0 
job-7972,6,11,7,398272,494527,494566,96255,39,398520,false,C-l-0 C-l-2 C-l-0 L-l-0 L-l-0 C-l-2 C-m-0 
job-7974,1,12,4,398368,494527,494576,96159,49,398593,false,C-m-2 C-s-1 C-m-1 C-m-2 
job-7973,2,9,8,398317,494527,494583,96210,56,398530,false,C-l-1 C-m-0 C-l-1 C-l-1 C-l-1 C-m-1 C-l-1 C-m-1 
job-7971,1,4,6,398236,494527,494617,96291,90,398541,false,L-s-0 L-m-0 L-m-0 L-s-0 L-s-0 L-s-0 
job-7975,6,12,2,398424,494583,494714,96159,131,398804,false,L-l-0 L-m-0 
job-7976,6,8,6,398472,494583,494727,96111,144,398685,false,L-l-0 C-l-2 C-l-2 C-m-0 C-l-0 C-l-0 
job-7977,6,9,5,398521,494714,495002,96193,288,398941,false,C-m-1 C-l-1 C-l-1 L-l-0 L-m-0 
job-7982,1,10,6,398762,495002,495107,96240,105,399076,false,C-m-1 C-l-0 C-l-0 C-m-1 C-l-0 C-m-2 
job-7981,3,7,4,398717,495002,495111,96285,109,398942,false,C-m-0 C-m-2 C-m-2 L-m-0 
job-7979,2,11,5,398630,495002,495115,96372,113,398769,false,L-m-0 L-m-0 L-s-0 C-m-0 C-m-0 
job-7980,6,7,1,398681,495002,495138,96321,136,398899,false,C-m-1 
job-7978,2,5,6,398568,495002,495186,96434,184,398865,false,L-l-0 L-l-0 L-l-0 L-l-0 L-l-0 L-l-0 
job-7983,2,12,5,398809,495002,495197,96193,195,399273,false,C-l-1 C-l-1 C-l-1 C-l-0 C-l-1 
job-7984,1,11,7,398854,495186,495232,96332,46,399111,false,L-l-0 L-l-0 C-l-0 C-l-0 L-l-0 L-l-0 C-l-0 
job-7985,3,7,2,398900,495232,495252,96332,20,399120,false,L-m-0 L-m-0 
job-7987,6,12,6,399001,495252,495269,96251,17,399272,false,L-m-0 C-l-2 C-l-1 C-m-1 C-l-1 C-l-2 
job-7986,6,4,5,398946,495232,495283,96286,51,399023,false,L-l-0 L-l-0 C-l-0 C-m-0 C-l-0 
job-7988,1,10,1,399060,495283,495293,96223,10,399233,false,L-s-0 
job-7989,5,6,8,399118,495283,495462,96165,179,399558,false,C-m-0 L-l-0 C-l-0 C-l-1 C-l-1 L-l-0 C-l-0 L-m-0 
job-7990,5,8,5,399165,495462,495530,96297,68,399276,false,L-l-0 L-l-0 C-l-0 L-m-0 C-l-0 
job-7991,3,7,3,399212,495462,495535,96250,73,399478,false,L-s-0 L-m-0 C-s-1 
job-7993,5,4,4,399309,495530,495623,96221,93,399601,false,L-m-0 L-l-0 L-l-0 C-m-1 
job-7992,5,12,5,399257,495462,495628,96205,166,399690,false,C-m-0 C-l-2 C-l-1 C-l-1 C-l-2 
job-7995,4,9,6,399419,495628,495668,96209,40,399617,false,L-m-0 C-l-0 C-l-0 L-m-0 C-l-0 C-s-1 
job-7994,1,11,5,399359,495628,495718,96269,90,399647,false,L-s-0 L-l-0 L-l-0 L-l-0 L-l-0 
job-7996,6,4,6,399461,495628,495766,96167,138,399802,false,L-l-0 C-l-1 C-l-1 C-m-0 C-l-2 C-l-2 
job-7997,4,4,1,399504,495766,495777,96262,11,399683,false,L-s-0 
job-7999,3,11,5,399597,495766,495845,96169,79,399876,false,L-m-0 C-l-1 C-l-1 C-l-1 C-l-1 
job-7998,5,8,5,399544,495766,495849,96222,83,399872,false,L-m-0 L-l-0 C-l-0 L-l-0 C-l-0 
job-8000,3,5,7,399651,495766,495917,96115,151,400095,false,C-s-1 C-l-2 C-l-2 C-m-0 C-l-2 C-l-2 C-m-0 
job-8001,3,8,7,399709,495917,495956,96208,39,399887,false,L-s-0 L-l-0 L-l-0 L-m-0 L-l-0 L-l-0 L-m-0 
job-8002,3,6,4,399769,495917,496108,96148,191,400244,false,C-l-2 C-l-2 C-l-2 C-l-2 
job-8003,3,10,3,399822,495917,496406,96095,489,400603,false,C-m-2 C-s-0 C-m-2 
job-8004,1,6,6,399877,496406,496432,96529,26,400106,false,L-l-0 L-l-0 L-l-0 L-l-0 L-l-0 L-l-0 
job-8006,3,9,3,399966,496406,496470,96440,64,400194,false,L-s-0 C-m-1 C-m-1 
job-8005,6,5,2,399917,496406,496569,96489,163,400369,false,L-m-0 L-l-0 
job-8007,2,5,8,400017,496569,496598,96552,29,400167,false,L-l-0 L-s-0 L-l-0 L-l-0 L-l-0 L-s-0 L-l-0 L-l-0 
job-8008,6,4,7,400070,496569,496651,96499,82,400300,false,C-l-0 C-l-2 C-l-1 C-l-0 C-l-1 C-l-2 L-m-0 
job-8009,5,6,4,400130,496598,496835,96468,237,400657,false,C-m-1 L-l-0 L-l-0 C-m-0 
job-8010,2,6,4,400176,496651,496843,96475,192,400404,false,C-m-0 L-l-0 L-s-0 C-m-1 
job-8011,3,4,4,400231,496843,496919,96612,76,400373,false,L-l-0 L-l-0 L-l-0 L-l-0 
job-8014,3,9,2,400378,496843,496971,96465,128,400709,false,C-m-0 C-m-0 
job-8013,2,9,8,400320,496843,497024,96523,181,400773,false,L-m-0 C-l-0 C-l-0 C-l-0 C-l-0 L-m-0 C-l-0 L-m-0 
job-8012,4,4,1,400275,496843,497029,96568,186,400483,false,L-s-0 
job-8016,5,10,7,400496,497024,497068,96528,44,400648,false,L-l-0 C-l-1 L-l-0 C-l-0 C-l-0 C-l-1 L-m-0 
job-8015,4,9,5,400435,496843,497077,96408,234,400939,false,C-m-1 C-l-2 C-l-2 C-m-1 C-l-2 
job-8017,4,10,4,400557,497068,497082,96511,14,400576,false,L-l-0 L-l-0 L-s-0 L-l-0 
job-8018,1,11,6,400609,497068,497140,96459,72,400952,false,L-m-0 C-l-0 C-l-0 L-m-0 C-l-0 C-l-0 
job-8019,6,7,6,400661,497077,497445,96416,368,401267,false,L-m-0 C-l-1 C-l-1 C-m-0 C-l-2 C-l-2 
job-8021,3,9,3,400761,497445,497515,96684,70,400864,false,L-l-0 L-l-0 L-l-0 
job-8020,2,8,2,400711,497445,497569,96734,124,400863,false,L-s-0 L-s-0 
job-8022,2,5,1,400807,497569,497584,96762,15,401056,false,L-s-0 
job-8024,5,12,7,400907,497569,497620,96662,51,400971,false,L-m-0 C-l-1 C-l-0 C-l-2 C-l-1 C-l-0 C-l-2 
job-8023,3,11,3,400854,497569,497645,96715,76,401175,false,L-l-0 L-l-0 L-l-0 
job-8025,2,7,1,400959,497645,498371,96686,726,401846,false,L-s-0 
job-8026,1,7,4,400994,498371,498417,97377,46,401132,false,L-m-0 L-m-0 L-m-0 L-m-0 
job-8027,3,11,1,401061,498371,498499,97310,128,401471,false,L-s-0 
job-8028,1,5,2,401108,498371,498505,97263,134,401424,false,L-s-0 L-l-0 
job-8029,6,10,7,401155,498371,498721,97216,350,401532,false,L-l-0 C-l-1 C-l-0 C-l-2 C-l-1 C-l-2 C-l-0 
job-8030,1,9,1,401205,498721,498796,97516,75,401454,false,L-s-0 
job-8031,5,6,6,401253,498721,498818,97468,97,401461,false,L-m-0 C-l-0 C-l-0 C-m-0 L-l-0 L-l-0 
job-8033,4,9,8,401361,498818,498922,97457,104,401521,false,C-l-0 C-l-0 C-l-1 C-l-0 C-l-1 C-l-1 L-s-0 L-m-0 
job-8032,1,10,6,401309,498818,498994,97509,176,401533,false,L-m-0 L-l-0 L-l-0 L-m-0 L-l-0 L-l-0 
job-8035,3,10,3,401475,498994,499127,97519,133,401683,false,L-l-0 L-l-0 L-l-0 
job-8037,6,10,5,401574,499127,499139,97553,12,401766,false,L-l-0 C-l-1 L-l-0 C-m-0 C-l-1 
job-8038,6,5,6,401619,499127,499159,97508,32,401945,false,C-m-1 C-l-0 C-l-2 C-m-2 C-l-0 C-l-2 
job-8039,5,9,8,401665,499159,499199,97494,40,401886,false,C-l-1 C-l-2 C-l-1 C-l-2 C-l-0 L-l-0 C-l-0 L-l-0 
job-8034,4,5,1,401422,498994,499200,97572,206,401643,false,L-s-0 
job-8036,1,4,6,401524,499127,499217,97603,90,401689,false,L-m-0 L-m-0 L-m-0 L-m-0 L-m-0 L-m-0 
job-8041,6,4,2,401764,499217,499262,97453,45,401864,false,C-m-0 L-m-0 
job-8040,6,10,8,401715,499199,499265,97484,66,402074,false,L-l-0 C-l-1 C-l-0 C-l-2 C-l-1 L-l-0 C-l-2 C-l-0 
job-8042,2,9,7,401814,499217,499268,97403,51,401986,false,L-m-0 C-m-0 L-s-0 C-m-1 C-m-1 C-s-1 C-m-1 
job-8043,5,10,2,401860,499268,499289,97408,21,401959,false,L-l-0 L-l-0 
job-8044,1,4,3,401918,499268,499402,97350,134,402108,false,L-l-0 L-l-0 L-s-0 
job-8047,6,7,8,402067,499402,499437,97335,35,402347,false,C-l-0 L-l-0 C-l-1 C-l-0 C-l-1 C-l-2 C-l-2 C-m-1 
job-8046,1,10,5,402021,499402,499443,97381,41,402241,false,L-s-0 L-l-0 L-l-0 L-l-0 L-l-0 
job-8049,5,4,6,402164,499437,499468,97273,31,402365,false,C-m-0 C-l-1 C-l-2 C-m-1 C-l-1 C-l-2 
job-8045,1,4,6,401964,499402,499471,97438,69,402075,false,L-m-0 L-m-0 L-m-0 L-m-0 L-m-0 L-m-0 
job-8048,5,5,3,402128,499437,499499,97309,62,402205,false,C-l-0 L-l-0 C-l-0 
job-8050,2,6,3,402219,499499,499606,97280,107,402572,false,L-m-0 L-m-0 L-m-0 
job-8051,1,8,1,402265,499606,499622,97341,16,402442,false,L-s-0 
job-8052,4,9,6,402332,499606,499803,97274,197,402617,false,L-m-0 L-m-0 L-l-0 C-s-1 L-l-0 L-l-0 
job-8055,6,10,4,402466,499803,499832,97337,29,402503,false,C-l-0 C-l-1 C-l-1 C-l-0 
job-8053,1,4,7,402382,499803,499842,97421,39,402592,false,L-m-0 L-m-0 L-m-0 L-m-0 L-m-0 L-m-0 L-m-0 
job-8056,3,4,5,402509,499803,499872,97294,69,402760,false,L-l-0 C-l-2 C-l-2 C-l-2 C-l-2 
job-8057,6,10,7,402557,499832,499891,97275,59,402904,false,C-m-2 C-l-0 C-l-1 C-m-0 C-l-1 C-l-0 C-m-1 
job-8054,3,4,3,402424,499803,499901,97379,98,402622,false,L-l-0 L-l-0 L-l-0 
job-8058,6,9,6,402613,499891,500194,97278,303,403124,false,L-m-0 C-l-0 C-l-1 C-m-0 C-l-0 C-l-1 
job-8059,1,8,4,402663,500194,500428,97531,234,403189,false,L-m-0 L-m-0 L-m-0 L-m-0 
job-8060,2,7,8,402719,500428,500469,97709,41,403027,false,L-l-0 L-l-0 L-l-0 L-l-0 L-l-0 L-s-0 L-l-0 L-s-0 
job-8061,4,4,5,402779,500428,500536,97649,108,402936,false,C-l-0 L-m-0 C-l-0 L-m-0 C-l-0 
job-8062,1,12,1,402821,500428,500547,97607,119,403053,false,C-s-1 
job-8063,5,11,2,402864,500428,500685,97564,257,403315,false,C-l-1 C-l-1 
job-8064,2,11,3,402915,500685,500699,97770,14,403180,false,L-m-0 L-m-0 L-s-0 
job-8065,5,12,1,402961,500685,500700,97724,15,403235,false,L-l-0 
job-8067,4,5,1,403057,500699,500730,97642,31,403109,false,L-s-0 
job-8066,2,5,6,403008,500699,500735,97691,36,403261,false,L-m-0 L-l-0 L-l-0 L-m-0 L-l-0 L-m-0 
job-8068,5,10,4,403106,500699,500785,97593,86,403298,false,C-l-0 C-l-1 C-l-1 C-l-0 
job-8069,1,4,8,403168,500735,500787,97567,52,403357,false,L-s-0 C-l-0 C-l-1 L-s-0 C-l-0 C-l-1 L-s-0 L-s-0 
job-8073,5,5,8,403378,500787,500802,97409,15,403591,false,C-m-1 C-l-1 C-l-0 C-l-1 C-l-0 C-l-2 C-l-2 C-m-0 
job-8070,5,9,1,403217,500735,500805,97518,70,403362,false,L-m-0 
job-8071,3,5,3,403272,500787,500832,97515,45,403359,false,L-l-0 L-l-0 L-m-0 
job-8072,1,10,4,403323,500787,500874,97464,87,403655,false,L-s-0 L-l-0 L-l-0 L-l-0 
job-8075,5,5,4,403483,500874,500948,97391,74,403764,false,L-l-0 L-l-0 C-l-0 C-l-0 
job-8076,6,12,2,403542,500874,501112,97332,238,403824,false,C-l-1 C-l-1 
job-8074,3,4,2,403425,500874,501156,97449,282,403932,false,L-m-0 L-m-0 
job-8077,5,4,5,403601,501112,501163,97511,51,403755,false,L-l-0 L-l-0 C-l-0 C-m-0 C-l-0 
job-8079,4,5,7,403685,501163,501269,97478,106,403993,false,L-s-0 L-l-0 L-m-0 C-m-0 L-l-0 L-l-0 C-m-0 
job-8078,1,9,2,403643,501163,501480,97520,317,404245,false,L-m-0 L-m-0 
job-8080,2,12,7,403743,501480,501500,97737,20,403771,false,L-s-0 L-l-0 L-l-0 L-m-0 L-l-0 L-l-0 L-m-0 
job-8082,2,9,1,403852,501480,501546,97628,66,404173,false,C-s-2 
job-8081,4,11,1,403802,501480,501570,97678,90,403904,false,C-s-1 
job-8083,4,9,1,403915,501546,501573,97631,27,404208,false,L-s-0 
job-8084,4,12,1,403972,501546,501604,97574,58,404288,false,L-m-0 
job-8085,3,6,3,404030,501546,501632,97516,86,404407,false,L-l-0 L-m-0 L-l-0 
job-8086,1,7,6,404087,501632,501643,97545,11,404254,false,L-l-0 L-l-0 L-l-0 L-l-0 L-l-0 L-l-0 
job-8087,2,10,4,404134,501632,501678,97498,46,404233,false,L-s-0 L-m-0 L-m-0 L-m-0 
job-8088,1,11,1,404179,501678,501691,97499,13,404421,false,L-s-0 
job-8090,3,4,8,404279,501678,501773,97399,95,404385,false,L-s-0 C-l-0 C-l-0 C-l-0 C-l-0 C-m-0 C-m-0 L-m-0 
job-8089,2,12,7,404236,501678,501778,97442,100,404387,false,L-m-0 L-m-0 L-l-0 L-l-0 L-l-0 L-l-0 C-s-1 
job-8091,5,5,2,404321,501678,501851,97357,173,404583,false,C-l-1 C-l-1 
job-8092,5,9,1,404369,501678,501908,97309,230,404754,false,C-m-1 
job-8093,1,12,2,404411,501908,501926,97497,18,404546,false,L-m-0 L-m-0 
job-8094,6,4,6,404466,501908,501966,97442,58,404771,false,L-l-0 C-l-1 L-m-0 C-m-0 C-l-1 L-l-0 
job-8096,3,7,7,404572,501908,502023,97336,115,404694,false,C-l-0 C-m-2 C-l-0 C-m-2 C-l-0 C-l-0 C-s-1 
job-8095,4,9,6,404525,501908,502065,97383,157,404808,false,L-s-0 C-l-2 C-m-1 C-m-1 C-l-2 C-l-2 
job-8097,2,12,2,404627,502023,502088,97396,65,404913,false,L-m-0 L-m-0 
job-8098,2,4,7,404691,502023,502257,97332,234,405175,false,L-l-0 L-m-0 L-m-0 L-l-0 L-l-0 L-l-0 L-l-0 
job-8100,3,4,7,404800,502257,502275,97457,18,404942,false,L-m-0 L-l-0 L-l-0 L-m-0 L-l-0 L-l-0 C-s-1 
job-8099,1,7,2,404744,502257,502280,97513,23,404825,false,L-s-0 L-s-0 
job-8101,3,4,3,404854,502257,502284,97403,27,405078,false,C-l-0 C-l-0 C-l-0 
job-8102,3,8,1,404896,502284,502362,97388,78,405097,false,L-s-0 
job-8104,3,6,2,405005,502284,502371,97279,87,405279,false,L-m-0 L-l-0 
job-8103,5,7,1,404944,502284,502376,97340,92,405091,false,L-m-0 
job-8105,1,10,2,405067,502376,502477,97309,101,405287,false,L-m-0 L-m-0 
job-8106,3,8,1,405120,502477,502583,97357,106,405321,false,L-s-0 
job-8107,1,7,1,405176,502583,502652,97407,69,405496,false,L-s-0 
job-8108,2,10,4,405216,502583,502661,97367,78,405442,false,L-l-0 L-l-0 L-l-0 L-l-0 
job-8109,1,5,5,405258,502652,502681,97394,29,405490,false,L-m-0 L-m-0 L-l-0 L-m-0 L-m-0 
job-8110,6,12,3,405307,502652,502748,97345,96,405497,false,C-l-0 C-l-0 C-m-0 
job-8111,3,6,7,405363,502652,502877,97289,225,405858,false,L-s-0 C-l-1 C-l-1 C-s-1 C-l-1 C-l-1 L-m-0 
job-8113,6,8,3,405482,502877,502962,97395,85,405661,false,L-l-0 L-l-0 C-m-0 
job-8112,1,6,5,405423,502877,502992,97454,115,405770,false,L-m-0 L-m-0 L-m-0 L-m-0 L-m-0 
job-8114,1,6,6,405533,502877,503370,97344,493,406305,false,L-s-0 C-s-1 C-m-0 L-s-0 C-m-0 C-s-1 
job-8115,4,11,8,405577,503370,503409,97793,39,405625,false,L-l-0 L-m-0 L-l-0 L-m-0 C-m-1 L-s-0 L-l-0 C-m-1 
job-8116,3,6,5,405630,503409,503419,97779,10,405895,false,L-s-0 L-l-0 L-l-0 L-l-0 L-l-0 
job-8117,1,7,4,405686,503409,503704,97723,295,406103,false,L-m-0 L-m-0 L-s-0 L-m-0 
job-8119,2,4,6,405788,503704,503726,97916,22,405930,false,L-l-0 L-l-0 L-l-0 L-l-0 L-l-0 L-l-0 
job-8120,5,4,7,405844,503704,503741,97860,37,406148,false,C-m-0 C-l-2 C-l-1 C-l-2 C-l-0 C-l-1 C-l-0 
job-8118,1,10,3,405732,503704,503742,97972,38,405837,false,L-m-0 L-m-0 L-m-0 
job-8122,5,5,8,405956,503741,503774,97785,33,406134,false,L-l-0 C-l-0 C-m-2 C-l-0 C-l-1 C-m-0 C-l-1 L-l-0 
job-8121,3,8,5,405905,503704,503789,97799,85,406254,false,L-s-0 C-m-1 C-s-1 C-m-1 C-m-0 
job-8123,2,5,4,406019,503774,503870,97755,96,406275,false,L-m-0 C-m-0 C-m-0 C-m-1 
job-8126,1,7,6,406164,503870,503964,97706,94,406385,false,L-m-0 L-l-0 L-l-0 C-s-1 L-l-0 L-m-0 
job-8127,2,9,2,406218,503870,503987,97652,117,406592,false,C-s-1 C-s-2 
job-8125,3,5,5,406117,503870,503994,97753,124,406505,false,L-m-0 L-l-0 L-l-0 L-m-0 L-l-0 
job-8124,1,4,4,406072,503870,504028,97798,158,406284,false,L-s-0 L-s-0 L-s-0 L-s-0 
job-8128,6,4,3,406268,503870,504231,97602,361,406835,false,C-m-0 C-l-1 C-l-1 
job-8129,2,9,2,406318,504231,504254,97913,23,406363,false,L-m-0 L-m-0 
job-8130,5,11,8,406370,504231,504266,97861,35,406490,false,L-l-0 C-l-0 C-l-0 C-l-1 C-l-1 L-l-0 C-l-2 C-l-2 
job-8131,1,5,1,406420,504266,504664,97846,398,406991,false,L-s-0 
job-8133,4,7,4,406511,504664,504676,98153,12,406658,false,C-l-0 C-l-0 C-l-0 C-s-1 
job-8132,4,10,6,406459,504664,504695,98205,31,406706,false,L-m-0 L-s-0 L-l-0 L-l-0 L-m-0 L-l-0 
job-8134,4,11,3,406559,504664,504870,98105,206,407053,false,C-l-1 C-l-1 C-l-1 
job-8137,6,12,3,406728,504870,504894,98142,24,407040,false,L-m-0 C-l-1 C-l-1 
job-8136,6,9,2,406678,504870,504912,98192,42,406732,false,L-l-0 L-l-0 
job-8135,1,5,1,406626,504870,504998,98244,128,407035,false,L-s-0 
job-8138,1,12,8,406770,504870,505010,98100,140,407190,false,C-l-2 C-l-0 C-l-0 C-l-2 C-l-2 C-l-2 C-l-0 L-m-0 
job-8139,6,12,4,406834,504870,505264,98036,394,407314,false,C-m-0 C-m-2 C-l-0 C-m-1 
job-8140,6,8,5,406891,505264,505312,98373,48,407040,false,L-m-0 C-l-0 L-l-0 L-l-0 C-l-0 
job-8141,4,5,6,406939,505264,505331,98325,67,407223,false,L-s-0 C-l-2 C-m-0 C-m-0 C-l-2 C-l-2 
job-8142,4,6,7,406967,505264,505390,98297,126,407319,false,C-m-1 C-l-1 C-m-2 C-m-2 C-l-1 C-l-1 C-m-1 
job-8143,3,11,7,407002,505390,505414,98388,24,407318,false,L-s-0 L-l-0 L-l-0 L-m-0 L-l-0 L-l-0 L-m-0 
job-8144,5,12,7,407071,505390,505419,98319,29,407274,false,C-m-0 C-l-1 C-l-1 C-l-2 C-l-0 C-l-2 C-l-0 
job-8145,6,5,7,407114,505419,505799,98305,380,407699,false,L-m-0 C-l-0 C-l-1 L-l-0 C-l-0 C-l-1 L-l-0 
job-8147,6,8,4,407238,505799,505817,98561,18,407467,false,C-l-0 C-l-1 C-l-1 C-l-0 
job-8146,6,10,3,407187,505799,505862,98612,63,407307,false,L-l-0 L-l-0 L-m-0 
job-8148,3,7,6,407305,505799,505896,98494,97,407576,false,L-s-0 C-l-2 C-l-2 C-s-1 C-l-2 C-l-2 
job-8149,2,12,1,407357,505896,505907,98539,11,407512,false,L-s-0 
job-8150,6,5,8,407401,505896,506219,98495,323,407732,false,L-l-0 L-l-0 C-l-1 C-l-2 C-l-1 L-m-0 C-l-2 C-m-0 
job-8152,6,4,3,407501,506219,506280,98718,61,407589,false,L-l-0 C-m-0 L-l-0 
job-8151,3,9,3,407445,506219,506414,98774,195,407710,false,L-m-0 L-m-0 L-s-0 
job-8153,5,6,6,407543,506219,506417,98676,198,408028,false,C-l-0 C-l-2 C-l-2 C-l-1 C-l-0 C-l-1 
job-8154,1,7,1,407584,506417,506448,98833,31,407904,false,L-s-0 
job-8156,2,11,8,407686,506417,506519,98731,102,407838,false,L-l-0 C-l-2 C-l-2 C-l-2 C-l-2 C-m-0 C-s-1 L-m-0 
job-8155,5,11,4,407636,506417,506549,98781,132,407994,false,L-m-0 L-l-0 L-l-0 C-m-0 
job-8157,3,6,1,407747,506549,506603,98802,54,407962,false,L-s-0 
job-8159,5,5,4,407850,506549,506636,98699,87,408092,false,L-l-0 C-l-0 C-l-0 L-l-0 
job-8158,5,12,1,407797,506549,506789,98752,240,408323,false,L-m-0 
job-8160,4,10,1,407890,506789,506813,98899,24,408006,false,L-s-0 
job-8161,1,8,5,407945,506789,506857,98844,68,408310,false,L-l-0 L-l-0 L-l-0 L-l-0 L-l-0 
job-8162,2,6,8,407992,506789,506952,98797,163,408442,false,L-m-0 L-l-0 L-m-0 C-m-0 C-m-0 L-m-0 C-m-0 L-m-0 
job-8163,1,9,5,408044,506952,507007,98908,55,408317,false,L-l-0 L-l-0 L-l-0 L-l-0 L-l-0 
job-8164,2,9,8,408097,506952,507079,98855,127,408334,false,L-m-0 C-l-0 C-l-0 C-l-0 C-l-0 C-l-0 L-m-0 L-m-0 
job-8165,3,5,1,408146,507079,507119,98933,40,408242,false,L-s-0 
job-8166,3,9,6,408186,507079,507122,98893,43,408302,false,L-l-0 L-m-0 L-m-0 L-l-0 L-l-0 L-l-0 
job-8168,1,10,5,408284,507079,507127,98795,48,408531,false,L-m-0 C-m-0 L-s-0 C-m-0 C-m-0 
job-8170,5,10,3,408372,507119,507133,98747,14,408549,false,C-m-2 C-l-1 C-l-1 
job-8169,6,9,5,408328,507119,507133,98791,14,408428,false,C-l-0 C-l-2 C-l-0 C-m-1 C-l-2 
job-8167,4,7,1,408238,507079,507168,98841,89,408477,false,C-s-1 
job-8171,4,10,4,408421,507122,507301,98701,179,408827,false,L-m-0 L-l-0 L-l-0 L-l-0 
job-8173,5,6,4,408549,507301,507321,98752,20,408798,false,L-m-0 C-l-0 C-m-0 C-l-0 
job-8174,4,8,6,408594,507301,507328,98707,27,408889,false,L-s-0 C-l-2 C-l-2 C-m-1 C-l-2 C-m-1 
job-8172,3,5,3,408489,507301,507330,98812,29,408695,false,L-l-0 L-l-0 L-l-0 
job-8176,5,6,6,408696,507328,507391,98632,63,408894,false,C-m-2 C-l-2 C-l-1 C-m-1 C-l-1 C-l-2 
job-8175,5,10,4,408653,507321,507458,98668,137,409023,false,L-m-0 C-m-0 C-l-0 C-l-0 
job-8177,1,6,1,408754,507458,507472,98704,14,408780,false,L-s-0 
job-8179,4,11,2,408853,507458,507569,98605,111,409216,false,L-m-0 L-l-0 
job-8181,3,11,3,408953,507458,507576,98505,118,409367,false,C-s-2 C-m-1 C-m-1 
job-8182,3,10,3,409000,507472,507594,98472,122,409417,false,L-s-0 C-m-2 C-m-2 
job-8184,4,11,7,409104,507576,507626,98472,50,409339,false,C-m-0 L-l-0 C-m-0 C-m-1 C-s-2 L-m-0 C-m-1 
job-8178,4,7,1,408805,507458,507629,98653,171,409066,false,L-m-0 
job-8180,4,5,6,408901,507458,507634,98557,176,409329,false,C-l-1 C-l-1 L-l-0 C-s-1 L-l-0 C-l-1 
job-8183,6,12,4,409042,507569,507646,98527,77,409145,false,C-l-2 C-l-0 C-l-0 C-l-2 
job-8185,3,12,8,409153,507626,507684,98473,58,409376,false,L-m-0 L-l-0 C-s-2 C-m-1 C-m-0 C-m-1 L-s-0 C-m-0 
job-8186,6,10,8,409213,507646,507704,98433,58,409414,false,C-l-1 L-l-0 C-l-2 C-l-1 C-l-0 C-l-0 C-l-2 C-m-2 
job-8188,5,4,2,409319,507684,507796,98365,112,409565,false,C-m-0 C-m-1 
job-8187,3,7,6,409268,507684,507821,98416,137,409596,false,C-s-1 L-m-0 L-s-0 L-m-0 L-l-0 L-l-0 
job-8189,3,12,3,409378,507684,507907,98306,223,409622,false,C-s-2 C-m-1 C-m-0 
job-8191,2,9,8,409478,507907,507935,98429,28,409653,false,L-m-0 L-l-0 L-l-0 L-l-0 L-l-0 L-l-0 L-m-0 L-m-0 
job-8192,5,8,8,409527,507907,507970,98380,63,409614,false,C-m-1 C-l-1 C-l-0 C-l-2 C-l-1 C-l-0 C-l-2 C-m-0 
job-8190,2,8,1,409419,507907,508019,98488,112,409542,false,L-s-0 
job-8193,2,5,4,409573,507970,508024,98397,54,409661,false,L-m-0 L-m-0 L-s-0 L-m-0 
job-8196,6,7,1,409704,507970,508074,98266,104,410099,false,C-m-0 
job-8194,2,7,5,409609,507970,508077,98361,107,409791,false,L-l-0 L-m-0 L-l-0 L-l-0 L-l-0 
job-8195,4,5,2,409656,507970,508178,98314,208,409958,false,C-s-1 L-l-0 
job-8197,3,9,6,409761,507970,508241,98209,271,410319,false,C-l-0 C-l-0 C-m-1 C-m-1 C-l-0 C-l-0 
job-8198,4,4,6,409801,508241,508286,98440,45,409990,false,L-m-0 L-s-0 L-l-0 L-l-0 L-m-0 L-l-0 
job-8199,1,8,8,409859,508241,508361,98382,120,410181,false,C-l-1 C-l-1 C-l-1 C-s-1 C-s-1 C-l-1 C-l-1 C-l-1 
job-8200,5,5,7,409909,508241,508420,98332,179,410361,false,C-m-2 C-l-2 C-l-0 C-m-1 C-l-0 C-l-2 C-m-0 
job-8202,4,10,2,409992,508361,508484,98369,123,410240,false,C-s-1 C-s-0 
job-8205,1,12,7,410131,508484,508504,98353,20,410187,false,C-m-1 C-l-1 C-l-1 C-s-2 C-l-1 C-l-1 C-m-1 
job-8203,4,7,1,410034,508484,508510,98450,26,410274,false,C-s-1 
job-8204,4,9,6,410082,508484,508518,98402,34,410276,false,C-l-0 C-l-2 C-l-0 C-l-2 C-l-2 C-l-0 
job-8207,5,12,3,410229,508504,508520,98275,16,410501,false,C-l-1 C-m-2 C-l-1 
job-8206,6,8,2,410185,508484,508526,98299,42,410327,false,C-m-1 C-m-0 
job-8201,4,6,6,409947,508286,508529,98339,243,410301,false,L-m-0 L-l-0 L-s-0 L-m-0 L-l-0 L-l-0 
job-8208,6,10,7,410269,508520,508627,98251,107,410475,false,C-l-2 C-l-1 C-l-2 C-m-2 C-l-1 C-l-0 C-l-0 
job-8209,2,4,1,410316,508627,509217,98311,590,411010,false,L-s-0 
job-8211,3,7,4,410430,509217,509319,98787,102,410587,false,L-l-0 L-l-0 L-l-0 L-l-0 
job-8210,4,11,2,410376,509217,509343,98841,126,410683,false,L-m-0 L-m-0 
job-8212,1,6,2,410475,509319,509343,98844,24,410795,false,L-s-0 L-s-0 
job-8215,6,4,5,410616,509319,509380,98703,61,410742,false,C-m-0 C-l-0 C-m-2 C-m-1 C-l-0 
job-8213,3,8,7,410518,509319,509408,98801,89,410862,false,L-l-0 C-l-2 L-l-0 C-l-2 L-l-0 C-l-2 C-l-2 
job-8217,3,10,2,410722,509380,509453,98658,73,410924,false,C-m-1 C-m-1 
job-8214,2,8,7,410558,509319,509458,98761,139,410995,false,C-l-1 C-l-1 C-l-1 C-l-1 C-l-1 L-l-0 C-l-1 
job-8216,2,6,6,410669,509380,509459,98711,79,410978,false,L-m-0 L-s-0 L-m-0 L-m-0 L-m-0 L-s-0 
job-8218,5,10,3,410763,509380,509591,98617,211,411062,false,C-m-0 C-l-0 C-l-0 
job-8219,1,8,5,410809,509591,509675,98782,84,411022,false,L-l-0 L-l-0 L-l-0 L-l-0 L-l-0 
job-8220,6,4,2,410853,509591,509799,98738,208,411325,false,L-m-0 L-l-0 
job-8221,2,10,1,410897,509799,509840,98902,41,411025,false,L-s-0 
job-8222,4,5,3,410938,509799,509902,98861,103,411056,false,L-l-0 L-l-0 L-l-0 
job-8223,6,8,3,410983,509799,510152,98816,353,411549,false,L-m-0 C-l-0 C-l-0 
job-8226,4,11,3,411140,510152,510218,99012,66,411395,false,C-l-0 C-l-0 C-l-0 
job-8225,3,5,3,411084,510152,510254,99068,102,411296,false,L-m-0 C-s-1 L-m-0 
job-8228,1,6,8,411248,510152,510293,98904,141,411504,false,C-l-2 C-l-2 C-l-2 C-l-2 C-l-2 C-l-2 C-s-1 C-m-2 
job-8224,2,5,8,411036,510152,510295,99116,143,411242,false,L-l-0 L-s-0 L-l-0 L-l-0 L-l-0 L-s-0 L-l-0 L-l-0 
job-8227,2,8,4,411191,510152,510304,98961,152,411547,false,L-m-0 C-m-2 C-m-2 C-m-2 
job-8229,5,8,6,411279,510218,510316,98939,98,411402,false,C-l-0 C-l-1 C-l-0 C-m-0 C-l-1 C-l-2 
job-8230,6,6,1,411326,510218,510344,98892,126,411669,false,C-m-1 
job-8231,5,12,1,411389,510316,510351,98927,35,411700,false,L-m-0 
job-8232,1,10,5,411435,510344,510359,98909,15,411587,false,L-l-0 L-m-0 L-m-0 L-l-0 L-l-0 
job-8233,5,5,6,411480,510344,510467,98864,123,411818,false,C-m-0 C-l-0 C-l-0 C-l-1 C-l-1 L-l-0 
job-8234,3,4,8,411535,510467,510512,98932,45,411797,false,L-m-0 L-l-0 L-s-0 L-l-0 L-l-0 L-l-0 C-s-1 L-m-0 
job-8235,2,5,5,411584,510467,510550,98883,83,411779,false,C-m-0 L-m-0 C-m-0 C-m-0 C-m-0 
job-8237,3,5,3,411676,510467,510590,98791,123,412092,false,C-l-1 C-l-1 C-l-1 
job-8236,4,7,3,411631,510467,510611,98836,144,412040,false,C-l-0 C-l-0 C-l-0 
job-8238,3,10,4,411740,510467,510717,98727,250,412153,false,C-s-2 C-l-1 C-m-2 C-m-2 
job-8239,6,11,5,411797,510717,510778,98920,61,411996,false,L-m-0 C-l-0 L-l-0 L-l-0 C-l-0 
job-8240,5,11,7,411834,510717,510860,98883,143,412226,false,C-m-2 C-l-1 C-l-2 C-m-1 C-l-1 C-l-2 C-m-0 
job-8242,2,5,8,411937,510860,510967,98923,107,412079,false,L-l-0 L-l-0 L-l-0 L-l-0 L-l-0 L-s-0 L-l-0 L-s-0 
job-8243,5,7,7,411984,510860,510975,98876,115,412200,false,C-m-0 C-l-2 C-l-1 C-l-1 C-l-0 C-l-2 C-l-0 
job-8241,2,8,4,411883,510860,511008,98977,148,412223,false,L-m-0 L-m-0 L-m-0 L-m-0 
job-8244,2,9,2,412045,510975,511057,98930,82,412226,false,L-l-0 L-l-0 
job-8246,1,11,6,412143,511057,511078,98914,21,412430,false,L-m-0 L-l-0 L-l-0 L-m-0 L-l-0 L-l-0 
job-8247,4,7,7,412187,511057,511116,98870,59,412317,false,C-l-0 C-l-1 C-l-0 C-l-1 C-l-0 C-l-1 L-m-0 
job-8245,2,5,2,412100,511057,511142,98957,85,412385,false,L-s-0 L-s-0 
job-8248,4,6,8,412238,511057,511239,98819,182,412598,false,C-s-1 C-l-2 C-l-2 C-l-2 C-m-1 C-m-0 C-m-1 C-m-0 
job-8249,4,8,5,412287,511239,511249,98952,10,412389,false,L-m-0 L-l-0 L-l-0 L-l-0 L-m-0 
job-8250,5,6,5,412325,511239,511287,98914,48,412532,false,C-m-0 C-l-1 C-l-0 C-l-0 C-l-1 
job-8251,4,10,8,412364,511239,511470,98875,231,412690,false,C-m-1 C-l-2 C-m-2 C-l-2 C-l-2 C-m-2 L-s-0 C-m-1 
job-8252,6,4,3,412412,511470,511563,99058,93,412597,false,L-l-0 L-l-0 L-m-0 
job-8254,4,5,4,412514,511470,511694,98956,224,412791,false,C-l-0 C-l-0 C-l-0 C-s-1 
job-8253,4,9,1,412466,511470,511742,99004,272,412970,false,L-s-0 
job-8255,4,4,5,412581,511694,511760,99113,66,412842,false,L-l-0 L-m-0 L-m-0 L-l-0 L-l-0 
job-8256,3,10,4,412634,511694,511760,99060,66,412976,false,C-l-0 C-l-0 C-l-0 C-l-0 
job-8257,5,9,3,412687,511694,511824,99007,130,412818,false,C-m-0 C-l-2 C-l-2 
job-8258,1,12,2,412742,511824,511834,99082,10,412778,false,L-m-0 L-m-0 
job-8259,5,5,1,412779,511834,511861,99055,27,412855,false,L-m-0 
job-8260,4,7,6,412828,511834,511883,99006,49,413066,false,L-s-0 L-l-0 C-m-0 C-m-0 L-l-0 L-l-0 
job-8261,3,6,6,412876,511834,511980,98958,146,413056,false,C-l-1 C-l-1 L-m-0 C-l-1 C-s-1 C-l-1 
job-8262,6,9,4,412918,511980,511998,99062,18,412953,false,L-m-0 L-l-0 L-l-0 C-m-0 
job-8263,4,5,6,412971,511980,512093,99009,113,413157,false,L-s-0 C-l-1 C-l-1 C-m-1 C-l-1 C-m-1 
job-8264,4,11,1,413014,511980,512118,98966,138,413288,false,C-s-1 
job-8265,4,10,7,413058,512093,512125,99035,32,413143,false,L-l-0 L-m-0 L-s-0 C-s-2 L-l-0 L-l-0 L-m-0 
job-8266,5,9,3,413109,512093,512127,98984,34,413419,false,C-m-0 C-l-1 C-l-1 
job-8268,6,5,4,413219,512127,512410,98908,283,413711,false,C-m-0 L-l-0 L-l-0 L-m-0 
job-8267,5,11,6,413167,512093,512432,98926,339,413611,false,C-m-1 C-l-2 C-l-2 C-m-2 C-l-0 C-l-0 
job-8270,3,5,2,413321,512432,512458,99111,26,413416,false,L-m-0 L-m-0 
job-8269,4,11,1,413273,512410,512479,99137,69,413395,false,L-s-0 
job-8271,6,5,4,413363,512432,512710,99069,278,413887,false,C-l-0 L-l-0 C-l-0 L-l-0 
job-8273,2,8,5,413457,512710,512742,99253,32,413682,false,C-m-0 L-m-0 C-m-0 C-m-0 C-m-0 
job-8272,3,10,8,413407,512710,512747,99303,37,413637,false,L-l-0 L-s-0 L-l-0 L-l-0 L-l-0 L-m-0 C-s-0 L-m-0 
job-8274,3,5,7,413502,512710,512848,99208,138,413735,false,C-l-1 C-l-1 C-l-0 C-l-1 C-l-0 C-l-0 C-l-0 
job-8275,1,4,8,413559,512848,512882,99289,34,413598,false,L-m-0 L-m-0 L-m-0 L-m-0 L-m-0 L-m-0 L-m-0 L-m-0 
job-8276,3,6,8,413619,512848,512945,99229,97,413928,false,L-l-0 L-l-0 C-l-0 C-l-0 C-l-0 L-l-0 C-l-0 L-l-0 
job-8277,2,9,5,413665,512945,512958,99280,13,413817,false,L-l-0 L-l-0 L-l-0 L-l-0 L-l-0 
job-8280,5,12,6,413824,512945,512959,99121,14,413894,false,C-l-1 C-l-0 C-l-0 C-l-2 C-l-2 C-l-1 
job-8278,3,11,2,413720,512945,512960,99225,15,413880,false,L-m-0 L-m-0 
job-8279,3,5,2,413771,512945,512992,99174,47,413841,false,L-s-0 C-s-1 
job-8281,5,6,7,413877,512959,513094,99082,135,414245,false,C-m-0 L-l-0 C-l-1 C-l-0 C-l-1 L-l-0 C-l-0 
job-8282,1,12,7,413926,513094,513378,99168,284,414227,false,L-s-0 L-l-0 L-l-0 L-m-0 L-l-0 L-l-0 L-m-0 
job-8283,3,5,2,413980,513378,513486,99398,108,414138,false,L-m-0 L-m-0 
job-8284,5,7,8,414021,513378,513700,99357,322,414526,false,L-l-0 C-l-1 C-l-0 C-l-0 C-l-1 C-l-2 C-l-2 L-l-0 
job-8286,5,11,4,414116,513700,513779,99584,79,414393,false,C-l-1 C-l-0 C-l-0 C-l-1 
job-8285,6,10,4,414074,513700,513796,99626,96,414425,false,L-m-0 L-l-0 L-l-0 C-m-0 
job-8287,3,10,5,414161,513700,513956,99539,256,414535,false,L-s-0 C-l-2 C-l-2 C-l-2 C-l-2 
job-8288,6,12,8,414226,513796,514264,99570,468,414710,false,L-l-0 C-l-1 C-l-0 C-l-1 C-l-0 C-m-0 L-l-0 L-m-0 
job-8289,2,8,7,414278,514264,514335,99986,71,414559,false,L-l-0 L-l-0 L-s-0 L-l-0 L-l-0 L-s-0 L-l-0 
job-8290,5,5,3,414325,514264,514374,99939,110,414677,false,L-m-0 C-l-0 C-l-0 
job-8295,5,10,7,414555,514374,514463,99819,89,414920,false,C-m-2 C-l-1 C-l-2 C-m-0 C-l-1 C-l-2 C-m-1 
job-8291,2,6,2,414378,514374,514485,99996,111,414502,false,L-s-0 L-s-0 
job-8294,5,11,2,414512,514374,514493,99862,119,414682,false,C-l-0 C-l-0 
job-8296,5,6,1,414607,514493,514521,99886,28,414912,false,C-m-0 
job-8293,1,5,5,414461,514374,514536,99913,162,414907,false,L-m-0 L-m-0 L-m-0 L-m-0 L-m-0 
job-8292,3,9,4,414419,514374,514599,99955,225,414781,false,L-l-0 L-l-0 L-l-0 L-l-0 
job-8297,6,10,2,414658,514493,514627,99835,134,414818,false,C-l-0 C-l-0 
job-8298,6,7,8,414707,514536,514788,99829,252,415212,false,C-m-2 C-l-1 C-l-2 C-l-2 C-l-1 C-m-1 C-m-0 L-m-0 
job-8299,5,4,8,414761,514788,514821,100027,33,415082,false,L-l-0 C-l-0 C-l-1 C-l-1 C-l-0 L-l-0 C-m-0 L-m-0 
job-8300,3,5,8,414800,514788,514851,99988,63,415094,false,C-s-1 C-l-2 C-l-2 L-s-0 C-l-2 C-l-2 L-m-0 C-m-0 
job-8301,1,12,2,414862,514851,514876,99989,25,415055,false,L-m-0 L-m-0 
job-8302,3,7,6,414905,514851,514998,99946,147,415289,false,L-s-0 L-l-0 L-m-0 L-l-0 L-l-0 L-l-0 
job-8303,4,7,6,414961,514851,515232,99890,381,415343,false,C-l-0 C-l-0 C-l-1 C-l-0 C-l-1 C-l-1 
job-8304,5,9,1,415016,515232,515244,100216,12,415212,false,L-m-0 
job-8305,5,5,3,415058,515232,515245,100174,13,415261,false,L-l-0 L-l-0 C-m-0 
job-8306,3,9,5,415113,515232,515275,100119,43,415210,false,C-m-0 L-m-0 L-s-0 C-s-1 C-s-0 
job-8307,4,7,2,415162,515232,515306,100070,74,415412,false,C-m-1 C-m-1 
job-8309,6,5,7,415277,515245,515331,99968,86,415532,false,C-l-2 C-l-2 C-l-0 C-l-1 C-l-0 L-l-0 L-l-0 
job-8308,3,5,2,415218,515232,515374,100014,142,415568,false,C-m-2 C-m-2 
job-8310,6,5,8,415321,515331,515734,100010,403,416019,false,L-l-0 C-l-0 C-l-0 C-l-1 C-l-1 L-l-0 C-m-0 L-m-0 
job-8311,4,8,7,415367,515734,515898,100367,164,415776,false,L-l-0 L-m-0 L-s-0 L-l-0 L-m-0 L-l-0 C-s-1 
job-8312,2,6,1,415410,515898,515968,100488,70,415640,false,L-s-0 
job-8313,1,8,1,415462,515968,515986,100506,18,415541,false,L-s-0 
job-8315,3,5,8,415584,515968,515992,100384,24,415885,false,L-m-0 C-l-1 C-l-1 C-l-1 C-l-1 C-s-1 L-s-0 L-m-0 
job-8317,6,10,2,415703,515968,516046,100265,78,415849,false,C-l-0 C-l-0 
job-8314,6,7,2,415519,515968,516056,100449,88,415825,false,L-l-0 L-l-0 
job-8318,2,12,8,415750,516046,516090,100296,44,415947,false,L-s-0 C-m-0 C-l-0 C-l-0 C-l-0 L-m-0 C-l-0 L-m-0 
job-8316,6,8,1,415642,515968,516129,100326,161,415931,false,C-m-0 
job-8319,6,5,2,415797,516046,516210,100249,164,416121,false,C-l-1 C-l-1 
job-8320,4,10,3,415848,516210,516264,100362,54,416188,false,L-m-0 L-m-0 L-s-0 
job-8321,5,8,5,415895,516210,516504,100315,294,416266,false,C-m-0 L-l-0 C-l-1 L-l-0 C-l-1 
job-8322,6,8,1,415955,516504,516514,100549,10,416049,false,L-m-0 
job-8323,5,8,7,415993,516504,516542,100511,38,416049,false,C-m-0 L-l-0 C-l-1 C-l-0 C-l-1 L-l-0 C-l-0 
job-8324,4,11,8,416038,516542,516554,100504,12,416066,false,L-l-0 L-m-0 L-l-0 L-m-0 C-m-1 L-s-0 L-l-0 C-m-1 
job-8325,6,4,5,416085,516542,516557,100457,15,416306,false,C-m-0 C-l-2 C-l-0 C-l-0 C-l-2 
job-8326,1,4,3,416134,516542,516803,100408,261,416475,false,C-m-0 C-m-0 C-s-0 
job-8327,6,8,2,416184,516803,516920,100619,117,416323,false,L-l-0 L-l-0 
job-8329,2,10,5,416283,516920,516942,100637,22,416330,false,L-m-0 L-l-0 L-l-0 L-l-0 L-l-0 
job-8331,6,11,8,416361,516942,516954,100581,12,416442,false,L-l-0 L-m-0 C-l-0 C-l-2 C-l-2 C-m-0 C-l-0 L-l-0 
job-8328,3,9,1,416237,516920,516955,100683,35,416473,false,L-s-0 
job-8330,1,5,3,416318,516942,517037,100624,95,416690,false,L-m-0 L-m-0 L-s-0 
job-8332,2,6,8,416417,516942,517054,100525,112,416744,false,C-s-1 C-m-0 C-l-1 C-l-1 C-l-1 C-l-1 C-l-1 C-l-1 
job-8334,3,7,2,416519,517037,517054,100518,17,416691,false,L-s-0 L-m-0 
job-8333,1,7,5,416467,517037,517055,100570,18,416566,false,C-s-1 L-s-0 C-m-0 C-m-0 C-m-0 
job-8337,4,11,8,416684,517054,517117,100370,63,416959,false,C-l-1 C-l-1 C-l-2 C-l-2 C-l-1 C-m-0 C-s-2 C-l-2 
job-8336,6,7,3,416626,517037,517159,100411,122,416933,false,C-l-0 C-m-1 C-l-0 
job-8338,5,5,5,416736,517159,517179,100423,20,416787,false,L-m-0 C-l-1 C-l-0 C-l-0 C-l-1 
job-8339,5,7,8,416783,517179,517191,100396,12,417044,false,C-l-0 C-l-2 C-l-1 C-l-0 C-l-1 C-m-0 C-l-2 L-m-0 
job-8335,3,8,5,416578,517037,517206,100459,169,416906,false,L-l-0 L-l-0 L-m-0 L-l-0 L-l-0 
job-8341,6,10,1,416857,517191,517449,100334,258,417329,false,C-m-1 
job-8340,1,8,8,416819,517191,517452,100372,261,417290,false,L-m-0 C-m-0 L-s-0 L-m-0 C-m-0 C-m-0 L-m-0 C-m-0 
job-8343,3,11,4,416943,517449,517537,100506,88,417133,false,C-l-0 C-l-0 C-l-0 C-l-0 
job-8344,6,12,7,416976,517452,517555,100476,103,417110,false,C-m-1 C-l-1 C-l-2 C-m-0 C-l-1 C-l-2 L-m-0 
job-8342,4,9,3,416899,517449,517578,100550,129,417143,false,L-l-0 L-l-0 L-l-0 
job-8345,6,9,1,417033,517452,517626,100419,174,417303,false,C-m-2 
job-8346,5,11,7,417086,517555,517651,100469,96,417315,false,C-l-0 C-l-1 C-l-1 L-m-0 C-l-0 C-l-2 C-l-2 
job-8348,3,5,6,417176,517651,517756,100475,105,417413,false,L-m-0 C-l-0 C-l-0 L-m-0 C-l-0 C-l-0 
job-8347,1,11,6,417133,517651,517803,100518,152,417338,false,L-m-0 L-l-0 L-l-0 L-m-0 L-l-0 L-l-0 
job-8350,6,9,5,417275,517803,517830,100528,27,417333,false,L-l-0 L-l-0 C-l-0 L-m-0 C-l-0 
job-8349,1,6,1,417226,517803,517888,100577,85,417320,false,L-s-0 
job-8351,3,10,4,417323,517803,517917,100480,114,417522,false,C-s-2 C-s-0 L-s-0 C-s-1 
job-8352,5,12,3,417367,517888,517923,100521,35,417421,false,L-l-0 L-m-0 L-l-0 
job-8353,3,12,8,417421,517888,518031,100467,143,417731,false,C-l-1 L-m-0 C-l-1 C-l-0 C-l-0 C-l-0 C-l-1 C-l-1 
job-8354,1,4,5,417469,518031,518056,100562,25,417699,false,L-m-0 L-m-0 L-m-0 L-m-0 L-m-0 
job-8355,4,12,7,417516,518031,518084,100515,53,417844,false,L-s-0 C-l-1 C-l-1 L-l-0 C-l-1 L-l-0 L-l-0 
job-8356,2,12,5,417561,518084,518095,100523,11,417669,false,L-l-0 L-s-0 L-l-0 L-l-0 L-l-0 
job-8359,6,7,5,417716,518084,518103,100368,19,417961,false,C-l-0 C-l-2 C-l-0 C-m-0 C-l-2 
job-8360,5,8,3,417767,518084,518119,100317,35,418005,false,C-m-1 C-l-1 C-l-1 
job-8358,3,5,1,417667,518084,518170,100417,86,417789,false,C-s-1 
job-8357,4,5,2,417612,518084,518229,100472,145,417782,false,L-m-0 L-m-0 
job-8362,6,8,1,417877,518229,518245,100352,16,418120,false,L-m-0 
job-8361,1,10,1,417818,518229,518262,100411,33,418133,false,L-s-0 
job-8363,1,7,8,417919,518229,518264,100310,35,417963,false,L-l-0 L-m-0 L-l-0 L-m-0 L-l-0 L-l-0 L-l-0 L-l-0 
job-8364,6,9,3,417960,518229,518370,100269,141,418307,false,C-l-0 C-l-0 C-m-0 
job-8365,1,10,2,418016,518370,518412,100354,42,418078,false,L-m-0 L-m-0 
job-8366,2,10,4,418061,518370,518449,100309,79,418340,false,L-l-0 L-l-0 L-l-0 L-m-0 
job-8367,2,7,2,418118,518449,518486,100331,37,418265,false,L-s-0 L-s-0 
job-8368,5,7,7,418174,518449,518502,100275,53,418276,false,L-m-0 L-l-0 C-l-0 C-l-1 C-l-1 L-l-0 C-l-0 
job-8369,6,7,3,418231,518486,518514,100255,28,418556,false,C-m-0 C-l-2 C-l-2 
job-8370,2,4,4,418278,518502,518567,100224,65,418626,false,L-m-0 C-m-0 L-m-0 L-m-0 
job-8371,4,12,7,418333,518502,518765,100169,263,418792,false,L-l-0 C-l-1 C-l-1 L-l-0 C-l-1 L-l-0 L-s-0 
job-8372,6,11,8,418392,518765,518808,100373,43,418450,false,L-l-0 C-l-0 C-l-2 C-l-2 C-l-0 L-l-0 C-m-0 L-m-0 
job-8373,4,9,5,418442,518765,518825,100323,60,418619,false,L-s-0 C-l-1 C-l-1 C-s-1 C-l-1 
job-8375,6,5,3,418528,518808,519056,100280,248,418914,false,C-m-1 C-m-2 C-m-0 
job-8374,6,6,7,418490,518808,519081,100318,273,418981,false,L-l-0 C-l-0 C-l-2 L-l-0 C-l-0 C-l-2 L-m-0 
job-8378,5,11,5,418689,519081,519149,100392,68,419023,false,C-m-2 L-l-0 C-l-0 L-l-0 C-l-0 
job-8377,3,6,3,418650,519056,519195,100406,139,419002,false,C-m-0 C-m-1 C-m-1 
job-8376,1,11,5,418593,519056,519209,100463,153,419019,false,L-s-0 L-m-0 L-m-0 C-m-0 C-m-0 
job-8380,1,12,7,418788,519149,519222,100361,73,419071,false,C-m-2 C-l-2 C-l-2 C-m-1 C-l-2 C-l-2 C-m-2 
job-8379,6,4,7,418738,519149,519251,100411,102,418913,false,C-l-0 L-l-0 L-m-0 C-l-1 C-l-0 C-l-1 L-l-0 
job-8381,3,12,2,418845,519251,519273,100406,22,419078,false,L-m-0 L-m-0 
job-8382,6,4,7,418883,519251,519298,100368,47,418949,false,C-m-0 C-l-1 C-l-0 L-l-0 C-l-0 C-l-1 L-l-0 
job-8383,4,7,7,418923,519251,519438,100328,187,419346,false,L-s-0 C-l-2 C-l-2 C-m-1 C-l-2 C-s-1 C-m-1 
job-8385,5,6,2,419027,519438,519451,100411,13,419156,false,C-l-0 C-l-0 
job-8384,3,10,8,418978,519298,519457,100320,159,419275,false,C-s-0 L-l-0 L-l-0 L-l-0 L-l-0 L-m-0 C-s-2 L-m-0 
job-8386,4,12,6,419075,519438,519646,100363,208,419575,false,L-s-0 C-l-1 C-l-1 C-m-0 C-l-1 C-m-0 
job-8387,6,5,7,419128,519646,519670,100518,24,419410,false,L-m-0 C-l-0 C-l-1 L-l-0 C-l-0 C-l-1 L-l-0 
job-8388,1,8,2,419191,519670,519782,100479,112,419476,false,L-s-0 L-s-0 
job-8389,3,6,1,419235,519782,519801,100547,19,419426,false,L-s-0 
job-8390,5,8,6,419287,519782,519937,100495,155,419535,false,L-m-0 C-l-0 L-l-0 C-m-0 C-l-0 L-l-0 
job-8391,6,7,3,419339,519937,519999,100598,62,419490,false,L-l-0 L-l-0 L-m-0 
job-8392,2,12,2,419381,519999,520030,100618,31,419664,false,L-m-0 L-m-0 
job-8394,6,4,7,419490,519999,520053,100509,54,419547,false,C-l-0 C-l-2 C-l-1 C-m-0 C-l-0 C-l-1 C-l-2 
job-8393,6,4,2,419435,519999,520054,100564,55,419556,false,L-l-0 L-l-0 
job-8395,2,9,4,419541,519999,520063,100458,64,419625,false,C-m-1 C-m-0 C-m-1 C-m-1 
job-8396,4,9,7,419581,520030,520113,100449,83,419844,false,C-s-2 L-m-0 C-m-2 C-s-1 C-m-2 L-s-0 L-m-0 
job-8397,2,12,3,419626,520053,520282,100427,229,420005,false,C-l-0 C-l-0 C-m-0 
job-8398,6,4,4,419688,520282,520361,100594,79,419779,false,L-m-0 L-l-0 L-l-0 C-m-0 
job-8399,3,12,8,419738,520282,520395,100544,113,419980,false,C-l-0 C-l-0 C-l-1 C-l-0 C-l-1 C-l-1 C-l-0 C-l-1 
job-8400,1,6,6,419791,520282,520419,100491,137,420104,false,C-m-0 L-s-0 L-s-0 L-m-0 C-m-0 L-m-0 
job-8401,6,9,5,419853,520361,520433,100508,72,419942,false,L-m-0 L-l-0 L-l-0 C-m-1 C-m-0 
job-8402,3,8,8,419894,520361,520513,100467,152,420132,false,C-s-1 C-l-2 C-l-2 C-m-2 C-l-2 C-l-2 C-s-2 C-m-2 
job-8403,4,5,6,419949,520513,520559,100564,46,420102,false,L-m-0 L-s-0 L-l-0 L-l-0 L-m-0 L-l-0 
job-8404,6,8,6,420000,520513,520832,100513,319,420617,false,C-l-1 C-l-0 C-l-2 C-l-2 C-l-0 C-l-1 
job-8405,1,11,3,420063,520832,520887,100769,55,420412,false,L-l-0 L-l-0 L-l-0 
job-8406,5,7,8,420116,520832,520895,100716,63,420318,false,C-l-2 C-l-0 C-l-0 C-l-1 C-l-1 L-l-0 C-l-2 L-m-0 
job-8407,2,7,8,420161,520887,520928,100726,41,420282,false,L-l-0 C-l-1 L-l-0 C-l-2 C-l-0 L-l-0 L-s-0 L-m-0 
job-8408,4,7,7,420210,520887,520936,100677,49,420484,false,C-m-0 C-m-2 C-m-0 C-m-1 C-m-2 C-s-1 C-m-1 
job-8409,2,8,6,420249,520928,521098,100679,170,420519,false,L-l-0 L-l-0 L-l-0 L-l-0 L-l-0 L-l-0 
job-8411,1,12,3,420340,521098,521117,100758,19,420373,false,L-l-0 L-l-0 L-l-0 
job-8410,3,7,1,420299,521098,521125,100799,27,420460,false,L-s-0 
job-8412,6,11,8,420388,521098,521164,100710,66,420585,false,C-l-2 C-l-2 C-l-1 C-l-0 C-l-1 L-l-0 C-l-0 L-m-0 
job-8413,1,8,3,420444,521164,521259,100720,95,420811,false,L-m-0 L-m-0 L-m-0 
job-8414,1,11,6,420492,521164,521343,100672,179,420721,false,L-s-0 L-l-0 L-l-0 C-s-1 L-l-0 L-l-0 
job-8415,2,12,1,420539,521343,521356,100804,13,420589,false,L-s-0 
job-8416,3,8,7,420592,521343,521446,100751,103,420726,false,L-m-0 L-m-0 L-l-0 C-s-1 L-l-0 L-l-0 L-l-0 
job-8417,1,6,5,420638,521446,521458,100808,12,420677,false,L-m-0 L-m-0 L-m-0 L-m-0 L-m-0 
job-8419,2,10,6,420727,521446,521471,100719,25,420923,false,L-s-0 L-l-0 C-m-0 C-m-0 C-m-0 L-l-0 
job-8418,1,5,4,420676,521446,521519,100770,73,420870,false,L-l-0 L-l-0 L-l-0 L-l-0 
job-8420,3,9,5,420771,521446,521581,100675,135,421146,false,C-s-2 C-l-2 C-l-2 C-l-2 C-l-2 
job-8421,6,6,6,420826,521581,521602,100755,21,421104,false,C-m-0 C-l-0 L-l-0 L-m-0 C-l-0 L-l-0 
job-8422,6,5,5,420866,521581,521651,100715,70,421082,false,C-m-1 C-l-1 C-l-1 C-l-2 C-l-2 
job-8425,6,9,5,421002,521651,521744,100649,93,421360,false,C-m-0 C-l-2 C-l-0 C-l-2 C-l-0 
job-8424,3,9,6,420959,521651,521749,100692,98,421220,false,L-m-0 L-l-0 L-l-0 L-m-0 L-l-0 L-l-0 
job-8423,3,6,2,420915,521581,521813,100666,232,421385,false,L-s-0 C-s-1 
job-8426,3,4,4,421055,521813,521824,100758,11,421265,false,L-l-0 L-l-0 L-l-0 L-l-0 
job-8428,1,11,8,421160,521813,521843,100653,30,421358,false,C-l-0 C-l-1 C-l-1 C-l-0 C-l-1 C-l-0 C-l-0 C-l-1 
job-8429,1,8,8,421224,521813,521869,100589,56,421291,false,L-s-0 C-l-2 C-l-2 C-l-2 C-l-2 C-l-2 C-l-2 L-m-0 
job-8427,1,8,3,421107,521813,521922,100706,109,421273,false,L-m-0 L-m-0 L-m-0 
job-8430,4,11,2,421273,521922,521935,100649,13,421444,false,L-m-0 L-m-0 
job-8431,5,8,7,421314,521922,522017,100608,95,421419,false,C-m-0 L-l-0 C-l-1 C-l-0 C-l-1 L-l-0 C-l-0 
job-8432,5,7,6,421354,522017,522033,100663,16,421467,false,L-m-0 C-l-0 C-l-0 C-m-0 L-l-0 L-l-0 
job-8434,6,4,4,421477,522033,522053,100556,20,421691,false,L-m-0 L-l-0 L-l-0 C-m-0 
job-8435,5,10,5,421533,522033,522053,100500,20,421696,false,C-l-0 C-l-1 C-l-1 C-m-1 C-l-0 
job-8436,3,4,5,421585,522033,522089,100448,56,421641,false,C-l-2 C-l-2 L-s-0 C-m-1 C-l-2 
job-8437,4,4,4,421625,522033,522266,100408,233,421884,false,C-m-2 C-s-1 C-s-2 C-m-2 
job-8433,1,12,1,421409,522033,522270,100624,237,421689,false,L-s-0 
job-8438,6,6,5,421672,522266,522286,100594,20,421902,false,L-l-0 L-l-0 C-l-0 L-m-0 C-l-0 
job-8439,3,7,8,421722,522266,522352,100544,86,421888,false,C-l-1 C-l-1 C-l-2 C-l-2 C-l-1 C-l-2 C-l-1 C-l-2 
job-8440,1,12,4,421771,522266,522414,100495,148,422198,false,L-m-0 L-m-0 C-m-0 C-m-0 
job-8441,6,7,8,421823,522414,522425,100591,11,421980,false,L-l-0 C-l-0 C-l-0 C-l-1 C-l-1 L-l-0 C-m-0 L-m-0 
job-8442,4,7,6,421865,522414,522704,100549,290,422228,false,L-s-0 C-l-2 C-l-2 C-m-1 C-l-2 C-m-1 
job-8443,3,7,3,421913,522704,522720,100791,16,421988,false,L-m-0 L-m-0 L-s-0 
job-8444,1,12,2,421955,522704,522732,100749,28,422254,false,L-l-0 L-m-0 
job-8445,5,8,8,421998,522704,522881,100706,177,422467,false,C-l-2 L-l-0 C-l-1 C-l-2 C-l-0 L-l-0 C-l-0 C-l-1 
job-8446,6,12,1,422045,522704,523023,100659,319,422587,false,C-m-0 
job-8447,2,6,5,422099,522881,523056,100782,175,422460,false,L-m-0 C-m-0 L-m-0 L-m-0 L-m-0 
job-8450,5,8,4,422244,523056,523070,100812,14,422303,false,C-l-0 C-l-1 C-l-0 C-l-1 
job-8448,1,11,3,422149,523056,523086,100907,30,422451,false,L-l-0 L-l-0 L-l-0 
job-8449,4,10,3,422196,523056,523121,100860,65,422277,false,L-m-0 L-m-0 L-l-0 
job-8451,1,6,2,422288,523121,523146,100833,25,422596,false,L-s-0 L-s-0 
job-8453,4,5,1,422374,523121,523192,100747,71,422733,false,L-l-0 
job-8452,1,10,3,422332,523121,523193,100789,72,422413,false,L-m-0 L-m-0 L-m-0 
job-8454,1,7,4,422436,523192,523415,100756,223,422676,false,L-l-0 L-l-0 L-l-0 L-l-0 
job-8457,2,11,3,422578,523415,523446,100837,31,422707,false,L-m-0 C-m-0 C-m-0 
job-8455,5,6,1,422486,523415,523456,100929,41,422649,false,L-m-0 
job-8456,4,10,4,422532,523415,523466,100883,51,422648,false,L-l-0 L-l-0 L-l-0 L-s-0 
job-8458,6,7,6,422645,523415,523472,100770,57,422770,false,C-l-0 C-l-2 C-l-1 C-l-2 C-l-1 C-l-0 
job-8459,5,12,3,422688,523446,523540,100758,94,422850,false,C-m-2 C-m-1 C-m-0 
job-8460,6,11,2,422741,523540,523590,100799,50,422966,false,L-l-0 L-l-0 
job-8461,5,6,3,422791,523540,523781,100749,241,423193,false,L-m-0 C-l-0 C-l-0 
job-8462,4,4,6,422827,523781,523824,100954,43,422884,false,L-m-0 L-s-0 L-l-0 L-l-0 L-m-0 L-l-0 
job-8463,4,5,4,422873,523781,523914,100908,133,423083,false,C-l-1 C-l-1 C-l-1 C-s-1 
job-8465,5,12,8,422971,523824,523950,100853,126,423369,false,C-m-1 L-l-0 C-l-0 C-l-2 C-l-0 L-l-0 C-l-2 L-m-0 
job-8464,6,10,1,422925,523781,523981,100856,200,423357,false,C-m-0 
job-8466,2,12,8,423023,523981,523991,100958,10,423055,false,L-m-0 L-s-0 L-l-0 L-l-0 L-l-0 L-l-0 C-s-1 L-m-0 
job-8469,6,6,7,423173,523991,524044,100818,53,423227,false,C-l-0 C-l-2 C-l-2 L-l-0 C-l-0 L-l-0 C-m-0 
job-8467,4,4,1,423068,523991,524058,100923,67,423213,false,L-s-0 
job-8468,2,4,4,423131,523991,524120,100860,129,423296,false,L-m-0 L-m-0 L-m-0 L-m-0 
job-8470,4,4,8,423218,523991,524137,100773,146,423457,false,C-m-2 C-l-1 C-l-1 C-s-1 C-l-1 C-m-1 C-m-1 C-m-2 
job-8472,1,6,1,423322,524044,524142,100722,98,423428,false,C-s-2 
job-8474,5,6,7,423428,524142,524188,100714,46,423492,false,C-l-1 C-l-2 C-l-0 C-l-1 C-l-2 C-l-0 L-m-0 
job-8471,1,9,5,423276,524044,524207,100768,163,423646,false,L-l-0 L-l-0 L-l-0 L-l-0 L-l-0 
job-8475,3,9,2,423483,524142,524298,100659,156,423808,false,C-s-1 L-m-0 
job-8476,6,10,7,423543,524298,524309,100755,11,423594,false,L-l-0 C-l-0 C-l-2 L-l-0 C-l-0 C-l-2 L-m-0 
job-8477,2,11,5,423586,524298,524371,100712,73,423817,false,C-l-1 C-l-1 L-m-0 C-l-1 C-l-1 
job-8480,6,10,8,423743,524371,524409,100628,38,424067,false,C-m-0 C-l-2 C-l-0 C-l-1 C-l-1 C-l-2 C-l-0 L-m-0 
job-8473,1,5,2,423377,524142,524416,100765,274,423681,false,L-s-0 L-s-0 
job-8481,4,8,8,423798,524409,524428,100611,19,423873,false,C-l-0 C-l-1 C-l-1 C-l-0 C-l-1 L-m-0 C-l-0 L-m-0 
job-8478,2,9,6,423651,524298,524436,100647,138,423964,false,C-m-1 C-m-2 C-m-2 C-m-1 C-m-2 C-m-1 
job-8479,3,10,3,423699,524371,524443,100672,72,423967,false,L-l-0 L-l-0 L-l-0 
job-8482,3,5,7,423840,524409,524491,100569,82,424074,false,C-l-2 C-l-2 C-l-2 C-m-0 C-l-2 L-l-0 C-m-0 
job-8483,2,4,6,423889,524491,524509,100602,18,424180,false,L-l-0 L-l-0 L-l-0 L-l-0 L-l-0 L-l-0 
job-8484,6,8,1,423933,524491,524533,100558,42,424207,false,L-m-0 
job-8485,6,4,7,423978,524491,524701,100513,210,424286,false,C-l-0 C-l-1 C-l-0 C-m-0 C-l-1 C-l-2 C-l-2 
job-8486,5,4,6,424024,524701,524733,100677,32,424138,false,L-m-0 C-l-0 C-l-0 C-m-0 L-l-0 L-l-0 
job-8489,5,5,4,424184,524733,524788,100549,55,424241,false,C-m-0 L-l-0 L-l-0 L-m-0 
job-8487,1,7,1,424072,524733,524835,100661,102,424230,false,L-s-0 
job-8490,5,9,8,424236,524733,524841,100497,108,424388,false,C-m-1 C-l-1 C-l-0 C-l-2 C-l-0 C-l-1 C-l-2 C-m-2 
job-8488,3,8,2,424120,524733,524850,100613,117,424406,false,L-s-0 L-m-0 
job-8491,4,11,8,424273,524788,524918,100515,130,424489,false,C-s-1 L-l-0 C-s-2 L-l-0 L-l-0 C-m-0 C-m-0 L-m-0 
job-8492,2,11,3,424332,524918,524936,100586,18,424350,false,L-m-0 L-m-0 L-s-0 
job-8493,5,5,4,424388,524918,524949,100530,31,424710,false,L-l-0 C-l-0 C-l-0 L-l-0 
job-8494,6,9,3,424429,524918,524979,100489,61,424559,false,C-m-0 C-l-1 C-l-1 
job-8495,5,9,3,424475,524979,525001,100504,22,424612,false,L-l-0 L-l-0 L-m-0 
job-8496,6,5,1,424530,524979,525002,100449,23,424675,false,C-m-0 
job-8498,3,4,6,424621,524979,525009,100358,30,424903,false,L-s-0 C-l-0 C-l-0 C-l-0 C-l-0 L-m-0 
job-8499,2,6,5,424670,524979,525024,100309,45,424815,false,C-m-0 C-s-1 C-m-1 C-s-1 L-l-0 
job-8497,6,8,1,424574,524979,525045,100405,66,424827,false,C-m-1 
job-8500,3,8,1,424723,524979,525130,100256,151,424997,false,C-s-2 
job-8501,3,8,1,424775,524979,525211,100204,232,425117,false,C-s-0 
job-8502,4,12,6,424832,525211,525228,100379,17,424922,false,L-m-0 L-s-0 L-l-0 L-l-0 L-m-0 L-l-0 
job-8503,5,11,1,424885,525211,525287,100326,76,424962,false,C-m-0 
job-8504,3,11,3,424935,525287,525318,100352,31,424990,false,L-m-0 L-m-0 L-s-0 
job-8505,4,12,2,424988,525318,525330,100330,12,425277,false,L-m-0 L-m-0 
job-8506,4,5,8,425037,525318,525484,100281,166,425224,false,C-s-1 C-l-1 L-l-0 C-l-1 C-l-1 L-s-0 L-l-0 L-l-0 
job-8507,2,7,3,425096,525318,525769,100222,451,425694,false,C-s-0 C-s-2 C-s-0 
job-8508,4,10,8,425158,525769,525799,100611,30,425197,false,L-m-0 L-l-0 L-l-0 L-l-0 C-m-0 L-s-0 L-m-0 C-m-0 
job-8509,2,6,2,425213,525799,525809,100586,10,425278,false,L-s-0 L-s-0 
job-8510,4,4,5,425269,525799,525966,100530,167,425733,false,L-l-0 L-m-0 L-m-0 L-l-0 L-l-0 
job-8511,4,4,2,425327,525966,525991,100639,25,425505,false,L-m-0 L-m-0 
job-8513,4,5,2,425425,525966,525998,100541,32,425732,false,C-m-0 C-m-0 
job-8514,6,12,7,425485,525966,526048,100481,82,425760,false,C-l-0 C-l-2 C-l-1 C-m-1 C-l-0 C-l-1 C-l-2 
job-8512,4,9,4,425380,525966,526072,100586,106,425717,false,L-l-0 L-l-0 L-s-0 L-l-0 
job-8516,5,12,5,425578,526048,526122,100470,74,425922,false,C-m-0 C-l-1 C-m-2 C-m-1 C-l-1 
job-8515,6,6,5,425539,526048,526211,100509,163,425784,false,L-m-0 C-l-2 C-l-0 C-l-0 C-l-2 
job-8517,6,7,6,425616,526122,526471,100506,349,426115,false,C-m-1 L-l-0 C-l-1 C-m-0 C-l-1 L-l-0 
job-8519,3,7,6,425716,526471,526491,100755,20,425957,false,C-m-0 C-l-1 C-l-1 C-m-0 C-l-1 C-l-1 
job-8520,5,4,7,425771,526491,526532,100720,41,425912,false,C-m-0 C-l-1 C-l-1 C-l-2 C-l-0 C-l-2 C-l-0 
job-8518,3,12,7,425668,526471,526574,100803,103,425965,false,L-s-0 L-l-0 L-l-0 L-m-0 L-l-0 L-l-0 L-m-0 
job-8521,4,10,1,425833,526491,526584,100658,93,426198,false,C-s-1 
job-8523,5,4,2,425924,526532,526674,100608,142,426241,false,C-l-0 C-l-0 
job-8524,6,12,2,425975,526674,526747,100699,73,426155,false,L-l-0 L-l-0 
job-8522,5,9,1,425873,526491,526757,100618,266,426354,false,C-m-1 
job-8525,2,11,2,426032,526674,526924,100642,250,426321,false,L-s-0 C-m-1 
job-8526,1,5,4,426092,526924,526968,100832,44,426147,false,L-m-0 L-m-0 L-m-0 L-m-0 
job-8527,6,7,6,426134,526924,527259,100790,335,426592,false,C-l-0 C-l-1 C-l-1 L-l-0 C-l-0 L-l-0 
job-8528,1,5,3,426180,527259,527340,101079,81,426351,false,L-s-0 L-s-0 L-s-0 
job-8529,5,4,6,426232,527259,527380,101027,121,426650,false,L-m-0 C-l-0 L-l-0 C-m-0 C-l-0 L-l-0 
job-8530,4,5,4,426278,527380,527401,101102,21,426511,false,L-l-0 L-l-0 L-s-0 L-l-0 
job-8531,6,4,5,426330,527380,527427,101050,47,426473,false,L-m-0 C-l-0 C-l-1 C-l-1 C-l-0 
job-8532,6,4,5,426380,527380,527438,101000,58,426734,false,C-m-0 C-l-2 C-m-2 C-m-1 C-l-2 
job-8535,2,4,6,426518,527427,527500,100909,73,426799,false,L-m-0 L-l-0 L-l-0 L-m-0 L-l-0 L-l-0 
job-8533,1,8,7,426418,527427,527501,101009,74,426594,false,C-m-1 C-m-2 C-m-0 C-m-1 C-m-2 L-s-0 C-m-0 
job-8534,2,6,3,426474,527427,527529,100953,102,426788,false,L-s-0 L-m-0 L-m-0 
job-8536,4,4,5,426560,527427,527860,100867,433,427099,false,C-s-1 C-l-1 L-l-0 C-l-1 C-l-1 
job-8537,3,8,6,426594,527860,527877,101266,17,426713,false,L-m-0 L-l-0 L-l-0 L-l-0 L-m-0 L-l-0 
job-8538,3,7,3,426640,527860,527898,101220,38,426701,false,L-s-0 C-m-0 C-m-0 
job-8539,1,11,5,426690,527860,527923,101170,63,426772,false,L-m-0 C-l-0 C-l-0 C-l-0 C-m-0 
job-8542,3,7,3,426856,527860,528054,101004,194,427060,false,C-s-0 C-m-1 C-m-1 
job-8540,3,11,6,426746,527860,528057,101114,197,427155,false,C-s-2 C-l-1 C-l-1 C-l-1 C-l-0 C-l-1 
job-8541,2,9,5,426799,527860,528072,101061,212,427213,false,C-l-2 C-l-2 C-l-2 C-l-2 C-l-2 
job-8544,6,9,3,426944,528054,528129,101110,75,427274,false,C-m-1 L-m-0 C-m-0 
job-8543,4,4,5,426893,528054,528172,101161,118,427304,false,C-l-0 L-l-0 C-l-0 L-l-0 L-l-0 
job-8545,1,12,2,426998,528172,528255,101174,83,427176,false,L-m-0 L-m-0 
job-8546,1,10,8,427057,528172,528387,101115,215,427516,false,L-s-0 L-l-0 C-m-0 L-l-0 L-l-0 L-l-0 C-m-0 C-m-0 
job-8548,6,4,7,427163,528387,528442,101224,55,427233,false,L-l-0 C-l-0 C-l-2 L-l-0 C-l-0 C-l-2 L-m-0 
job-8547,2,6,1,427103,528387,528662,101284,275,427576,false,L-s-0 
job-8549,2,4,4,427232,528662,528702,101430,40,427353,false,L-m-0 L-m-0 L-m-0 L-m-0 
job-8550,2,6,4,427290,528662,528832,101372,170,427512,false,L-l-0 L-l-0 L-l-0 L-l-0 
job-8551,4,12,2,427353,528832,528853,101479,21,427382,false,L-m-0 L-m-0 
job-8552,6,4,8,427399,528832,529008,101433,176,427872,false,L-l-0 C-l-0 C-l-1 C-l-1 C-l-0 C-l-2 C-l-2 L-l-0 
job-8553,5,5,7,427444,529008,529054,101564,46,427511,false,C-l-1 L-l-0 C-l-0 C-l-1 C-l-0 L-l-0 L-m-0 
job-8555,6,8,5,427537,529054,529065,101517,11,427822,false,L-m-0 C-l-0 L-l-0 L-l-0 C-l-0 
job-8554,3,7,1,427491,529054,529112,101563,58,427789,false,L-s-0 
job-8556,5,7,2,427585,529054,529288,101469,234,427860,false,C-l-1 C-l-1 
job-8558,5,11,6,427677,529288,529307,101611,19,427983,false,C-l-1 L-l-0 C-l-0 C-l-1 C-l-0 L-l-0 
job-8557,3,5,2,427629,529288,529421,101659,133,427775,false,L-m-0 L-m-0 
job-8560,6,10,7,427774,529421,529477,101647,56,427947,false,C-m-1 C-l-2 C-l-1 C-l-2 L-l-0 C-l-0 L-m-0 
job-8559,2,9,8,427717,529288,529479,101571,191,428162,false,L-l-0 C-l-1 C-l-0 L-s-0 C-m-0 C-m-0 L-m-0 C-m-0 
job-8564,6,8,8,427974,529479,529546,101505,67,428320,false,C-l-2 C-l-1 C-l-2 C-l-0 C-l-0 C-m-2 C-l-1 C-m-1 
job-8562,2,10,4,427872,529479,529563,101607,84,428107,false,L-l-0 L-m-0 L-l-0 L-l-0 
job-8563,2,7,8,427921,529479,529674,101558,195,428175,false,L-s-0 L-l-0 L-s-0 C-m-0 L-l-0 C-m-0 C-m-0 C-m-0 
job-8561,2,11,2,427828,529479,529688,101651,209,428266,false,L-m-0 L-m-0 
job-8566,5,10,6,428093,529674,529697,101581,23,428154,false,L-l-0 C-l-1 C-l-1 C-l-0 C-l-0 L-l-0 
job-8565,1,8,3,428028,529674,529712,101646,38,428326,false,L-s-0 L-m-0 L-s-0 
job-8568,4,7,3,428191,529674,529722,101483,48,428258,false,C-s-1 C-m-0 C-m-0 
job-8567,5,10,2,428141,529674,529759,101533,85,428405,false,C-l-2 C-l-2 
job-8569,1,9,5,428239,529697,529852,101458,155,428640,false,L-m-0 C-l-2 L-l-0 L-m-0 C-l-2 
job-8572,6,11,7,428376,529852,529933,101476,81,428642,false,C-l-0 C-l-1 C-l-0 C-l-2 C-l-1 C-l-2 L-m-0 
job-8574,6,6,5,428475,529933,530038,101458,105,428813,false,C-l-0 C-l-1 C-l-1 L-m-0 C-l-0 
job-8570,5,5,2,428284,529852,530042,101568,190,428645,false,L-l-0 L-l-0 
job-8576,2,7,6,428565,529933,530062,101368,129,428767,false,C-s-1 C-m-1 C-m-1 C-m-1 C-m-1 C-s-1 
job-8573,2,10,2,428417,529933,530081,101516,148,428717,false,L-s-0 L-m-0 
job-8575,4,8,6,428517,529933,530085,101416,152,428680,false,C-s-0 C-l-2 C-l-2 C-m-2 C-l-2 C-m-2 
job-8571,1,4,3,428332,529852,530111,101520,259,428828,false,L-l-0 L-l-0 L-s-0 
job-8577,2,9,6,428613,530038,530144,101425,106,428758,false,L-m-0 C-l-1 C-l-1 L-m-0 C-l-1 C-l-1 
job-8578,3,6,1,428667,530144,530171,101477,27,428781,false,L-s-0 
job-8579,3,7,7,428725,530144,530292,101419,148,428885,false,L-m-0 L-m-0 L-l-0 L-l-0 L-l-0 L-l-0 C-s-1 
job-8582,4,5,8,428874,530292,530312,101418,20,429163,false,C-m-0 L-l-0 C-l-1 C-l-1 C-l-1 L-m-0 C-m-0 L-m-0 
job-8580,4,10,1,428766,530292,530318,101526,26,428794,false,L-s-0 
job-8584,4,12,7,428971,530292,530366,101321,74,429150,false,C-l-2 C-l-0 C-l-2 C-s-1 C-l-0 C-l-0 C-l-2 
job-8585,4,9,6,429017,530312,530368,101295,56,429237,false,L-m-0 C-l-1 C-l-1 L-m-0 C-l-1 C-s-2 
job-8581,1,10,4,428811,530292,530393,101481,101,429006,false,L-l-0 L-l-0 L-l-0 L-l-0 
job-8583,5,8,1,428926,530292,530395,101366,103,429035,false,C-m-1 
job-8588,6,6,7,429154,530395,530416,101241,21,429433,false,L-l-0 C-l-2 C-l-1 C-l-0 C-l-1 C-l-0 C-l-2 
job-8587,2,12,5,429102,530395,530457,101293,62,429311,false,L-m-0 L-l-0 L-l-0 L-m-0 L-l-0 
job-8586,2,9,1,429059,530395,530461,101336,66,429397,false,L-s-0 
job-8590,2,12,7,429273,530457,530513,101184,56,429354,false,C-s-1 L-l-0 L-l-0 L-m-0 L-l-0 L-l-0 L-m-0 
job-8589,3,4,1,429217,530457,530516,101240,59,429346,false,L-m-0 
job-8591,1,7,6,429314,530457,530605,101143,148,429529,false,C-l-0 C-l-0 L-s-0 C-l-0 C-l-0 C-l-0 
job-8593,5,5,2,429421,530605,530632,101184,27,429576,false,L-l-0 L-l-0 
job-8594,4,6,7,429461,530605,530652,101144,47,429604,false,L-m-0 C-l-1 C-l-1 C-m-0 C-l-1 L-m-0 C-m-0 
job-8592,2,5,2,429367,530605,530657,101238,52,429526,false,L-s-0 L-s-0 
job-8596,6,7,3,429554,530605,530696,101051,91,429803,false,C-l-2 C-m-1 C-l-2 
job-8595,1,5,3,429508,530605,530802,101097,197,429777,false,C-s-0 L-l-0 L-l-0 
job-8598,3,8,8,429647,530802,530862,101155,60,429745,false,L-m-0 L-l-0 L-l-0 L-l-0 C-m-1 C-m-1 L-l-0 L-m-0 
job-8597,3,5,1,429594,530802,530871,101208,69,429931,false,L-s-0 
job-8599,1,5,7,429703,530802,530922,101099,120,430095,false,C-m-1 L-m-0 C-s-0 C-m-1 C-s-0 L-m-0 L-s-0 
job-8600,2,10,1,429739,530922,530981,101183,59,429836,false,L-s-0 
job-8601,1,11,1,429781,530922,530982,101141,60,430074,false,L-m-0 
job-8602,5,4,5,429830,530922,531191,101092,269,430237,false,L-l-0 C-l-0 L-m-0 L-l-0 C-l-0 
job-8604,5,9,1,429923,531191,531224,101268,33,430037,false,L-l-0 
job-8603,3,5,2,429879,531191,531227,101312,36,429989,false,L-m-0 L-m-0 
job-8605,3,5,7,429985,531191,531357,101206,166,430231,false,L-l-0 C-l-0 C-l-0 L-s-0 C-l-0 C-l-0 L-l-0 
job-8606,2,9,4,430036,531191,531492,101155,301,430588,false,L-m-0 C-m-1 C-m-1 C-m-1 
job-8607,5,4,5,430096,531492,531513,101396,21,430368,false,L-l-0 L-l-0 C-l-0 L-m-0 C-l-0 
job-8608,2,9,3,430157,531513,531529,101356,16,430259,false,L-m-0 L-m-0 L-m-0 
job-8609,1,11,1,430207,531513,531636,101306,123,430539,false,L-s-0 
job-8610,3,10,4,430241,531513,531769,101272,256,430764,false,L-l-0 L-l-0 L-l-0 L-l-0 
job-8611,1,4,2,430289,531769,531785,101480,16,430409,false,L-s-0 L-s-0 
job-8613,1,11,8,430375,531785,531804,101410,19,430600,false,C-m-0 L-l-0 L-l-0 L-l-0 L-l-0 L-m-0 C-m-0 L-m-0 
job-8617,6,10,7,430572,531785,531846,101213,61,430846,false,C-l-0 C-l-1 C-l-1 C-m-2 C-l-2 C-l-0 C-l-2 
job-8614,4,7,2,430426,531785,531849,101359,64,430531,false,C-s-1 C-m-0 
job-8615,1,12,1,430470,531785,531861,101315,76,430704,false,C-s-2 
job-8612,1,7,2,430336,531769,531878,101433,109,430688,false,L-s-0 L-m-0 
job-8616,4,4,3,430514,531785,531970,101271,185,430931,false,C-m-1 L-l-0 C-m-1 
job-8618,2,10,8,430625,531970,531983,101345,13,430764,false,L-m-0 L-s-0 L-l-0 L-l-0 L-l-0 L-l-0 L-m-0 L-m-0 
job-8620,2,9,5,430727,531970,532111,101243,141,431149,false,C-m-0 C-l-1 C-m-0 C-m-0 C-l-0 
job-8619,5,9,4,430682,531970,532127,101288,157,430862,false,C-l-0 C-l-0 C-l-1 C-l-1 
job-8621,5,11,7,430771,532111,532135,101340,24,430917,false,C-m-0 L-l-0 C-l-2 C-m-1 C-l-2 L-l-0 L-m-0 
job-8622,3,9,2,430828,532135,532257,101307,122,431212,false,L-m-0 L-m-0 
job-8623,4,8,5,430882,532257,532273,101375,16,430917,false,L-m-0 L-l-0 L-l-0 L-l-0 L-m-0 
job-8624,6,7,7,430941,532257,532366,101316,109,431165,false,C-l-0 C-l-0 C-l-1 C-m-0 C-l-1 C-l-2 C-l-2 
job-8625,3,8,7,430990,532366,532408,101376,42,431033,false,L-s-0 L-l-0 L-l-0 L-m-0 L-l-0 L-l-0 L-m-0 
job-8626,2,4,2,431038,532366,532421,101328,55,431229,false,C-s-1 L-m-0 
job-8627,5,7,4,431084,532366,532522,101282,156,431304,false,C-l-0 C-l-1 C-l-1 C-l-0 
job-8628,5,5,2,431138,532366,532657,101228,291,431627,false,C-l-2 C-l-2 
job-8630,5,7,7,431237,532657,532753,101420,96,431398,false,C-l-2 C-l-0 C-l-1 C-l-2 C-l-0 C-l-1 L-m-0 
job-8629,1,6,7,431189,532657,532762,101468,105,431433,false,L-l-0 L-l-0 L-l-0 L-l-0 L-l-0 L-l-0 L-l-0 
job-8633,4,8,6,431389,532762,532812,101373,50,431492,false,L-m-0 L-l-0 L-l-0 C-m-0 C-m-0 L-l-0 
job-8634,2,5,3,431434,532762,532850,101328,88,431522,false,L-m-0 C-s-2 C-s-2 
job-8632,2,5,1,431340,532762,532863,101422,101,431500,false,L-m-0 
job-8635,2,4,8,431484,532762,533022,101278,260,431857,false,C-s-0 C-l-1 C-l-1 C-l-1 C-l-1 C-l-1 C-s-0 C-l-1 
job-8631,3,7,1,431295,532753,533048,101458,295,431677,false,L-s-0 
job-8636,3,8,7,431525,533022,533115,101497,93,431901,false,L-m-0 L-m-0 L-l-0 L-l-0 L-l-0 L-l-0 C-s-1 
job-8637,5,6,8,431571,533022,533222,101451,200,431958,false,C-m-1 C-l-2 C-l-1 C-l-2 C-l-1 C-l-0 C-l-0 C-m-0 
job-8638,6,6,3,431616,533115,533234,101499,119,432022,false,L-m-0 L-l-0 L-l-0 
job-8639,6,12,7,431669,533222,533244,101553,22,431898,false,C-l-0 C-l-1 C-l-1 C-m-0 C-l-2 C-l-2 C-l-0 
job-8640,1,9,2,431731,533244,533258,101513,14,431798,false,L-m-0 L-m-0 
job-8642,6,12,6,431844,533244,533282,101400,38,432008,false,C-l-0 C-l-2 C-l-0 C-l-2 C-l-1 C-l-1 
job-8641,5,7,3,431781,533244,533413,101463,169,432099,false,L-l-0 L-m-0 L-l-0 
job-8644,4,4,6,431944,533282,533480,101338,198,432233,false,L-s-0 C-m-1 C-l-2 C-m-1 C-l-2 C-l-2 
job-8643,5,7,5,431902,533282,533510,101380,228,432325,false,C-m-0 C-l-1 C-l-0 C-l-0 C-l-1 
job-8645,6,6,1,431994,533413,533528,101419,115,432301,false,L-m-0 
job-8646,2,9,3,432036,533510,533562,101474,52,432110,false,L-l-0 L-l-0 L-m-0 
job-8647,6,12,5,432102,533510,533627,101408,117,432416,false,L-l-0 C-l-0 C-l-1 C-l-1 C-l-0 
job-8650,4,9,8,432252,533627,533649,101375,22,432373,false,C-m-0 C-l-2 C-l-2 C-l-2 C-m-1 C-m-1 C-s-0 C-m-0 
job-8649,5,8,7,432203,533627,533651,101424,24,432408,false,L-l-0 L-l-0 L-m-0 C-l-0 C-l-1 C-l-1 C-l-0 
job-8651,4,9,3,432299,533627,533677,101328,50,432395,false,C-m-2 C-m-2 C-s-1 
job-8648,1,4,2,432149,533627,533704,101478,77,432294,false,L-s-0 L-s-0 
job-8653,4,9,2,432404,533704,533745,101300,41,432465,false,L-m-0 L-m-0 
job-8652,6,8,2,432352,533649,533748,101297,99,432738,false,C-l-2 C-l-2 
job-8654,6,11,6,432456,533704,533792,101248,88,432698,false,L-l-0 C-l-0 C-l-1 L-l-0 C-l-0 C-l-1 
job-8656,6,10,6,432570,533792,533803,101222,11,432638,false,C-l-0 C-l-1 C-l-1 L-m-0 C-l-0 L-l-0 
job-8655,1,6,6,432520,533792,533806,101272,14,432743,false,L-l-0 L-l-0 L-l-0 L-l-0 L-l-0 L-l-0 
job-8657,5,8,7,432614,533803,533954,101189,151,432826,false,C-m-0 C-l-0 C-l-1 C-l-0 C-l-1 L-l-0 L-m-0 
job-8658,5,9,4,432666,533954,534004,101288,50,432946,false,L-m-0 L-l-0 L-l-0 C-m-0 
job-8659,3,9,6,432716,534004,534020,101288,16,432878,false,L-m-0 L-l-0 L-l-0 L-l-0 L-m-0 L-l-0 
job-8660,4,7,1,432765,534004,534030,101239,26,432857,false,L-s-0 
job-8661,6,9,5,432807,534004,534291,101197,287,433215,false,C-l-0 C-l-2 C-l-2 C-m-0 C-l-0 
job-8663,3,4,5,432919,534291,534346,101372,55,433239,false,L-l-0 L-l-0 L-l-0 C-s-1 L-l-0 
job-8662,4,12,3,432861,534291,534357,101430,66,433141,false,L-m-0 L-m-0 L-s-0 
job-8664,1,11,4,432979,534291,534402,101312,111,433269,false,C-l-2 C-s-1 C-l-2 C-l-2 
job-8665,2,7,3,433032,534346,534426,101314,80,433385,false,L-l-0 C-l-2 C-l-2 
job-8666,3,11,6,433074,534346,534456,101272,110,433232,false,C-m-1 L-l-0 L-l-0 C-m-1 L-l-0 C-s-2 
job-8667,1,7,7,433113,534456,534472,101343,16,433136,false,L-s-0 L-l-0 L-l-0 L-l-0 L-l-0 L-l-0 L-l-0 
job-8669,1,4,5,433211,534456,534529,101245,73,433328,false,L-m-0 L-l-0 C-s-1 C-m-1 C-s-1 
job-8668,2,9,7,433159,534456,534539,101297,83,433326,false,L-s-0 L-m-0 C-m-1 C-m-1 L-m-0 L-m-0 C-m-1 
job-8670,2,7,6,433260,534456,534803,101196,347,433881,false,C-s-2 C-m-0 C-m-0 C-m-0 C-s-1 C-m-0 
job-8671,2,6,4,433307,534803,534867,101496,64,433427,false,L-m-0 L-m-0 L-m-0 L-m-0 
job-8673,6,8,4,433401,534803,534931,101402,128,433561,false,C-m-0 C-l-1 C-l-1 L-l-0 
job-8672,3,5,2,433357,534803,534966,101446,163,433731,false,L-l-0 L-l-0 
job-8674,6,4,5,433455,534803,535038,101348,235,433854,false,C-l-2 C-l-0 C-l-2 C-m-1 C-l-0 
job-8675,3,11,8,433499,535038,535057,101539,19,433758,false,L-m-0 L-l-0 L-l-0 L-m-0 L-l-0 L-l-0 C-s-2 L-s-0 
job-8676,4,9,3,433553,535038,535129,101485,91,433650,false,C-l-0 C-l-0 C-l-0 
job-8677,5,8,4,433599,535038,535184,101439,146,434026,false,C-l-1 C-l-2 C-l-1 C-l-2 
job-8678,3,6,7,433651,535184,535206,101533,22,433716,false,L-s-0 L-l-0 L-l-0 L-m-0 L-l-0 L-l-0 L-m-0 
job-8679,4,8,6,433709,535184,535341,101475,157,434016,false,C-l-1 C-l-0 C-l-1 C-l-0 C-l-0 C-l-1 
job-8680,4,11,2,433761,535341,535358,101580,17,433798,false,L-m-0 L-m-0 
job-8681,3,9,4,433813,535341,535363,101528,22,433855,false,L-l-0 L-l-0 L-l-0 L-l-0 
job-8682,4,6,1,433859,535341,535411,101482,70,434223,false,L-s-0 
job-8684,3,11,7,433956,535411,535471,101455,60,434279,false,L-m-0 L-l-0 L-l-0 L-m-0 L-l-0 L-l-0 L-s-0 
job-8683,5,10,6,433912,535341,535473,101429,132,434059,false,C-l-0 C-l-2 C-l-1 C-l-2 C-l-1 C-l-0 
job-8685,5,10,7,434009,535473,535654,101464,181,434346,false,C-l-1 L-l-0 C-l-0 C-l-1 C-l-0 L-l-0 L-m-0 
job-8687,5,4,8,434097,535654,535700,101557,46,434265,false,C-l-0 C-l-1 C-l-0 C-l-2 C-l-1 C-m-0 C-l-2 C-m-1 
job-8686,2,10,6,434050,535654,535710,101604,56,434206,false,L-m-0 L-l-0 L-l-0 L-m-0 L-l-0 L-l-0 
job-8688,4,12,8,434145,535700,535732,101555,32,434219,false,C-s-1 C-l-0 L-s-0 C-s-2 C-l-0 C-l-0 C-s-0 L-m-0 
job-8689,4,10,4,434200,535732,535746,101532,14,434285,false,L-l-0 L-l-0 L-s-0 L-l-0 
job-8690,3,4,5,434244,535732,535767,101488,35,434314,false,C-l-0 C-l-0 L-m-0 C-l-0 C-l-0 
job-8692,4,6,2,434325,535732,535820,101407,88,434660,false,C-l-1 C-s-1 
job-8691,2,9,6,434277,535732,535826,101455,94,434385,false,L-m-0 C-l-1 C-l-1 L-m-0 C-l-1 C-l-1 
job-8693,3,6,6,434382,535732,535890,101350,158,434729,false,C-m-0 C-l-2 C-l-2 C-m-0 C-l-2 C-l-2 
job-8695,3,11,6,434468,535746,535966,101278,220,434930,false,L-s-0 C-s-2 C-m-1 C-m-2 C-m-2 C-s-0 
job-8694,5,6,3,434435,535746,536028,101311,282,434962,false,C-m-1 L-l-0 L-l-0 
job-8696,4,6,1,434524,536028,536063,101504,35,434621,false,L-s-0 
job-8697,2,4,5,434570,536028,536357,101458,329,435166,false,L-l-0 L-l-0 L-l-0 L-l-0 L-l-0 
job-8698,3,10,2,434614,536357,536431,101743,74,434898,false,L-m-0 L-m-0 
job-8701,3,12,8,434766,536431,536450,101665,19,435013,false,C-l-0 L-l-0 C-l-0 L-l-0 L-l-0 C-l-0 C-l-0 L-m-0 
job-8699,1,5,2,434658,536431,536498,101773,67,434976,false,L-s-0 L-s-0 
job-8700,1,10,1,434709,536431,536586,101722,155,435163,false,L-m-0 
job-8702,6,12,2,434813,536586,536601,101773,15,435103,false,L-l-0 L-l-0 
job-8704,6,6,8,434906,536586,536620,101680,34,434979,false,C-l-0 C-l-1 C-l-1 C-l-2 C-l-0 C-m-1 C-l-2 C-m-0 
job-8703,2,7,3,434854,536586,536686,101732,100,435022,false,L-m-0 L-m-0 L-m-0 
job-8705,1,11,4,434962,536620,536758,101658,138,435302,false,L-l-0 L-m-0 L-l-0 L-l-0 
job-8706,1,7,8,435007,536620,536948,101613,328,435451,false,L-s-0 L-l-0 L-s-0 C-m-0 C-m-0 L-l-0 C-m-0 C-m-0 
job-8707,2,10,7,435074,536948,537020,101874,72,435318,false,L-m-0 L-l-0 L-l-0 L-m-0 L-l-0 L-l-0 L-m-0 
job-8708,2,6,2,435120,536948,537054,101828,106,435405,false,L-s-0 L-l-0 
job-8710,4,4,8,435232,536948,537073,101716,125,435587,false,C-s-1 C-l-2 C-l-2 C-l-2 C-m-0 C-m-1 C-m-1 C-m-0 
job-8709,5,7,4,435181,536948,537075,101767,127,435312,false,C-l-0 C-l-0 C-l-1 C-l-1 
job-8713,5,11,4,435364,537075,537096,101711,21,435450,false,L-l-0 C-l-0 C-l-0 L-l-0 
job-8711,2,4,2,435284,537075,537117,101791,42,435603,false,L-s-0 L-s-0 
job-8712,4,9,1,435324,537075,537144,101751,69,435558,false,L-m-0 
job-8714,3,8,8,435422,537075,537222,101653,147,435809,false,C-l-1 C-l-1 C-l-2 C-l-1 C-l-2 C-l-2 C-l-2 L-m-0 
job-8715,5,11,2,435488,537075,537309,101587,234,435852,false,C-m-1 C-m-0 
job-8716,6,12,7,435535,537222,537338,101687,116,435784,false,C-l-1 C-l-0 L-l-0 L-m-0 C-l-0 L-l-0 C-l-1 
job-8717,5,4,4,435580,537309,537806,101729,497,436092,false,C-m-1 C-l-2 C-l-2 C-m-0 
job-8718,5,9,5,435630,537806,537851,102176,45,435691,false,L-l-0 L-l-0 C-l-0 L-m-0 C-l-0 
job-8719,6,8,2,435682,537806,537873,102124,67,435979,false,C-l-1 C-l-1 
job-8720,5,9,3,435727,537806,538079,102079,273,436233,false,C-m-0 C-l-2 C-l-2 
job-8721,3,9,8,435767,537806,538103,102039,297,436312,false,L-s-0 C-s-2 C-m-2 C-s-0 C-m-0 C-m-2 C-s-1 L-m-0 
job-8722,5,11,3,435810,538079,538230,102269,151,436239,false,L-l-0 C-m-0 L-m-0 
job-8723,1,12,4,435856,538230,538297,102374,67,436165,false,L-l-0 L-l-0 L-l-0 L-l-0 
job-8724,1,11,2,435899,538297,538329,102398,32,436103,false,L-m-0 L-m-0 
job-8726,3,5,6,435996,538297,538343,102301,46,436286,false,C-m-0 L-l-0 L-l-0 C-m-0 L-l-0 L-l-0 
job-8728,6,10,5,436083,538329,538351,102246,22,436108,false,C-l-1 C-l-2 C-l-2 C-m-1 C-l-1 
job-8725,3,5,3,435946,538297,538374,102351,77,436306,false,L-s-0 L-m-0 L-m-0 
job-8727,4,11,4,436038,538297,538375,102259,78,436141,false,C-s-1 C-l-0 C-l-0 C-l-0 
job-8731,5,6,3,436218,538351,538411,102133,60,436480,false,C-m-1 C-l-1 C-l-1 
job-8729,4,12,6,436124,538343,538429,102219,86,436481,false,C-m-0 L-l-0 C-s-2 C-m-0 L-l-0 L-l-0 
job-8730,2,12,2,436167,538351,538434,102184,83,436477,false,C-s-0 L-m-0 
job-8732,4,7,4,436256,538411,538436,102155,25,436374,false,L-m-0 C-m-1 L-s-0 C-m-1 
job-8733,2,4,4,436309,538411,538606,102102,195,436786,false,C-s-0 C-s-1 C-s-1 L-m-0 
job-8735,5,11,6,436424,538411,538653,101987,242,436705,false,C-l-2 C-l-1 C-l-0 C-m-2 C-l-1 C-l-2 
job-8734,1,7,5,436363,538411,538701,102048,290,436900,false,C-l-0 C-l-0 C-l-0 C-l-0 C-l-0 
job-8736,5,12,7,436463,538653,538718,102190,65,436817,false,L-l-0 C-l-1 C-l-1 L-m-0 C-l-0 L-l-0 C-m-0 
job-8737,4,4,3,436514,538701,538722,102187,21,436809,false,L-s-0 C-s-1 C-l-0 
job-8738,2,6,2,436563,538722,539388,102159,666,437339,false,L-s-0 L-s-0 
job-8739,1,10,6,436617,539388,539423,102771,35,436655,false,L-m-0 L-l-0 L-l-0 L-m-0 L-l-0 L-l-0 
job-8740,6,8,1,436670,539423,539493,102753,70,436942,false,L-m-0 
job-8741,3,11,2,436715,539423,539594,102708,171,437068,false,L-l-0 L-l-0 
job-8742,6,10,6,436765,539423,539737,102658,314,437354,false,C-m-0 C-l-0 C-l-1 C-l-1 C-l-0 L-l-0 
job-8743,2,5,8,436820,539594,539776,102774,182,437070,false,L-l-0 L-m-0 L-m-0 C-m-0 L-m-0 L-l-0 L-l-0 L-m-0 
job-8744,2,11,7,436866,539737,539799,102871,62,437158,false,C-m-0 L-l-0 L-l-0 C-m-0 C-s-1 L-l-0 L-s-0 
job-8745,4,8,6,436917,539737,540084,102820,347,437349,false,C-l-1 C-l-1 C-l-0 C-l-0 C-l-1 C-l-0 
job-8746,5,10,7,436964,540084,540163,103120,79,437295,false,C-l-1 L-l-0 C-l-0 C-l-1 C-l-0 L-l-0 L-m-0 
job-8747,4,12,4,437008,540163,540206,103155,43,437299,false,L-l-0 L-l-0 L-s-0 L-l-0 
job-8748,4,5,2,437062,540163,540273,103101,110,437355,false,L-m-0 L-m-0 
job-8749,1,10,4,437117,540273,540283,103156,10,437179,false,L-l-0 L-l-0 L-l-0 L-l-0 
job-8750,2,10,5,437173,540273,540309,103100,36,437308,false,L-m-0 L-m-0 L-s-0 L-m-0 C-s-1 
job-8751,5,12,5,437218,540273,540324,103055,51,437552,false,C-m-0 C-l-0 C-l-1 C-l-0 C-l-1 
job-8752,4,12,1,437271,540309,540335,103038,26,437568,false,L-s-0 
job-8754,2,4,8,437380,540309,540496,102929,187,437687,false,C-s-1 L-m-0 C-l-1 C-l-0 L-m-0 L-m-0 C-s-1 L-m-0 
job-8753,3,8,5,437334,540309,540554,102975,245,437874,false,L-l-0 C-m-0 L-l-0 L-l-0 L-l-0 
job-8755,2,11,1,437422,540554,540611,103132,57,437602,false,L-s-0 
job-8757,6,4,6,437528,540554,540664,103026,110,437710,false,L-m-0 C-l-0 C-l-1 C-m-0 C-l-0 C-l-1 
job-8759,6,4,8,437617,540664,540677,103047,13,437888,false,C-m-0 C-l-0 C-l-0 C-l-2 C-l-1 C-l-1 C-l-2 L-m-0 
job-8758,1,12,7,437569,540664,540685,103095,21,437690,false,L-s-0 L-m-0 L-l-0 C-m-0 C-m-0 L-m-0 L-l-0 
job-8756,5,6,2,437476,540554,540769,103078,215,437965,false,L-l-0 L-l-0 
job-8760,1,12,1,437675,540769,540798,103094,29,437818,false,L-s-0 
job-8761,1,9,4,437721,540769,540877,103048,108,438051,false,L-l-0 L-l-0 L-l-0 L-l-0 
job-8762,2,6,3,437764,540877,540895,103113,18,438001,false,L-m-0 L-m-0 L-m-0 
job-8763,4,6,7,437830,540877,540936,103047,59,437948,false,L-l-0 L-l-0 L-l-0 L-s-0 C-l-2 C-l-2 C-l-2 
job-8764,2,10,6,437875,540877,541138,103002,261,438382,false,C-l-0 C-l-0 L-m-0 C-s-1 C-l-0 C-l-0 
job-8765,2,5,5,437925,541138,541245,103213,107,438278,false,L-l-0 L-l-0 L-l-0 L-l-0 L-l-0 
job-8766,2,7,3,437980,541245,541271,103265,26,438127,false,L-m-0 L-m-0 L-m-0 
job-8767,4,12,7,438037,541245,541331,103208,86,438171,false,L-l-0 C-l-2 C-l-2 L-l-0 C-l-2 L-l-0 L-s-0 
job-8768,2,8,5,438093,541331,541352,103238,21,438265,false,L-l-0 L-l-0 L-l-0 L-l-0 L-l-0 
job-8771,5,9,1,438243,541331,541381,103088,50,438300,false,C-m-0 
job-8772,4,7,6,438291,541381,541402,103090,21,438508,false,L-l-0 C-l-0 L-l-0 C-l-0 C-l-0 L-l-0 
job-8770,4,9,3,438196,541331,541432,103135,101,438356,false,L-s-0 C-s-2 L-m-0 
job-8769,1,10,2,438153,541331,541446,103178,115,438500,false,L-m-0 L-m-0 
job-8773,1,9,1,438348,541381,541476,103033,95,438573,false,C-s-1 
job-8776,3,12,8,438508,541432,541520,102924,88,438652,false,L-l-0 L-l-0 C-l-0 C-l-0 C-l-0 C-l-0 L-l-0 L-l-0 
job-8774,5,8,4,438405,541381,541532,102976,151,438715,false,C-l-1 C-l-1 C-l-2 C-l-2 
job-8775,2,8,5,438450,541432,541538,102982,106,438592,false,L-s-0 C-l-2 L-m-0 L-s-0 C-l-1 
job-8777,1,7,2,438560,541538,541604,102978,66,438701,false,L-s-0 L-s-0 
job-8779,3,12,2,438661,541604,541625,102943,21,438891,false,L-s-0 L-l-0 
job-8778,1,6,6,438612,541538,541628,102926,90,438721,false,L-l-0 L-l-0 L-l-0 L-l-0 L-l-0 L-l-0 
job-8780,4,9,6,438703,541604,541791,102901,187,438908,false,L-m-0 L-m-0 C-l-1 C-s-1 C-l-1 C-l-1 
job-8783,5,9,6,438842,541791,541812,102949,21,438871,false,L-m-0 C-l-0 C-l-1 C-m-0 C-l-1 C-l-0 
job-8784,6,10,7,438874,541812,541831,102938,19,438941,false,C-l-0 C-l-1 L-m-0 C-l-1 C-l-0 C-l-2 C-l-2 
job-8785,5,6,8,438918,541831,541849,102913,18,438993,false,C-l-0 C-l-2 C-l-1 C-l-0 C-l-1 C-m-0 C-l-2 L-m-0 
job-8786,3,4,3,438961,541831,541851,102870,20,439257,false,C-m-1 C-m-0 C-m-1 
job-8781,4,6,1,438752,541791,541861,103039,70,438978,false,L-s-0 
job-8782,1,9,6,438806,541791,541879,102985,88,439099,false,L-m-0 L-l-0 L-l-0 L-l-0 L-l-0 L-l-0 
job-8787,5,12,1,439007,541831,542161,102824,330,439352,false,C-m-2 
job-8789,6,4,3,439103,542161,542240,103058,79,439362,false,L-l-0 L-l-0 C-m-0 
job-8788,5,12,1,439052,542161,542372,103109,211,439495,false,L-m-0 
job-8790,3,10,3,439147,542372,542383,103225,11,439385,false,L-m-0 L-m-0 L-s-0 
job-8791,5,4,6,439193,542372,542451,103179,79,439278,false,C-l-0 L-l-0 C-l-0 C-l-1 C-l-1 L-l-0 
job-8792,4,9,6,439239,542372,542476,103133,104,439375,false,C-m-0 C-l-2 C-l-2 C-m-0 C-l-2 C-s-1 
job-8793,3,12,2,439277,542372,542848,103095,476,439964,false,C-m-1 C-m-1 
job-8795,3,8,1,439399,542848,542893,103449,45,439503,false,L-s-0 
job-8794,6,11,1,439345,542848,542898,103503,50,439395,false,L-m-0 
job-8796,5,8,3,439449,542848,542942,103399,94,439715,false,L-l-0 L-l-0 C-m-0 
job-8797,4,8,2,439492,542848,543127,103356,279,439985,false,C-m-1 C-m-1 
job-8799,2,11,3,439580,543127,543161,103547,34,439853,false,L-s-0 L-m-0 L-m-0 
job-8798,2,9,5,439530,543127,543172,103597,45,439845,false,L-l-0 L-l-0 L-l-0 L-l-0 L-l-0 
job-8802,6,10,3,439740,543172,543193,103432,21,439768,false,L-l-0 C-l-0 C-l-0 
job-8800,4,8,6,439642,543127,543203,103485,76,439736,false,C-m-0 L-m-0 C-l-1 C-m-0 C-l-1 C-l-1 
job-8801,1,6,7,439699,543172,543204,103473,32,439848,false,L-m-0 L-m-0 L-m-0 L-l-0 L-l-0 L-m-0 L-l-0 
job-8803,3,10,4,439793,543172,543376,103379,204,440228,false,C-m-2 C-m-2 L-s-0 L-l-0 
job-8804,5,7,2,439844,543376,543431,103532,55,440012,false,L-l-0 L-l-0 
job-8805,3,12,8,439896,543376,543449,103480,73,440266,false,L-s-0 C-l-0 C-l-0 C-l-0 C-l-0 L-m-0 C-s-1 L-m-0 
job-8806,1,12,8,439947,543376,543598,103429,222,440338,false,C-l-2 L-l-0 C-l-2 C-l-2 C-l-2 L-l-0 C-m-0 C-m-0 
job-8807,5,7,7,439991,543598,543618,103607,20,440083,false,C-l-1 L-l-0 C-l-0 C-l-1 C-l-0 L-l-0 L-m-0 
job-8808,6,4,6,440043,543618,543655,103575,37,440310,false,C-m-0 C-l-0 L-l-0 L-m-0 C-l-0 L-l-0 
job-8809,1,11,7,440086,543618,543693,103532,75,440316,false,C-m-1 C-m-1 L-s-0 C-m-0 C-m-0 L-m-0 L-m-0 
job-8810,5,10,1,440131,543693,543719,103562,26,440265,false,L-m-0 
job-8812,5,6,5,440235,543693,543902,103458,209,440588,false,C-l-1 C-l-0 C-l-0 C-l-1 L-l-0 
job-8811,2,11,3,440191,543693,544035,103502,342,440733,false,L-l-0 L-m-0 L-l-0 
job-8814,3,11,2,440327,544035,544058,103708,23,440611,false,L-l-0 L-l-0 
job-8813,3,12,2,440278,544035,544072,103757,37,440602,false,L-m-0 L-m-0 
job-8815,5,9,2,440368,544035,544092,103667,57,440620,false,C-m-0 L-l-0 
job-8816,4,9,8,440413,544035,544099,103622,64,440596,false,L-s-0 C-l-0 C-l-0 C-l-1 C-l-1 C-l-1 C-s-1 C-l-0 
job-8817,2,7,6,440464,544035,544227,103571,192,440865,false,C-m-1 C-m-1 C-m-1 C-m-1 C-m-0 L-m-0 
job-8818,6,5,2,440515,544227,544318,103712,91,440801,false,L-l-0 L-l-0 
job-8819,1,5,6,440576,544318,544366,103742,48,440822,false,L-m-0 L-m-0 L-m-0 L-m-0 L-m-0 L-m-0 
job-8820,5,7,3,440625,544318,544420,103693,102,440790,false,L-l-0 L-l-0 C-m-0 
job-8821,6,6,5,440674,544318,544439,103644,121,440933,false,C-m-1 C-l-0 C-l-1 C-l-1 C-l-0 
job-8822,3,5,2,440721,544366,544476,103645,110,441012,false,L-s-0 C-m-0 
job-8824,3,9,6,440828,544476,544503,103648,27,441044,false,L-m-0 L-l-0 L-l-0 L-m-0 L-l-0 L-l-0 
job-8823,2,4,1,440765,544476,544577,103711,101,441115,false,L-s-0 
job-8825,6,5,7,440873,544476,544803,103603,327,441271,false,C-l-0 C-l-2 C-l-2 C-l-0 C-l-1 C-l-1 C-m-0 
job-8827,4,9,5,440969,544803,544838,103834,35,441137,false,L-l-0 L-l-0 L-m-0 L-m-0 L-l-0 
job-8829,6,7,5,441050,544803,544851,103753,48,441269,false,C-m-0 C-l-2 C-l-1 C-l-1 C-l-2 
job-8828,2,11,4,441013,544803,544934,103790,131,441242,false,C-l-0 C-l-0 C-l-0 C-l-0 
job-8826,1,9,1,440916,544803,544963,103887,160,441341,false,L-s-0 
job-8831,6,12,2,441152,544934,544965,103782,31,441313,false,C-l-0 C-l-0 
job-8830,4,9,6,441096,544934,544965,103838,31,441244,false,L-m-0 L-m-0 L-l-0 C-s-1 L-l-0 L-l-0 
job-8832,1,5,2,441211,544963,544977,103752,14,441293,false,L-s-0 L-s-0 
job-8833,4,12,8,441267,544963,545026,103696,63,441459,false,C-l-2 C-l-1 C-l-2 C-l-1 C-l-2 C-m-0 C-l-1 C-m-0 
job-8834,6,5,8,441325,545026,545087,103701,61,441403,false,L-l-0 C-l-0 C-l-2 C-l-2 C-l-0 L-l-0 C-m-0 L-m-0 
job-8836,3,12,6,441407,545087,545196,103680,109,441792,false,L-s-0 C-l-1 C-l-1 C-s-1 C-l-1 C-l-1 
job-8837,4,10,4,441461,545196,545236,103735,40,441611,false,C-m-1 C-m-1 L-s-0 C-s-1 
job-8835,6,5,5,441361,545087,545238,103726,151,441789,false,L-m-0 C-l-0 L-l-0 L-l-0 C-l-0 
job-8838,5,8,8,441509,545238,545265,103729,27,441558,false,L-l-0 C-l-0 C-l-1 C-l-1 C-l-0 L-l-0 C-m-0 L-m-0 
job-8839,3,7,7,441558,545238,545283,103680,45,441728,false,L-s-0 C-l-2 C-l-2 C-m-0 C-l-2 C-l-2 L-m-0 
job-8840,1,10,5,441608,545283,545296,103675,13,441863,false,L-s-0 L-l-0 L-l-0 L-l-0 L-l-0 
job-8841,3,6,3,441668,545283,545429,103615,146,441825,false,L-s-0 L-l-0 L-m-0 
job-8842,2,11,7,441717,545429,545443,103712,14,441827,false,L-m-0 L-l-0 L-l-0 L-s-0 L-l-0 L-l-0 L-m-0 
job-8843,2,12,3,441763,545429,545469,103666,40,442093,false,C-l-0 C-l-0 C-l-0 
job-8845,3,12,5,441874,545429,545491,103555,62,442152,false,C-l-1 C-l-1 C-l-1 C-s-0 C-l-1 
job-8844,2,12,2,441818,545429,545509,103611,80,442131,false,C-s-1 C-l-0 
job-8846,2,7,6,441915,545491,545524,103576,33,441988,false,L-s-0 C-l-0 C-l-0 C-l-0 C-l-0 C-l-0 
job-8848,3,10,7,442016,545509,545526,103493,17,442217,false,C-l-1 L-l-0 L-l-0 L-l-0 C-l-1 C-l-1 C-l-1 
job-8847,1,5,7,441967,545491,545598,103524,107,442130,false,L-s-0 L-m-0 L-m-0 L-m-0 L-m-0 L-m-0 L-m-0 
job-8850,6,11,5,442120,545526,545672,103406,146,442287,false,L-l-0 C-l-0 C-l-0 C-l-1 C-l-1 
job-8851,4,12,8,442168,545672,545702,103504,30,442449,false,L-l-0 L-l-0 C-l-2 C-s-1 C-l-2 L-m-0 C-l-2 L-m-0 
job-8849,1,8,2,442072,545526,545726,103454,200,442484,false,L-s-0 L-l-0 
job-8852,1,10,1,442234,545726,545775,103492,49,442500,false,L-s-0 
job-8853,2,8,5,442290,545726,545855,103436,129,442502,false,L-l-0 L-l-0 L-l-0 L-l-0 L-l-0 
job-8855,2,11,2,442397,545855,545879,103458,24,442507,false,L-l-0 L-l-0 
job-8854,4,12,2,442347,545855,545900,103508,45,442469,false,L-m-0 L-m-0 
job-8856,3,6,7,442458,545855,546164,103397,309,442955,false,L-s-0 C-l-0 C-l-0 C-l-0 C-l-0 L-l-0 L-l-0 
job-8857,5,12,3,442495,546164,546253,103669,89,442610,false,L-l-0 L-m-0 L-l-0 
job-8858,4,11,5,442531,546253,546266,103722,13,442732,false,L-m-0 L-l-0 L-l-0 L-l-0 L-m-0 
job-8859,3,11,6,442579,546253,546302,103674,49,442814,false,L-s-0 C-l-0 C-l-0 C-s-0 C-l-0 C-l-0 
job-8860,1,6,1,442624,546253,546491,103629,238,443036,false,C-s-1 
job-8861,3,7,6,442677,546491,546509,103814,18,442986,false,L-m-0 L-l-0 L-l-0 L-l-0 L-m-0 L-l-0 
job-8862,3,5,2,442718,546491,546522,103773,31,442928,false,L-s-0 C-s-1 
job-8863,5,7,8,442770,546491,546645,103721,154,443070,false,C-m-1 C-l-2 C-l-1 C-l-2 C-l-1 C-l-0 C-l-0 C-m-0 
job-8865,2,10,5,442877,546645,546685,103768,40,442984,false,L-l-0 L-l-0 L-l-0 C-s-1 L-l-0 
job-8866,6,10,7,442934,546645,546706,103711,61,443125,false,C-m-0 C-l-1 C-l-1 C-l-2 C-l-0 C-l-0 C-l-2 
job-8864,4,12,3,442823,546645,546738,103822,93,443089,false,L-m-0 L-m-0 L-s-0 
job-8868,2,9,8,443028,546706,546865,103678,159,443324,false,C-l-0 L-l-0 C-l-2 C-l-0 C-l-0 C-l-0 C-l-0 C-m-0 
job-8869,6,9,2,443075,546865,546929,103790,64,443217,false,C-m-1 L-m-0 
job-8867,5,6,5,442976,546706,546943,103730,237,443318,false,L-l-0 C-l-2 L-l-0 C-m-0 C-l-2 
job-8870,5,11,8,443135,546943,546960,103808,17,443430,false,C-m-0 C-l-0 C-l-0 C-l-1 C-l-1 L-l-0 L-m-0 L-l-0 
job-8873,6,9,6,443282,546960,546985,103678,25,443447,false,C-l-0 C-l-0 C-l-1 C-l-2 C-l-2 C-l-1 
job-8874,4,9,4,443336,546960,547024,103624,64,443682,false,C-m-0 C-m-1 C-m-0 C-m-1 
job-8871,2,4,2,443186,546960,547076,103774,116,443463,false,L-s-0 L-s-0 
job-8875,4,5,7,443386,546985,547096,103599,111,443571,false,C-l-0 C-l-2 C-l-0 C-l-2 C-l-0 C-l-2 C-s-1 
job-8872,4,6,5,443231,546960,547105,103729,145,443388,false,L-l-0 L-m-0 L-m-0 L-l-0 L-l-0 
job-8876,2,8,8,443441,546985,547203,103544,218,443807,false,C-l-1 C-l-1 C-l-1 C-l-1 C-s-2 C-l-1 C-s-2 C-l-1 
job-8877,3,6,2,443480,547203,547222,103723,19,443782,false,L-m-0 L-m-0 
job-8879,4,5,6,443581,547222,547382,103641,160,443849,false,L-m-0 L-l-0 L-m-0 C-s-1 L-l-0 L-l-0 
job-8878,1,4,1,443528,547222,547474,103694,252,444013,false,L-s-0 
job-8880,4,6,3,443630,547474,547495,103844,21,443947,false,L-l-0 L-l-0 L-l-0 
job-8882,3,6,8,443726,547474,547553,103748,79,444065,false,C-l-0 C-l-1 C-l-1 C-l-1 C-l-0 C-l-1 C-l-0 C-l-0 
job-8881,3,12,2,443668,547474,547647,103806,173,444082,false,L-m-0 L-m-0 
job-8885,6,4,5,443878,547647,547734,103769,87,444015,false,C-l-0 C-l-1 C-l-0 C-m-0 C-l-1 
job-8883,2,8,1,443770,547647,547769,103877,122,444003,false,L-s-0 
job-8884,2,6,8,443830,547647,548066,103817,419,444483,false,L-m-0 L-m-0 L-l-0 L-l-0 L-l-0 L-s-0 L-l-0 L-l-0 
job-8886,2,8,7,443937,548066,548120,104129,54,444211,false,L-l-0 L-l-0 L-s-0 L-l-0 L-l-0 L-s-0 L-l-0 
job-8887,4,7,5,443991,548066,548203,104075,137,444401,false,L-m-0 C-l-0 C-l-0 L-m-0 C-l-0 
job-8888,1,4,7,444045,548203,548220,104158,17,444087,false,L-m-0 L-m-0 L-m-0 L-m-0 L-m-0 L-m-0 L-m-0 
job-8890,6,8,8,444145,548203,548247,104058,44,444350,false,C-m-0 C-l-0 C-l-0 C-l-2 C-l-1 C-l-1 C-l-2 C-m-1 
job-8889,4,4,2,444090,548203,548540,104113,337,444609,false,L-l-0 L-l-0 
job-8891,1,4,5,444203,548540,548560,104337,20,444380,false,L-m-0 L-m-0 L-m-0 L-m-0 L-m-0 
job-8892,1,9,4,444247,548540,548665,104293,125,444572,false,L-l-0 L-l-0 L-l-0 L-m-0 
job-8893,3,10,7,444301,548540,548864,104239,324,444863,false,L-s-0 L-l-0 C-l-0 C-l-0 C-l-0 L-l-0 C-l-0 
job-8894,4,4,5,444357,548864,548880,104507,16,444384,false,L-m-0 L-l-0 L-l-0 L-l-0 L-m-0 
job-8895,4,10,6,444406,548864,548979,104458,115,444742,false,C-m-0 C-l-1 L-s-0 C-m-0 C-l-1 C-l-1 
job-8896,1,8,1,444465,548864,548989,104399,125,444666,false,C-s-1 
job-8897,2,7,5,444509,548979,549049,104470,70,444706,false,L-m-0 L-m-0 L-m-0 L-m-0 C-s-1 
job-8898,1,6,2,444569,549049,549063,104480,14,444728,false,L-s-0 L-s-0 
job-8899,1,4,6,444628,549049,549090,104421,41,444845,false,L-m-0 L-s-0 L-m-0 L-m-0 L-m-0 L-m-0 
job-8900,3,4,8,444681,549049,549196,104368,147,444977,false,L-l-0 L-m-0 C-l-0 C-l-0 L-l-0 L-l-0 C-l-0 C-l-0 
job-8902,5,7,2,444784,549196,549219,104412,23,444975,false,C-l-0 C-l-0 
job-8901,5,4,3,444728,549196,549228,104468,32,444933,false,L-l-0 L-l-0 L-m-0 
job-8903,3,11,4,444826,549219,549232,104393,13,444891,false,L-s-0 C-m-0 C-m-0 L-m-0 
job-8904,6,7,8,444889,549219,549289,104330,70,445220,false,C-m-2 C-l-2 C-l-0 C-l-2 C-l-1 C-m-1 C-l-0 C-l-1 
job-8906,3,8,7,444992,549232,549308,104240,76,445082,false,L-s-0 C-s-1 C-s-0 C-m-0 C-m-0 C-s-2 L-m-0 
job-8905,5,4,3,444944,549228,549432,104284,204,445444,false,L-l-0 L-l-0 L-m-0 
job-8907,5,12,2,445054,549432,549446,104378,14,445296,false,L-l-0 L-l-0 
job-8908,2,4,8,445103,549432,549498,104329,66,445175,false,C-s-1 L-m-0 L-s-0 C-s-1 L-m-0 L-s-0 L-l-0 L-m-0 
job-8909,2,7,1,445153,549498,549549,104345,51,445337,false,L-s-0 
job-8910,4,8,4,445204,549498,549585,104294,87,445351,false,L-m-0 L-l-0 L-l-0 L-l-0 
job-8911,6,9,6,445246,549498,549629,104252,131,445407,false,C-l-0 C-l-2 C-l-1 C-l-0 C-l-2 C-l-1 
job-8912,6,9,8,445293,549629,549659,104336,30,445613,false,L-l-0 C-l-0 C-l-2 C-l-2 C-l-0 L-l-0 C-m-0 L-m-0 
job-8914,4,7,6,445391,549629,549682,104238,53,445463,false,C-s-1 C-l-1 C-l-1 C-m-2 C-l-1 C-m-2 
job-8913,1,5,8,445342,549629,549744,104287,115,445706,false,L-m-0 C-s-2 L-s-0 C-m-0 C-m-0 C-s-2 L-m-0 C-s-2 
job-8915,4,12,1,445439,549629,549833,104190,204,445856,false,C-s-0 
job-8916,1,8,7,445491,549833,549854,104342,21,445673,false,L-s-0 L-s-0 L-l-0 L-l-0 L-l-0 L-l-0 L-l-0 
job-8918,1,10,7,445597,549833,549886,104236,53,445859,false,C-m-0 C-m-1 C-m-0 C-m-1 C-m-1 L-m-0 C-m-0 
job-8917,1,11,3,445545,549833,549952,104288,119,445783,false,C-s-1 L-m-0 L-m-0 
job-8920,6,8,3,445687,549952,550000,104265,48,445832,false,L-l-0 L-m-0 L-l-0 
job-8919,3,5,1,445635,549952,550110,104317,158,445860,false,L-s-0 
job-8921,1,10,4,445737,550110,550132,104373,22,445993,false,L-l-0 L-l-0 L-l-0 L-l-0 
job-8922,6,11,2,445783,550110,550255,104327,145,445981,false,L-m-0 C-m-0 
job-8923,1,12,2,445828,550255,550295,104427,40,446023,false,L-m-0 L-m-0 
job-8926,2,9,7,445970,550255,550377,104285,122,446290,false,C-m-0 C-l-2 C-l-2 C-l-2 C-l-2 C-l-2 C-m-0 
job-8925,3,12,7,445925,550255,550437,104330,182,446254,false,L-s-0 C-l-0 C-l-0 C-l-0 C-l-0 L-l-0 L-l-0 
job-8924,6,8,2,445883,550255,550457,104372,202,446330,false,L-l-0 L-m-0 
job-8927,4,5,4,446020,550255,550493,104235,238,446557,false,C-m-0 C-l-1 C-l-1 C-l-1 
job-8928,4,5,4,446090,550493,550520,104403,27,446327,false,L-l-0 L-l-0 L-s-0 L-l-0 
job-8929,4,7,1,446134,550520,550533,104386,13,446397,false,L-s-0 
job-8930,4,6,7,446185,550520,550618,104335,98,446565,false,C-m-0 L-m-0 L-l-0 C-m-0 L-m-0 L-l-0 L-l-0 
job-8932,1,9,6,446296,550618,550672,104322,54,446593,false,L-s-0 L-l-0 L-l-0 L-l-0 L-l-0 L-l-0 
job-8931,4,7,1,446239,550520,550686,104281,166,446654,false,C-s-1 
job-8933,2,5,4,446349,550672,550686,104323,14,446400,false,L-m-0 L-m-0 L-m-0 L-m-0 
job-8934,6,5,1,446393,550672,550770,104279,98,446755,false,L-l-0 
job-8936,5,11,5,446495,550770,550789,104275,19,446590,false,L-m-0 L-l-0 C-l-0 C-l-0 C-m-0 
job-8935,4,6,3,446447,550672,550826,104225,154,446870,false,L-s-0 C-s-2 L-l-0 
job-8937,5,6,4,446545,550770,550859,104225,89,446925,false,C-l-2 C-l-1 C-l-1 C-l-2 
job-8938,2,12,7,446599,550770,550934,104171,164,447017,false,C-s-1 L-l-0 C-l-2 L-m-0 C-l-0 C-l-1 C-m-0 
job-8939,1,10,5,446644,550934,551037,104290,103,447040,false,L-s-0 L-l-0 L-l-0 L-l-0 L-l-0 
job-8942,4,7,8,446784,551037,551054,104253,17,446959,false,L-m-0 C-l-0 C-l-0 C-l-0 C-l-1 C-l-1 L-m-0 C-l-1 
job-8940,4,7,1,446695,551037,551138,104342,101,446898,false,L-s-0 
job-8943,2,9,5,446844,551138,551157,104294,19,447006,false,C-s-2 L-m-0 L-s-0 L-m-0 L-m-0 
job-8941,3,8,4,446741,551037,551173,104296,136,447038,false,L-l-0 L-l-0 L-l-0 L-l-0 
job-8944,6,7,8,446892,551138,551433,104246,295,447242,false,C-l-0 C-l-2 C-l-1 C-l-2 C-l-1 C-m-1 C-l-0 C-m-0 
job-8945,6,5,5,446942,551433,551488,104491,55,447196,false,L-m-0 C-l-0 L-l-0 L-l-0 C-l-0 
job-8946,3,9,7,446998,551433,551586,104435,153,447154,false,L-s-0 C-l-1 C-l-1 C-s-0 C-l-1 C-l-1 C-s-1 
job-8949,4,8,4,447166,551586,551629,104420,43,447416,false,L-s-0 C-l-0 C-l-0 C-l-0 
job-8947,2,9,2,447050,551586,551638,104536,52,447136,false,L-m-0 L-m-0 
job-8950,6,8,8,447227,551629,551691,104402,62,447514,false,C-l-0 C-l-2 C-l-2 C-l-1 C-l-0 C-m-1 C-l-1 C-m-0 
job-8948,3,6,4,447116,551586,551718,104470,132,447535,false,L-m-0 L-l-0 L-l-0 L-l-0 
job-8951,4,10,5,447269,551691,551725,104422,34,447434,false,L-s-0 C-l-0 C-l-0 L-m-0 C-l-0 
job-8952,2,6,2,447312,551691,551892,104379,201,447753,false,C-s-1 L-l-0 
job-8953,5,11,1,447360,551892,551961,104532,69,447721,false,L-m-0 
job-8954,1,7,8,447415,551892,552213,104477,321,447824,false,L-m-0 L-m-0 L-l-0 L-m-0 L-l-0 L-l-0 L-l-0 L-l-0 
job-8955,6,12,5,447469,551892,552400,104423,508,448132,false,L-l-0 C-l-0 C-l-1 C-l-1 C-l-0 
job-8956,1,5,6,447520,552400,552460,104880,60,447644,false,L-m-0 L-m-0 L-m-0 L-m-0 L-m-0 L-m-0 
job-8960,6,12,6,447730,552400,552476,104670,76,448072,false,C-l-0 C-l-0 C-l-2 C-l-2 C-l-1 C-l-1 
job-8961,3,7,8,447784,552460,552507,104676,47,447991,false,L-m-0 C-m-1 C-s-0 C-s-1 C-m-2 C-m-2 C-m-1 L-m-0 
job-8957,3,4,3,447570,552400,552507,104830,107,447768,false,L-l-0 L-l-0 L-l-0 
job-8959,6,5,1,447682,552400,552533,104718,133,447826,false,C-m-0 
job-8962,4,8,3,447848,552476,552536,104628,60,448014,false,C-l-0 C-l-0 C-l-0 
job-8958,2,7,5,447615,552400,552539,104785,139,447765,false,L-s-0 L-l-0 L-s-0 C-s-2 C-s-2 
job-8963,2,11,4,447887,552507,552612,104620,105,448265,false,C-m-0 C-s-1 L-m-0 L-m-0 
job-8964,5,4,3,447930,552507,552712,104577,205,448275,false,C-m-1 C-l-1 C-l-1 
job-8965,4,12,8,447972,552712,552723,104740,11,448160,false,L-m-0 L-m-0 L-l-0 L-l-0 C-m-1 L-s-0 L-l-0 C-m-1 
job-8966,3,6,4,448021,552712,552890,104691,178,448494,false,C-l-0 C-l-0 C-l-0 C-l-0 
job-8969,5,5,3,448166,552890,552911,104724,21,448471,false,L-m-0 L-l-0 C-m-0 
job-8968,1,10,7,448110,552890,552937,104780,47,448195,false,L-m-0 L-l-0 L-l-0 L-s-0 L-l-0 L-l-0 L-m-0 
job-8967,3,6,1,448064,552890,552942,104826,52,448149,false,L-s-0 
job-8970,1,4,5,448208,552890,552952,104682,62,448469,false,L-m-0 C-s-1 C-m-0 C-m-0 C-m-0 
job-8971,3,10,6,448251,552890,552953,104639,63,448395,false,C-s-0 C-l-0 C-l-0 C-s-1 C-l-0 C-l-0 
job-8972,4,4,2,448296,552890,553047,104594,157,448537,false,C-m-1 C-m-1 
job-8973,3,11,8,448357,552890,553068,104533,178,448551,false,C-l-1 C-l-1 C-l-2 C-l-2 C-l-2 C-l-1 C-l-2 C-l-1 
job-8975,6,12,4,448428,552953,553090,104525,137,448639,false,C-m-2 C-l-0 C-l-0 C-m-0 
job-8974,1,12,8,448392,552937,553097,104545,160,448635,false,C-s-2 L-l-0 L-l-0 L-l-0 C-m-0 L-l-0 L-m-0 L-m-0 
job-8976,3,12,6,448476,553068,553207,104592,139,448806,false,L-s-0 C-l-1 C-l-1 C-s-1 C-l-1 C-l-1 
job-8977,6,11,4,448531,553207,553249,104676,42,448641,false,L-m-0 L-l-0 L-l-0 C-m-0 
job-8978,4,4,2,448580,553207,553514,104627,307,449138,false,L-s-0 C-s-1 
job-8979,2,11,3,448629,553514,553541,104885,27,448753,false,L-m-0 L-m-0 L-s-0 
job-8980,1,8,4,448691,553541,553553,104850,12,448754,false,L-m-0 L-m-0 L-m-0 L-m-0 
job-8981,6,12,5,448747,553541,553635,104794,94,448907,false,L-l-0 C-l-1 L-l-0 C-m-0 C-l-1 
job-8982,6,8,1,448799,553635,553698,104836,63,449153,false,L-m-0 
job-8983,2,12,6,448846,553635,553797,104789,162,449278,false,L-l-0 L-s-0 L-m-0 L-l-0 L-l-0 L-l-0 
job-8984,2,4,3,448893,553797,553862,104904,65,449191,false,L-m-0 L-m-0 L-m-0 
job-8985,6,9,2,448946,553797,554116,104851,319,449461,false,L-l-0 L-l-0 
job-8986,2,4,1,449007,554116,554152,105109,36,449152,false,L-s-0 
job-8988,6,6,1,449101,554152,554235,105051,83,449206,false,L-l-0 
job-8990,3,10,6,449196,554235,554267,105039,32,449515,false,L-s-0 C-s-2 L-l-0 C-s-0 L-l-0 L-m-0 
job-8989,6,11,1,449150,554235,554292,105085,57,449208,false,L-l-0 
job-8987,5,7,1,449050,554116,554350,105066,234,449482,false,L-m-0 
job-8992,1,7,7,449287,554235,554449,104948,214,449618,false,C-m-0 C-m-1 C-m-1 C-m-0 C-m-0 C-m-1 C-m-1 
job-8993,5,10,4,449337,554235,554500,104898,265,449670,false,C-l-0 C-l-0 C-l-1 C-l-1 
job-8994,6,5,8,449375,554500,554544,105125,44,449464,false,L-l-0 L-l-0 C-l-0 C-l-1 C-l-1 C-m-1 C-l-0 L-m-0 
job-8991,5,4,1,449231,554235,554565,105004,330,449854,false,C-m-0 
job-8995,2,12,2,449435,554544,554571,105109,27,449546,false,L-s-0 C-m-0 
job-8996,3,12,3,449485,554544,554639,105059,95,449808,false,L-l-0 L-l-0 L-l-0 
job-8997,2,9,6,449525,554639,554653,105114,14,449693,false,L-s-0 L-l-0 L-l-0 L-l-0 L-l-0 L-l-0 
job-8999,5,10,3,449629,554639,554709,105010,70,449906,false,C-l-0 C-l-0 L-m-0 
job-8998,1,7,6,449581,554639,554817,105058,178,449875,false,L-m-0 C-s-1 L-m-0 L-m-0 C-s-1 L-s-0 
job-9001,6,7,4,449730,554817,554852,105087,35,449989,false,L-m-0 C-l-0 C-l-0 C-m-0 
job-9000,5,10,2,449679,554817,554882,105138,65,449830,false,L-l-0 L-l-0 
job-9003,5,8,3,449810,554817,554913,105007,96,450117,false,C-m-1 C-l-2 C-l-2 
job-9002,6,12,2,449774,554817,554988,105043,171,450101,false,C-l-1 C-l-1 
job-9004,5,6,5,449858,554988,554999,105130,11,449886,false,L-l-0 L-l-0 C-l-0 L-m-0 C-l-0 
job-9005,1,9,1,449907,554999,555035,105092,36,449977,false,L-s-0 
job-9007,1,6,7,450018,554999,555075,104981,76,450330,false,C-l-0 L-s-0 C-l-0 C-l-0 C-l-0 C-l-0 C-l-0 
job-9006,4,10,7,449961,554999,555110,105038,111,450358,false,L-m-0 L-l-0 L-l-0 C-m-0 L-m-0 L-l-0 C-m-0 
job-9008,6,9,4,450068,554999,555238,104931,239,450352,false,C-m-1 C-l-2 C-l-0 C-l-2 
job-9010,4,9,8,450193,555075,555311,104882,236,450678,false,L-s-0 C-l-1 C-l-0 C-s-1 C-l-1 C-l-1 C-s-2 C-s-0 
job-9009,5,6,1,450130,554999,555416,104869,417,450678,false,C-m-2 
job-9012,6,5,8,450302,555311,555478,105009,167,450583,false,L-l-0 L-l-0 C-l-0 C-l-0 C-l-1 C-l-2 C-l-2 C-l-1 
job-9011,5,12,1,450244,555311,555516,105067,205,450599,false,L-m-0 
job-9013,1,7,3,450356,555516,555526,105160,10,450393,false,L-m-0 L-m-0 L-m-0 
job-9014,2,5,5,450424,555516,555564,105092,48,450611,false,L-m-0 L-l-0 L-m-0 L-l-0 L-l-0 
job-9015,6,6,8,450480,555516,555875,105036,359,450867,false,L-l-0 C-l-1 C-l-0 C-l-2 C-l-0 C-m-0 C-l-2 C-l-1 
job-9016,4,5,1,450539,555875,555900,105336,25,450645,false,L-s-0 
job-9018,4,12,3,450636,555875,555961,105239,86,450870,false,C-l-0 C-l-0 C-l-0 
job-9017,5,8,3,450594,555875,555979,105281,104,450749,false,L-l-0 L-m-0 L-l-0 
job-9020,4,9,8,450732,555961,556008,105229,47,451041,false,L-s-0 C-l-0 C-m-2 C-l-0 C-l-0 C-m-2 C-m-1 C-m-1 
job-9019,5,4,5,450682,555875,556024,105193,149,451062,false,C-m-0 C-l-1 C-l-1 C-l-2 C-l-2 
job-9021,4,10,2,450791,555961,556595,105170,634,451707,false,C-s-2 C-s-1 
job-9022,4,6,7,450844,556595,556677,105751,82,450967,false,L-l-0 L-m-0 L-s-0 L-l-0 L-m-0 L-l-0 C-s-1 
job-9023,4,5,5,450905,556595,556837,105690,242,451209,false,C-m-0 C-l-1 C-l-1 C-m-0 C-l-1 
job-9026,5,8,6,451075,556837,556886,105762,49,451386,false,C-l-0 C-l-1 C-l-0 C-l-2 C-l-2 C-l-1 
job-9024,3,11,5,450961,556837,556922,105876,85,451232,false,L-l-0 L-s-0 L-l-0 L-l-0 L-l-0 
job-9027,6,9,5,451124,556886,557095,105762,209,451482,false,C-l-0 C-l-2 C-l-0 C-m-0 C-l-2 
job-9025,3,4,2,451019,556837,557129,105818,292,451569,false,L-m-0 L-m-0 
job-9029,6,5,7,451217,557129,557272,105912,143,451443,false,C-l-0 C-l-1 L-l-0 L-m-0 C-l-1 L-l-0 C-l-0 
job-9028,2,4,1,451165,557129,557279,105964,150,451437,false,L-s-0 
job-9030,4,12,4,451278,557129,557347,105851,218,451684,false,C-s-1 C-l-2 C-l-2 C-l-2 
job-9031,3,5,1,451330,557272,557356,105942,84,451610,false,L-m-0 
job-9032,6,8,5,451382,557272,557359,105890,87,451506,false,C-l-0 L-l-0 L-l-0 C-m-0 C-l-0 
job-9033,5,12,2,451434,557347,557369,105913,22,451562,false,C-m-1 L-m-0 
job-9034,6,5,8,451484,557359,557386,105875,27,451769,false,L-l-0 C-l-1 C-l-0 C-l-1 C-l-0 L-l-0 C-l-2 C-l-2 
job-9035,2,8,6,451532,557386,557398,105854,12,451751,false,L-l-0 L-l-0 L-l-0 L-l-0 L-l-0 L-l-0 
job-9037,6,7,1,451638,557386,557432,105748,46,451930,false,C-m-0 
job-9036,4,8,4,451587,557386,557486,105799,100,451892,false,L-m-0 L-m-0 L-s-0 C-s-1 
job-9038,1,7,8,451698,557486,557507,105788,21,451962,false,L-l-0 L-s-0 L-s-0 L-l-0 L-l-0 L-l-0 L-l-0 L-l-0 
job-9039,3,8,3,451745,557486,557536,105741,50,451871,false,C-s-1 L-m-0 L-m-0 
job-9040,2,8,6,451788,557486,557607,105698,121,451978,false,C-l-1 C-l-1 L-m-0 C-l-1 C-l-1 C-l-1 
job-9041,6,4,8,451833,557486,557737,105653,251,452305,false,C-l-2 C-l-2 L-l-0 C-l-0 C-l-0 C-m-0 C-m-2 C-m-1 
job-9042,1,7,2,451877,557737,557768,105860,31,451961,false,L-s-0 L-s-0 
job-9043,3,8,2,451925,557737,558158,105812,421,452425,false,L-m-0 L-m-0 
job-9044,4,5,6,451966,558158,558186,106192,28,452177,false,L-m-0 L-s-0 L-l-0 L-l-0 L-m-0 L-l-0 
job-9045,1,4,4,452010,558158,558265,106148,107,452415,false,C-s-1 C-s-1 C-s-1 C-s-1 
job-9046,1,4,1,452052,558158,558396,106106,238,452536,false,C-s-2 
job-9048,1,9,3,452160,558396,558412,106236,16,452247,false,L-m-0 L-l-0 L-l-0 
job-9047,2,4,7,452095,558396,558418,106301,22,452253,false,L-s-0 L-s-0 L-l-0 L-l-0 L-l-0 L-l-0 L-l-0 
job-9050,4,6,4,452243,558396,558429,106153,33,452382,false,C-s-2 C-l-0 C-l-0 C-l-0 
job-9049,4,7,8,452202,558396,558432,106194,36,452358,false,L-m-0 C-l-2 C-l-1 C-l-2 C-l-1 C-l-1 C-s-1 C-l-2 
job-9051,5,6,2,452301,558412,558436,106111,24,452384,false,C-m-0 C-m-1 
job-9053,6,12,4,452419,558436,558451,106017,15,452731,false,L-m-0 L-l-0 L-l-0 C-m-0 
job-9054,2,8,8,452475,558436,558481,105961,45,452662,false,C-l-0 C-l-0 C-l-0 L-m-0 C-m-0 C-l-0 C-l-0 C-l-0 
job-9052,1,6,2,452358,558436,558534,106078,98,452637,false,L-s-0 L-s-0 
job-9055,2,10,6,452522,558436,558563,105914,127,452775,false,C-m-2 C-m-2 C-m-2 C-m-1 C-m-1 C-m-1 
job-9056,1,12,8,452570,558534,558571,105964,37,452773,false,L-m-0 L-l-0 L-l-0 L-s-0 L-l-0 L-l-0 C-s-1 L-m-0 
job-9057,2,12,6,452608,558534,558600,105926,66,452717,false,C-m-0 C-l-0 C-l-0 C-m-0 C-l-0 C-l-0 
job-9059,6,4,1,452700,558534,558712,105834,178,452894,false,C-l-1 
job-9058,2,8,3,452656,558534,558748,105878,214,453144,false,C-s-2 C-m-0 L-m-0 
job-9060,4,4,6,452759,558563,558763,105804,200,452961,false,C-m-1 C-l-2 C-l-2 C-m-1 C-l-1 C-l-2 
job-9061,4,6,1,452812,558763,558795,105951,32,452918,false,L-s-0 
job-9062,1,9,3,452860,558763,558881,105903,118,453112,false,L-m-0 L-m-0 L-m-0 
job-9064,3,12,2,452954,558763,558904,105809,141,453309,false,C-m-0 C-m-0 
job-9066,3,4,7,453051,558763,558908,105712,145,453431,false,C-l-0 C-l-0 C-l-2 C-l-2 C-l-2 C-l-0 C-l-0 
job-9063,4,4,4,452905,558763,558941,105858,178,453362,false,L-l-0 L-l-0 L-l-0 L-m-0 
job-9065,2,12,5,452999,558763,559024,105764,261,453314,false,C-s-1 C-l-1 C-l-1 C-l-1 C-l-1 
job-9067,4,4,2,453105,558763,559042,105658,279,453682,false,C-m-1 C-m-1 
job-9068,4,11,3,453153,559024,559104,105871,80,453492,false,L-s-0 L-m-0 L-m-0 
job-9069,3,12,8,453201,559024,559172,105823,148,453509,false,C-l-0 L-l-0 C-l-0 L-l-0 L-l-0 C-l-0 C-l-0 L-l-0 
job-9070,3,6,6,453252,559172,559185,105920,13,453424,false,L-m-0 L-l-0 L-l-0 L-m-0 L-l-0 L-l-0 
job-9071,1,11,3,453292,559172,559277,105880,105,453628,false,C-s-1 L-m-0 L-s-0 
job-9072,2,5,2,453336,559277,559318,105941,41,453533,false,L-s-0 L-s-0 
job-9074,5,4,3,453447,559318,559348,105871,30,453589,false,L-l-0 L-l-0 C-m-0 
job-9076,4,8,8,453536,559318,559488,105782,170,453941,false,C-s-0 C-l-1 C-l-1 C-l-0 C-l-1 C-l-0 C-s-1 C-l-0 
job-9075,4,11,1,453491,559318,559489,105827,171,453955,false,L-s-0 
job-9073,3,8,2,453399,559277,559502,105878,225,453689,false,L-m-0 L-m-0 
job-9077,3,6,3,453597,559318,559576,105721,258,454011,false,C-m-1 C-m-1 C-m-0 
job-9078,6,4,7,453650,559488,559583,105838,95,453929,false,C-l-0 C-l-1 L-l-0 C-m-2 C-l-1 L-l-0 C-l-0 
job-9079,4,7,4,453693,559488,559609,105795,121,454072,false,C-l-2 C-m-0 C-l-2 C-l-2 
job-9080,4,8,2,453741,559576,559613,105835,37,454037,false,L-s-0 C-m-0 
job-9081,6,5,5,453782,559583,559727,105801,144,454154,false,L-l-0 C-l-1 L-l-0 L-m-0 C-l-1 
job-9083,6,12,7,453875,559727,559876,105852,149,454057,false,L-l-0 C-l-1 C-l-2 L-m-0 C-l-1 C-l-2 L-l-0 
job-9082,3,8,6,453825,559583,559883,105758,300,454287,false,C-m-1 C-l-0 C-l-0 C-m-1 C-l-0 C-l-0 
job-9084,3,7,1,453929,559876,559916,105947,40,454007,false,L-s-0 
job-9086,4,6,8,454018,559876,560172,105858,296,454447,false,C-s-0 C-l-2 C-l-1 C-l-2 C-l-2 C-l-1 C-s-2 C-l-1 
job-9087,5,9,5,454062,560172,560182,106110,10,454140,false,C-m-0 C-l-1 C-l-0 C-l-0 C-l-1 
job-9085,4,8,6,453975,559876,560193,105901,317,454359,false,L-m-0 L-l-0 L-l-0 L-m-0 C-s-1 L-l-0 
job-9088,5,10,8,454110,560182,560251,106072,69,454271,false,C-m-1 C-l-2 C-l-1 C-l-1 C-l-2 C-l-0 C-l-0 C-m-0 
job-9089,5,11,6,454144,560251,560321,106107,70,454365,false,L-m-0 C-l-0 C-l-0 C-m-0 L-l-0 L-l-0 
job-9090,6,4,5,454189,560251,560387,106062,136,454401,false,C-m-1 C-l-1 C-l-2 C-l-2 C-l-1 
job-9092,4,4,7,454279,560321,560418,106042,97,454593,false,C-m-0 C-l-0 C-m-0 L-m-0 C-l-0 C-l-0 L-m-0 
job-9091,1,9,8,454238,560321,560421,106083,100,454492,false,C-m-1 C-m-1 L-l-0 L-l-0 L-l-0 L-l-0 L-s-0 L-l-0 
job-9093,1,11,4,454332,560321,560435,105989,114,454725,false,C-m-2 C-s-1 C-s-2 C-m-2 
job-9094,4,10,5,454381,560387,560537,106006,150,454558,false,C-l-1 C-m-2 C-l-1 C-l-1 C-m-1 
job-9095,2,6,2,454427,560387,560644,105960,257,454809,false,L-s-0 C-s-0 
job-9097,5,9,7,454523,560644,560675,106121,31,454627,false,C-m-1 L-l-0 C-l-1 C-l-2 L-l-0 C-l-2 C-l-1 
job-9096,5,6,4,454479,560418,560711,105939,293,455030,false,L-m-0 C-l-0 C-m-0 C-l-0 
job-9098,2,6,1,454578,560711,560778,106133,67,454880,false,L-s-0 
job-9101,1,8,7,454731,560711,560863,105980,152,455104,false,L-l-0 C-l-0 C-l-0 C-l-0 C-l-0 C-l-0 C-l-0 
job-9102,4,12,3,454786,560863,560927,106077,64,455104,false,C-m-1 C-m-1 C-s-2 
job-9103,3,11,8,454837,560863,560938,106026,75,454973,false,C-l-1 C-l-2 C-l-1 C-l-1 C-l-2 C-l-1 C-l-2 C-l-2 
job-9099,2,6,4,454628,560711,560944,106083,233,454869,false,L-m-0 L-m-0 L-s-0 L-m-0 
job-9100,2,10,5,454679,560711,560983,106032,272,455075,false,L-l-0 L-m-0 L-l-0 L-l-0 L-l-0 
job-9105,4,7,5,454944,560863,561081,105919,218,455390,false,C-m-0 C-l-0 C-l-0 C-m-0 C-l-0 
job-9104,3,4,2,454877,560863,561100,105986,237,455151,false,C-s-1 L-l-0 
job-9106,3,11,7,454995,561081,561105,106086,24,455300,false,L-s-0 L-m-0 L-l-0 L-l-0 L-l-0 L-m-0 C-s-2 
job-9107,1,10,2,455037,561105,561148,106068,43,455198,false,L-m-0 L-m-0 
job-9108,4,7,6,455086,561105,561211,106019,106,455413,false,L-s-0 L-l-0 L-m-0 C-s-1 L-l-0 L-l-0 
job-9109,5,4,2,455124,561105,561328,105981,223,455444,false,C-l-0 C-l-0 
job-9110,1,11,8,455165,561328,561355,106163,27,455448,false,L-s-0 L-l-0 L-l-0 L-l-0 L-l-0 L-m-0 C-s-1 L-m-0 
job-9112,4,6,6,455249,561328,561407,106079,79,455610,false,C-l-1 C-l-0 C-l-0 C-l-1 C-l-0 C-l-1 
job-9111,1,7,5,455200,561328,561528,106128,200,455631,false,C-m-0 L-m-0 C-m-0 C-m-0 C-m-0 
job-9114,6,7,1,455328,561328,561565,106000,237,455566,false,C-l-2 
job-9113,2,10,6,455295,561328,561726,106033,398,455791,false,C-m-2 C-m-1 C-m-2 C-m-2 C-m-1 C-m-1 
job-9115,6,4,4,455367,561726,561816,106359,90,455755,false,L-m-0 L-l-0 L-l-0 C-m-0 
job-9118,5,9,6,455526,561816,561850,106290,34,455707,false,C-l-2 C-l-0 C-l-1 C-l-2 C-l-1 C-l-0 
job-9117,1,10,7,455484,561816,561931,106332,115,455866,false,L-m-0 L-l-0 L-l-0 L-m-0 L-l-0 L-l-0 L-m-0 
job-9116,1,5,2,455424,561816,561952,106392,136,455650,false,L-s-0 L-s-0 
job-9119,1,7,4,455571,561850,562092,106279,242,455862,false,C-m-0 L-l-0 C-m-0 C-m-0 
job-9120,2,5,7,455629,562092,562170,106463,78,455863,false,L-l-0 L-l-0 L-s-0 L-l-0 L-l-0 L-s-0 L-l-0 
job-9121,6,12,2,455678,562092,562184,106414,92,456043,false,L-m-0 C-m-0 
job-9122,3,7,5,455724,562170,562184,106446,14,455994,false,L-l-0 L-l-0 L-l-0 L-s-0 L-l-0 
job-9123,2,5,8,455771,562170,562191,106399,21,455994,false,C-l-0 C-l-0 C-l-0 L-m-0 C-l-0 C-m-0 C-l-0 C-l-0 
job-9124,1,8,2,455820,562170,562228,106350,58,456137,false,L-s-0 C-s-1 
job-9125,1,5,2,455869,562170,562269,106301,99,456115,false,C-s-0 C-s-1 
job-9126,6,8,3,455903,562269,562282,106366,13,456207,false,L-l-0 L-l-0 L-m-0 
job-9127,4,7,7,455952,562269,562292,106317,23,455992,false,L-s-0 C-l-2 C-l-1 C-l-2 C-l-1 C-l-2 C-l-1 
job-9128,1,7,7,456010,562269,562330,106259,61,456323,false,C-l-0 L-m-0 L-m-0 C-l-0 C-l-0 C-l-0 C-l-0 
job-9129,5,7,7,456071,562282,562468,106211,186,456356,false,C-m-0 L-l-0 C-m-2 C-m-1 C-l-0 L-l-0 L-m-0 
job-9130,1,4,6,456106,562468,562496,106362,28,456327,false,L-m-0 L-m-0 L-m-0 L-m-0 L-m-0 L-m-0 
job-9134,5,7,7,456310,562496,562510,106186,14,456495,false,C-m-0 C-l-1 C-l-1 C-l-2 C-l-0 C-l-2 C-l-0 
job-9132,3,5,4,456209,562496,562511,106287,15,456515,false,L-l-0 L-l-0 L-l-0 L-l-0 
job-9131,2,7,1,456160,562496,562553,106336,57,456473,false,L-s-0 
job-9135,2,11,5,456352,562496,562573,106144,77,456477,false,C-s-1 C-l-0 C-l-1 C-m-0 C-l-2 
job-9133,1,4,8,456261,562496,562647,106235,151,456552,false,L-m-0 L-m-0 L-m-0 L-m-0 L-m-0 L-s-0 L-m-0 L-s-0 
job-9136,4,10,2,456392,562496,562663,106104,167,456684,false,C-m-1 C-m-1 
job-9137,2,6,1,456429,562647,562669,106218,22,456668,false,L-s-0 
job-9138,5,11,4,456485,562647,562719,106162,72,456806,false,L-m-0 L-l-0 L-l-0 C-m-0 
job-9139,3,4,6,456526,562647,562727,106121,80,456860,false,C-l-0 C-m-0 L-m-0 C-l-0 C-l-0 C-l-0 
job-9140,3,9,7,456577,562647,562778,106070,131,456914,false,C-l-1 C-l-2 C-l-2 C-l-1 C-l-2 C-l-2 C-l-1 
job-9141,1,12,3,456614,562727,562789,106113,62,456948,false,L-m-0 L-m-0 C-l-1 
job-9143,5,11,7,456717,562789,562806,106072,17,456849,false,C-m-0 L-l-0 C-l-1 C-l-0 C-l-1 L-l-0 C-l-0 
job-9144,1,7,7,456768,562806,562830,106038,24,457016,false,L-l-0 L-l-0 L-m-0 L-l-0 L-l-0 L-l-0 L-m-0 
job-9142,6,12,1,456671,562789,562838,106118,49,456779,false,L-m-0 
job-9145,1,9,6,456815,562806,562897,105991,91,456913,false,L-l-0 C-l-0 C-l-0 C-l-0 C-l-0 C-l-0 
job-9146,6,5,1,456853,562897,562920,106044,23,457103,false,L-m-0 
job-9148,3,5,3,456940,562897,562967,105957,70,457059,false,L-s-0 L-l-0 L-l-0 
job-9147,3,10,2,456893,562897,562971,106004,74,457156,false,L-l-0 L-l-0 
job-9150,2,10,7,457057,562967,562980,105910,13,457301,false,L-m-0 L-l-0 L-m-0 C-m-0 C-l-0 L-l-0 L-m-0 
job-9149,5,10,3,457001,562897,562981,105896,84,457151,false,C-l-0 C-l-0 C-m-0 
job-9151,5,7,5,457109,562967,563120,105858,153,457310,false,C-m-1 C-l-1 C-l-1 C-l-2 C-l-2 
job-9152,2,9,4,457155,562967,563156,105812,189,457536,false,L-s-0 C-l-2 C-l-1 C-m-1 
job-9153,6,11,8,457213,563120,563276,105907,156,457582,false,L-l-0 L-l-0 C-l-0 C-l-2 C-l-1 C-m-1 C-l-0 L-m-0 
job-9154,3,10,2,457265,563276,563432,106011,156,457688,false,L-m-0 L-m-0 
job-9155,2,7,1,457307,563432,563458,106125,26,457494,false,L-s-0 
job-9157,4,4,8,457396,563432,563516,106036,84,457729,false,C-m-0 C-l-1 L-l-0 C-l-1 C-l-1 L-l-0 L-l-0 C-m-0 
job-9156,6,5,1,457357,563432,563573,106075,141,457637,false,L-m-0 
job-9158,2,12,6,457446,563573,563592,106127,19,457502,false,L-m-0 L-l-0 L-l-0 L-l-0 L-m-0 L-l-0 
job-9159,6,12,1,457509,563573,563694,106064,121,457794,false,C-m-0 
job-9160,2,8,8,457567,563573,563928,106006,355,457963,false,C-m-0 L-m-0 L-s-0 C-m-1 C-m-1 C-m-1 L-s-0 C-m-1 
job-9161,6,12,1,457614,563928,564077,106314,149,457894,false,L-m-0 
job-9162,5,10,1,457657,563928,564099,106271,171,457982,false,L-l-0 
job-9163,1,6,2,457707,564099,564148,106392,49,457998,false,L-s-0 L-s-0 
job-9165,2,12,6,457825,564148,564167,106323,19,457954,false,L-m-0 C-l-2 C-l-2 L-m-0 C-l-2 C-l-2 
job-9166,2,12,8,457872,564148,564167,106276,19,457945,false,C-l-0 C-l-1 C-l-0 C-l-1 C-l-1 C-l-0 C-l-0 C-l-1 
job-9167,4,6,7,457920,564148,564174,106228,26,458041,false,C-m-1 C-m-1 C-m-2 C-m-0 C-m-2 L-s-0 C-m-0 
job-9164,2,8,7,457761,564099,564181,106338,82,458071,false,L-l-0 L-l-0 L-l-0 L-m-0 L-l-0 L-l-0 L-l-0 
job-9168,6,5,6,457968,564167,564235,106199,68,458304,false,C-l-0 C-l-0 L-m-0 C-l-2 C-l-2 C-l-1 
job-9169,4,8,5,458023,564174,564280,106151,106,458246,false,C-m-1 C-l-1 L-s-0 C-m-1 C-s-1 
job-9170,5,5,4,458075,564181,564339,106106,158,458336,false,C-m-2 L-l-0 L-l-0 C-m-0 
job-9171,1,12,3,458125,564339,564528,106214,189,458418,false,L-l-0 L-l-0 L-l-0 
job-9172,2,4,3,458175,564528,564749,106353,221,458625,false,L-m-0 L-m-0 L-m-0 
job-9173,4,5,1,458237,564749,564800,106512,51,458530,false,L-s-0 
job-9177,1,12,8,458434,564749,564823,106315,74,458679,false,C-l-0 C-l-1 C-l-1 C-l-1 C-l-0 C-l-1 C-l-0 C-l-0 
job-9175,4,11,2,458331,564749,564865,106418,116,458484,false,C-m-0 C-m-0 
job-9179,4,9,6,458552,564800,564889,106248,89,458872,false,C-m-2 C-m-1 C-m-2 C-m-1 C-s-0 L-s-0 
job-9178,2,8,8,458498,564749,564924,106251,175,458812,false,C-s-1 C-l-2 C-l-2 C-l-2 C-l-2 C-l-2 C-s-1 C-l-2 
job-9181,5,6,4,458661,564924,564948,106263,24,458860,false,C-l-1 C-l-0 C-l-0 C-l-1 
job-9176,4,12,1,458371,564749,564963,106378,214,458829,false,C-s-2 
job-9180,1,11,1,458605,564924,564968,106319,44,458859,false,L-s-0 
job-9174,2,10,7,458288,564749,564972,106461,223,458667,false,L-m-0 L-l-0 L-l-0 L-m-0 L-l-0 L-l-0 L-m-0 
job-9182,6,9,1,458716,564963,564973,106247,10,458744,false,C-m-0 
job-9183,6,12,1,458774,564963,565088,106189,125,458960,false,C-m-1 
job-9184,6,10,2,458823,565088,565114,106265,26,459022,false,L-l-0 L-l-0 
job-9185,3,9,5,458874,565088,565356,106214,268,459370,false,L-s-0 C-m-1 L-m-0 L-m-0 C-m-1 
job-9186,1,5,8,458932,565356,565455,106424,99,459080,false,L-s-0 L-m-0 L-s-0 L-s-0 L-m-0 L-m-0 L-m-0 L-m-0 
job-9187,4,6,7,458979,565356,565608,106377,252,459322,false,L-l-0 C-l-1 C-l-1 C-s-1 C-l-1 L-l-0 L-l-0 
job-9188,2,7,2,459013,565608,565633,106595,25,459291,false,L-s-0 L-s-0 
job-9189,5,8,5,459056,565608,565652,106552,44,459294,false,L-m-0 L-l-0 C-l-0 C-l-0 L-l-0 
job-9190,1,11,3,459099,565652,565721,106553,69,459241,false,L-l-0 L-l-0 L-l-0 
job-9192,5,10,3,459192,565721,565753,106529,32,459424,false,L-l-0 L-l-0 C-m-0 
job-9191,5,12,1,459147,565721,565837,106574,116,459348,false,L-m-0 
job-9194,4,9,2,459303,565721,565903,106418,182,459774,false,C-m-1 C-m-1 
job-9193,4,12,7,459244,565721,565958,106477,237,459767,false,L-s-0 C-l-2 C-s-1 C-s-0 C-l-2 C-l-2 C-s-2 
job-9195,3,4,3,459347,565721,566021,106374,300,459702,false,C-m-2 L-m-0 C-m-0 
job-9196,4,9,6,459407,565903,566021,106496,118,459661,false,C-m-0 L-l-0 L-m-0 C-m-2 L-l-0 L-l-0 
job-9197,1,9,6,459464,565903,566190,106439,287,459878,false,C-m-0 C-m-1 C-m-1 C-m-2 C-m-1 L-m-0 
job-9198,6,4,6,459521,565958,566292,106437,334,459967,false,C-l-1 C-l-0 C-l-2 C-l-2 C-l-0 C-l-1 
job-9199,6,6,5,459572,566292,566304,106720,12,459648,false,L-m-0 C-l-0 L-l-0 L-l-0 C-l-0 
job-9202,6,10,7,459704,566292,566332,106588,40,459848,false,C-m-1 C-l-2 C-l-1 C-m-2 C-l-1 C-l-2 C-m-0 
job-9200,1,8,5,459616,566292,566382,106676,90,459838,false,C-s-1 L-m-0 L-m-0 C-s-1 L-s-0 
job-9201,3,6,2,459665,566292,566392,106627,100,459856,false,L-s-0 C-s-2 
job-9203,1,9,8,459753,566382,566415,106629,33,459819,false,L-m-0 C-s-2 L-l-0 L-s-0 L-l-0 L-l-0 L-l-0 L-l-0 
job-9204,6,12,7,459811,566382,566495,106571,113,460147,false,C-l-0 L-m-0 C-l-1 C-l-0 C-l-1 C-l-2 C-l-2 
job-9205,3,6,4,459867,566382,566497,106515,115,460000,false,C-m-0 C-m-1 C-m-1 C-m-0 
job-9206,1,11,8,459916,566495,566518,106579,23,460135,false,L-m-0 L-l-0 L-l-0 L-l-0 L-l-0 C-m-0 C-m-1 L-m-0 
job-9207,1,9,3,459962,566518,566641,106556,123,460122,false,L-m-0 L-m-0 L-m-0 
job-9208,3,4,1,460024,566641,566679,106617,38,460204,false,L-s-0 
job-9209,1,8,6,460075,566641,566953,106566,312,460480,false,L-l-0 L-s-0 L-l-0 L-l-0 L-l-0 L-l-0 
job-9210,6,9,1,460114,566953,567005,106839,52,460267,false,L-m-0 
job-9211,4,10,7,460165,566953,567402,106788,449,460885,false,C-l-0 C-l-0 L-l-0 L-l-0 C-l-0 L-l-0 L-s-0 
job-9213,3,11,6,460258,567402,567447,107144,45,460349,false,C-s-0 C-l-0 C-l-0 C-s-2 C-l-0 C-l-0 
job-9214,4,8,7,460296,567402,567489,107106,87,460574,false,C-m-0 C-l-1 C-m-0 C-m-1 C-l-1 C-l-1 C-m-1 
job-9212,4,7,7,460207,567402,567522,107195,120,460444,false,L-l-0 L-m-0 L-s-0 L-l-0 L-m-0 L-l-0 C-s-1 
job-9215,5,12,6,460350,567489,567526,107139,37,460684,false,C-l-0 C-l-1 C-l-2 C-l-2 C-l-1 C-l-0 
job-9216,4,7,6,460396,567489,568040,107093,551,461200,false,C-m-1 C-m-2 C-m-0 C-m-1 C-m-0 C-m-2 
job-9218,3,4,7,460491,568040,568051,107549,11,460603,false,L-m-0 C-l-1 C-l-1 L-m-0 C-l-1 C-l-1 C-s-1 
job-9217,2,8,8,460438,568040,568100,107602,60,460520,false,L-l-0 L-l-0 L-l-0 L-l-0 L-l-0 L-s-0 L-l-0 L-s-0 
job-9219,5,4,2,460541,568040,568123,107499,83,460879,false,C-l-0 C-l-0 
job-9220,2,10,1,460590,568123,568370,107533,247,460843,false,L-s-0 
job-9222,5,7,2,460690,568370,568401,107680,31,460801,false,L-l-0 L-l-0 
job-9223,2,8,5,460740,568370,568413,107630,43,460948,false,L-s-0 C-s-1 L-s-0 C-s-1 L-l-0 
job-9221,1,5,6,460648,568370,568421,107722,51,460760,false,L-m-0 L-m-0 L-m-0 L-m-0 L-m-0 L-m-0 
job-9224,5,9,7,460794,568370,568495,107576,125,460981,false,C-m-0 C-l-1 C-l-0 C-l-2 C-l-1 C-l-2 C-l-0 
job-9225,4,12,2,460834,568495,568530,107661,35,461064,false,L-m-0 L-m-0 
job-9226,5,10,1,460883,568495,568575,107612,80,461034,false,L-l-0 
job-9227,1,8,3,460948,568575,569160,107627,585,461696,false,L-m-0 L-m-0 L-m-0 
job-9229,5,4,6,461040,569160,569178,108120,18,461060,false,L-m-0 C-l-0 C-l-0 C-m-0 L-l-0 L-l-0 
job-9230,1,5,8,461090,569178,569318,108088,140,461279,false,L-l-0 L-l-0 L-l-0 L-l-0 L-l-0 L-l-0 L-l-0 L-l-0 
job-9228,4,9,1,461000,569160,569360,108160,200,461435,false,L-s-0 
job-9232,3,8,6,461198,569318,569417,108120,99,461557,false,L-l-0 L-l-0 L-l-0 L-m-0 L-l-0 L-m-0 
job-9231,2,7,1,461149,569318,569443,108169,125,461305,false,L-m-0 
job-9233,6,5,1,461251,569318,569460,108067,142,461569,false,C-m-0 
job-9234,4,8,6,461302,569318,569649,108016,331,461684,false,C-l-1 C-l-0 C-l-1 C-l-1 C-l-0 C-l-0 
job-9235,6,5,4,461361,569649,569661,108288,12,461577,false,L-m-0 L-l-0 L-l-0 C-m-0 
job-9236,2,12,6,461402,569649,569986,108247,337,461926,false,C-m-0 C-l-0 C-l-0 C-l-0 C-l-0 L-m-0 
job-9238,5,8,2,461503,569986,570021,108483,35,461772,false,L-l-0 L-m-0 
job-9237,1,11,2,461450,569986,570045,108536,59,461521,false,L-m-0 L-m-0 
job-9239,1,4,4,461556,570045,570058,108489,13,461781,false,L-s-0 L-s-0 L-s-0 L-s-0 
job-9240,5,9,8,461604,570045,570121,108441,76,461711,false,L-l-0 C-l-1 C-l-0 C-l-1 C-l-0 L-l-0 C-m-0 L-m-0 
job-9241,3,8,7,461651,570045,570138,108394,93,461757,false,C-s-1 C-l-2 C-l-2 C-m-0 C-l-2 C-l-2 L-m-0 
job-9242,2,10,5,461713,570138,570154,108425,16,461739,false,L-s-0 L-l-0 L-l-0 L-l-0 L-l-0 
job-9243,4,11,6,461764,570138,570203,108374,65,462119,false,L-m-0 C-l-0 C-l-0 L-m-0 C-l-0 C-s-1 
job-9244,4,11,4,461809,570203,570229,108394,26,462074,false,L-l-0 L-l-0 L-s-0 L-l-0 
job-9245,6,9,5,461857,570203,570326,108346,123,462097,false,L-m-0 C-l-1 C-l-1 C-l-0 C-l-0 
job-9246,1,5,1,461908,570326,570362,108418,36,462103,false,L-s-0 
job-9247,3,5,6,461960,570326,570469,108366,143,462223,false,L-m-0 L-s-0 L-l-0 L-m-0 L-l-0 L-l-0 
job-9248,1,9,6,462017,570469,570542,108452,73,462218,false,L-s-0 L-l-0 L-l-0 L-l-0 L-l-0 L-l-0 
job-9249,3,9,4,462064,570469,570574,108405,105,462467,false,L-m-0 L-m-0 C-m-0 C-m-0 
job-9250,1,9,8,462118,570542,570585,108424,43,462204,false,L-m-0 L-l-0 L-l-0 L-l-0 L-l-0 L-s-0 C-m-0 L-l-0 
job-9251,5,5,1,462172,570585,570609,108413,24,462365,false,L-m-0 
job-9252,4,11,5,462212,570585,571116,108373,531,462765,false,C-s-2 L-l-0 L-l-0 L-s-0 L-l-0 
job-9254,6,5,7,462330,571116,571230,108786,114,462677,false,C-l-1 C-l-0 C-l-1 C-m-0 C-l-0 L-l-0 L-m-0 
job-9253,1,9,4,462284,571116,571253,108832,137,462472,false,L-l-0 L-l-0 L-l-0 L-l-0 
job-9255,2,10,3,462382,571116,571270,108734,154,462623,false,L-s-0 C-m-0 L-m-0 
job-9257,3,12,3,462490,571253,571364,108763,111,462744,false,C-m-0 L-m-0 L-l-0 
job-9256,1,10,7,462427,571116,571373,108689,257,462858,false,C-m-1 C-l-2 C-l-2 C-m-1 C-l-2 C-l-2 C-m-1 
job-9258,4,4,5,462544,571364,571419,108820,55,462638,false,L-l-0 L-l-0 C-l-2 L-l-0 C-l-2 
job-9260,3,8,8,462644,571419,571443,108775,24,462788,false,L-m-0 L-l-0 C-s-1 L-l-0 L-l-0 L-s-0 L-l-0 L-m-0 
job-9259,1,7,1,462586,571364,571597,108778,233,462968,false,L-s-0 
job-9262,6,4,7,462747,571597,571673,108850,76,462847,false,L-l-0 C-l-1 C-l-0 L-m-0 C-l-0 L-l-0 C-l-1 
job-9264,3,9,1,462844,571673,571847,108829,174,463220,false,L-m-0 
job-9263,3,10,4,462798,571597,571851,108799,254,463325,false,C-l-2 C-l-2 C-l-2 C-l-2 
job-9265,4,7,4,462886,571847,571963,108961,116,463177,false,L-m-0 L-l-0 L-l-0 L-l-0 
job-9261,1,8,1,462699,571597,571982,108898,385,463191,false,L-s-0 
job-9266,3,5,4,462927,571963,571985,109036,22,462958,false,L-l-0 L-l-0 L-s-0 L-l-0 
job-9268,5,8,4,463028,571963,572149,108935,186,463372,false,C-l-1 C-l-0 C-l-0 C-l-1 
job-9267,2,11,5,462975,571963,572229,108988,266,463471,false,L-m-0 L-l-0 L-m-0 C-m-0 C-m-0 
job-9269,2,4,8,463070,571963,572394,108893,431,463574,false,C-s-1 C-l-1 C-s-1 C-l-0 C-m-0 L-m-0 C-m-0 L-m-0 
job-9270,5,9,6,463120,572394,572422,109274,28,463250,false,L-m-0 L-l-0 C-l-0 C-m-0 C-l-0 L-l-0 
job-9273,4,10,6,463263,572422,572436,109159,14,463377,false,C-s-1 C-l-1 C-l-1 L-m-0 C-l-1 L-m-0 
job-9271,1,8,2,463169,572422,572457,109253,35,463266,false,L-s-0 L-s-0 
job-9274,1,7,8,463303,572422,572477,109119,55,463480,false,L-l-0 C-l-0 C-l-0 C-l-0 C-l-0 C-l-0 C-l-0 L-l-0 
job-9275,1,8,8,463374,572477,572493,109103,16,463673,false,L-m-0 L-l-0 L-s-0 L-l-0 L-m-0 L-m-0 L-s-0 L-m-0 
job-9272,3,5,3,463219,572422,572496,109203,74,463400,false,L-l-0 L-l-0 L-l-0 
job-9276,2,7,8,463420,572477,572878,109057,401,463852,false,C-s-2 C-l-0 C-l-0 C-l-0 C-l-0 C-l-0 C-s-2 C-l-0 
job-9278,6,11,7,463525,572878,572888,109353,10,463813,false,C-l-0 C-l-1 C-l-0 C-l-2 C-l-2 C-l-1 C-m-0 
job-9277,2,10,6,463471,572878,572957,109407,79,463843,false,L-m-0 L-l-0 L-l-0 L-m-0 L-l-0 L-l-0 
job-9279,3,11,2,463589,572878,572972,109289,94,463976,false,L-s-0 L-m-0 
job-9280,5,12,8,463638,572888,573017,109250,129,463972,false,C-m-1 C-l-1 C-l-0 C-l-2 C-l-1 C-l-2 C-l-0 C-m-0 
job-9281,4,4,4,463676,572972,573018,109296,46,463770,false,L-s-0 L-l-0 L-l-0 L-l-0 
job-9282,6,11,5,463719,573017,573119,109298,102,463969,false,C-l-0 C-l-1 C-l-0 L-m-0 C-l-1 
job-9283,6,5,6,463764,573018,573145,109254,127,464033,false,C-m-1 L-l-0 C-l-2 C-m-0 C-l-2 L-l-0 
job-9284,1,10,8,463802,573119,573226,109317,107,463985,false,L-m-0 L-m-0 L-m-0 C-m-1 C-m-0 C-m-0 L-s-0 C-m-1 
job-9285,3,8,8,463873,573119,573229,109246,110,464206,false,C-l-0 C-l-1 C-l-0 C-l-1 C-l-1 C-l-0 C-l-0 C-l-1 
job-9288,3,7,8,464038,573226,573246,109188,20,464343,false,C-s-1 C-l-2 C-l-2 C-l-2 C-l-2 C-m-0 C-m-0 L-m-0 
job-9286,1,8,2,463929,573226,573254,109297,28,464022,false,L-s-0 L-s-0 
job-9287,5,7,3,463978,573226,573282,109248,56,464226,false,L-l-0 L-m-0 L-l-0 
job-9289,2,10,6,464088,573226,573309,109138,83,464388,false,C-s-0 C-m-2 C-m-2 C-m-2 C-m-0 L-l-0 
job-9290,4,7,4,464143,573282,573316,109139,34,464303,false,C-m-0 L-l-0 L-l-0 L-s-0 
job-9292,4,10,2,464235,573282,573406,109047,124,464499,false,C-s-1 L-m-0 
job-9291,4,12,1,464190,573282,573497,109092,215,464526,false,L-m-0 
job-9293,6,12,5,464276,573282,573522,109006,240,464523,false,C-l-1 C-l-1 C-l-0 C-m-1 C-l-0 
job-9294,1,9,7,464326,573522,573545,109196,23,464422,false,L-m-0 L-l-0 L-l-0 L-l-0 L-m-0 L-l-0 L-m-0 
job-9295,1,9,6,464389,573522,573685,109133,163,464669,false,L-l-0 C-l-0 C-l-0 C-l-0 C-l-0 C-l-0 
job-9296,6,8,3,464437,573685,573734,109248,49,464764,false,L-l-0 L-l-0 L-m-0 
job-9298,6,10,4,464529,573685,573769,109156,84,464834,false,C-l-1 C-l-2 C-l-2 C-l-1 
job-9300,3,9,6,464650,573734,573797,109084,63,464744,false,L-m-0 L-l-0 L-l-0 L-m-0 L-l-0 L-l-0 
job-9297,6,10,2,464479,573685,573798,109206,113,464645,false,C-l-0 C-l-0 
job-9299,4,11,1,464585,573734,573830,109149,96,464947,false,L-s-0 
job-9301,2,8,1,464689,573797,573886,109108,89,465019,false,L-m-0 
job-9302,4,12,7,464746,573797,573926,109051,129,465008,false,L-l-0 L-l-0 L-m-0 L-l-0 C-l-1 C-l-1 C-l-1 
job-9303,6,9,3,464796,573926,573943,109130,17,464998,false,L-l-0 L-l-0 L-m-0 
job-9304,4,8,1,464844,573926,574272,109082,346,465259,false,L-s-0 
job-9305,6,5,1,464897,574272,574292,109375,20,465014,false,L-m-0 
job-9306,4,6,6,464949,574272,574305,109323,33,465090,false,L-s-0 L-l-0 C-m-0 C-m-0 L-l-0 L-l-0 
job-9307,4,7,1,464996,574292,574305,109296,13,465076,false,L-m-0 
job-9308,6,11,6,465047,574292,574409,109245,117,465430,false,C-l-2 C-l-1 C-l-0 C-l-2 C-l-1 C-l-0 
job-9309,4,7,8,465094,574292,574642,109198,350,465660,false,C-s-0 L-m-0 C-m-2 C-s-1 C-m-2 C-m-1 C-s-2 C-m-1 
job-9310,2,10,4,465136,574642,574733,109506,91,465389,false,L-l-0 L-l-0 L-l-0 L-l-0 
job-9311,4,10,6,465186,574642,574828,109456,186,465653,false,L-s-0 C-l-0 C-l-0 L-m-0 C-l-0 L-m-0 
job-9312,1,7,4,465242,574828,574868,109586,40,465303,false,L-m-0 L-m-0 L-m-0 L-m-0 
job-9313,2,7,1,465290,574828,574928,109538,100,465491,false,L-s-0 
job-9314,5,4,5,465349,574828,574931,109479,103,465704,false,L-l-0 C-l-0 C-l-0 C-m-0 L-l-0 
job-9315,5,5,7,465409,574868,574946,109459,78,465560,false,C-m-1 C-l-1 C-l-2 C-m-2 C-l-1 C-l-2 L-m-0 
job-9316,1,10,3,465459,574946,574960,109487,14,465685,false,L-m-0 L-m-0 L-m-0 
job-9318,4,7,5,465567,574946,575043,109379,97,465907,false,C-m-0 L-l-0 L-l-0 C-m-0 L-l-0 
job-9317,3,12,1,465516,574946,575114,109430,168,465842,false,L-s-0 
job-9319,6,10,3,465618,574946,575175,109328,229,465954,false,C-m-1 C-l-1 C-l-1 
job-9320,5,11,2,465675,575175,575201,109500,26,465899,false,L-l-0 L-l-0 
job-9321,6,7,5,465735,575175,575225,109440,50,465886,false,C-l-0 C-l-1 C-l-1 L-m-0 C-l-0 
job-9322,4,9,7,465774,575175,575273,109401,98,466095,false,L-s-0 C-l-2 C-l-2 C-m-0 C-l-2 C-s-1 C-m-0 
job-9323,2,8,7,465837,575273,575312,109436,39,466080,false,L-l-0 L-l-0 L-s-0 L-l-0 L-l-0 L-s-0 L-l-0 
job-9324,2,5,6,465887,575273,575474,109386,201,466106,false,L-l-0 L-m-0 L-m-0 C-s-1 L-m-0 C-s-1 
job-9325,3,8,4,465946,575474,575549,109528,75,466290,false,L-l-0 L-l-0 L-l-0 L-l-0 
job-9326,3,4,8,466003,575474,575576,109471,102,466246,false,L-s-0 C-l-0 C-l-0 C-l-0 C-l-0 L-m-0 C-s-1 L-m-0 
job-9327,3,12,5,466062,575549,575577,109487,28,466226,false,C-s-2 L-l-0 L-l-0 L-l-0 L-l-0 
job-9328,1,6,7,466118,575549,575585,109431,36,466355,false,L-s-0 C-m-0 L-m-0 C-s-1 C-m-0 L-m-0 C-m-0 
job-9329,3,12,5,466170,575549,575649,109379,100,466307,false,C-l-1 C-l-1 C-l-1 C-m-0 C-l-1 
job-9330,1,7,4,466215,575649,575665,109434,16,466267,false,L-m-0 L-m-0 L-m-0 L-m-0 
job-9332,2,9,8,466303,575649,575690,109346,41,466619,false,L-s-0 C-l-0 C-l-0 C-l-0 C-l-0 L-l-0 C-s-1 C-l-0 
job-9331,3,11,3,466256,575649,575776,109393,127,466587,false,L-l-0 L-l-0 L-l-0 
job-9334,5,8,3,466400,575776,575787,109376,11,466534,false,L-l-0 L-m-0 L-l-0 
job-9333,2,6,1,466345,575776,575788,109431,12,466544,false,L-s-0 
job-9335,3,12,4,466463,575776,575927,109313,151,466786,false,L-m-0 C-m-0 C-m-0 C-s-1 
job-9336,2,7,7,466513,575776,575936,109263,160,466910,false,L-s-0 C-m-0 L-l-0 C-s-0 C-s-2 C-s-0 C-s-2 
job-9337,3,7,6,466575,575927,575939,109352,12,466604,false,C-m-0 L-l-0 L-l-0 C-m-0 L-m-0 L-l-0 
job-9339,6,10,7,466681,575939,575954,109258,15,466965,false,L-l-0 C-l-1 L-l-0 C-l-2 C-l-1 C-l-2 L-m-0 
job-9338,6,4,3,466621,575927,575957,109306,30,466743,false,C-m-1 C-l-0 C-l-0 
job-9340,1,9,4,466738,575954,575983,109216,29,467014,false,C-m-1 C-m-1 L-m-0 L-m-0 
job-9342,2,9,8,466836,575983,576010,109147,27,466981,false,L-m-0 L-l-0 L-l-0 L-l-0 L-l-0 L-l-0 L-m-0 L-m-0 
job-9341,2,10,1,466785,575983,576026,109198,43,466870,false,L-s-0 
job-9343,3,4,2,466877,575983,576134,109106,151,467115,false,C-m-0 C-m-0 
job-9344,6,11,1,466921,576134,576194,109213,60,467052,false,L-m-0 
job-9345,5,7,8,466964,576134,576294,109170,160,467337,false,C-l-2 C-l-1 C-l-0 C-l-0 C-l-1 L-l-0 C-l-2 L-l-0 
job-9346,1,8,6,467019,576294,576430,109275,136,467385,false,L-l-0 L-l-0 L-l-0 L-l-0 L-l-0 L-l-0 
job-9347,2,4,7,467091,576430,576450,109339,20,467310,false,L-s-0 L-s-0 L-l-0 L-l-0 L-l-0 L-l-0 L-l-0 
job-9348,3,11,4,467137,576430,576589,109293,159,467407,false,L-m-0 C-s-2 C-s-0 L-m-0 
job-9349,4,12,7,467188,576589,576628,109401,39,467410,false,L-l-0 L-m-0 L-s-0 L-l-0 L-m-0 L-l-0 C-s-2 
job-9350,1,10,2,467235,576589,576668,109354,79,467454,false,C-m-0 C-m-0 
job-9351,5,8,4,467279,576668,576679,109389,11,467551,false,L-m-0 L-l-0 L-l-0 C-m-0 
job-9352,4,11,8,467328,576668,576847,109340,179,467717,false,L-s-0 C-l-2 C-l-2 C-l-2 C-m-2 C-s-1 C-s-2 C-m-2 
job-9353,6,4,7,467380,576679,576926,109299,247,467799,false,L-l-0 C-l-0 C-l-1 C-l-1 C-l-0 L-l-0 L-m-0 
job-9354,3,12,7,467432,576926,576946,109494,20,467499,false,L-s-0 L-l-0 L-l-0 L-m-0 L-l-0 L-l-0 L-m-0 
job-9355,4,9,4,467478,576926,577142,109448,216,467920,false,C-s-1 C-l-1 C-l-1 C-l-1 
job-9356,6,10,6,467516,577142,577165,109626,23,467705,false,C-m-0 C-l-0 L-l-0 L-m-0 C-l-0 L-l-0 
job-9357,5,10,8,467571,577165,577398,109594,233,467806,false,L-l-0 C-l-0 C-l-1 C-l-1 C-l-0 L-l-0 C-m-0 L-m-0 
job-9358,6,7,6,467608,577398,577509,109790,111,467755,false,C-m-0 C-l-0 L-l-0 L-m-0 C-l-0 L-l-0 
job-9360,2,5,8,467706,577509,577534,109803,25,467934,false,L-m-0 L-m-0 L-l-0 L-m-0 L-l-0 L-l-0 L-l-0 L-l-0 
job-9359,4,11,1,467664,577509,577616,109845,107,467960,false,L-s-0 
job-9361,4,11,1,467742,577509,577700,109767,191,467941,false,C-s-1 
job-9362,4,6,7,467780,577700,577713,109920,13,467819,false,L-l-0 L-m-0 L-s-0 L-l-0 L-m-0 L-l-0 C-s-1 
job-9363,2,6,4,467847,577700,577777,109853,77,468145,false,C-m-0 C-m-0 C-m-0 C-m-0 
job-9365,6,4,6,467939,577700,577845,109761,145,468343,false,C-l-2 C-l-2 C-l-1 C-m-1 C-l-1 C-m-2 
job-9364,3,10,4,467888,577700,577867,109812,167,468164,false,C-l-0 C-l-0 C-l-0 C-l-0 
job-9366,5,11,7,467982,577845,578051,109863,206,468243,false,L-m-0 L-l-0 C-l-1 C-l-2 C-l-1 L-l-0 C-l-2 
job-9367,4,4,1,468031,578051,578101,110020,50,468334,false,L-s-0 
job-9368,2,9,2,468084,578051,578104,109967,53,468417,false,L-m-0 L-m-0 
job-9371,6,12,8,468229,578104,578165,109875,61,468560,false,L-l-0 C-l-0 C-l-0 C-l-2 C-l-1 C-l-1 C-l-2 L-l-0 
job-9372,5,5,7,468279,578165,578267,109886,102,468508,false,L-l-0 L-l-0 C-l-1 C-l-2 C-l-1 C-l-2 C-m-0 
job-9369,4,5,1,468130,578104,578321,109974,217,468434,false,L-s-0 
job-9373,1,9,6,468324,578267,578380,109943,113,468475,false,C-s-1 L-l-0 L-l-0 L-l-0 L-l-0 L-l-0 
job-9376,5,5,4,468473,578380,578428,109907,48,468697,false,C-l-0 C-l-1 C-l-1 C-l-0 
job-9370,1,5,5,468184,578104,578461,109920,357,468652,false,L-m-0 L-m-0 L-m-0 L-m-0 L-m-0 
job-9378,3,10,5,468568,578380,578475,109812,95,468930,false,L-s-0 L-l-0 C-s-0 C-m-2 C-m-1 
job-9377,5,11,4,468518,578380,578477,109862,97,468738,false,C-l-2 C-m-2 C-l-2 C-m-1 
job-9375,4,5,2,468425,578380,578480,109955,100,468728,false,L-l-0 L-l-0 
job-9380,4,7,7,468666,578461,578486,109795,25,468948,false,L-m-0 C-l-0 C-l-0 C-l-1 C-l-0 C-l-1 L-m-0 
job-9381,6,11,1,468710,578477,578530,109767,53,469042,false,C-m-1 
job-9374,1,9,1,468376,578267,578536,109891,269,468848,false,C-s-2 
job-9379,3,10,2,468615,578380,578537,109765,157,469004,false,C-m-0 C-m-0 
job-9382,3,7,2,468756,578530,578554,109774,24,468876,false,L-s-0 C-s-2 
job-9383,1,11,3,468791,578530,578573,109739,43,469047,false,L-m-0 L-m-0 C-m-0 
job-9384,4,9,7,468840,578530,578595,109690,65,469121,false,L-l-0 L-l-0 L-m-0 C-l-0 C-l-0 L-l-0 C-l-0 
job-9385,3,10,8,468899,578530,578673,109631,143,469340,false,C-l-1 C-l-2 C-l-1 C-l-2 C-l-1 C-l-2 C-l-1 C-l-2 
job-9386,3,4,1,468944,578673,578692,109729,19,469084,false,L-s-0 
job-9387,6,12,1,468991,578673,578749,109682,76,469189,false,L-m-0 
job-9388,5,8,6,469034,578673,578841,109639,168,469211,false,C-l-0 C-l-0 L-l-0 C-l-1 C-l-1 L-l-0 
job-9389,3,4,2,469086,578673,578873,109587,200,469584,false,C-m-0 C-m-0 
job-9390,1,8,3,469144,578873,578897,109729,24,469425,false,L-m-0 L-m-0 L-m-0 
job-9392,5,11,4,469242,578873,578955,109631,82,469466,false,L-l-0 C-l-0 C-l-0 C-m-0 
job-9391,3,12,2,469194,578873,578991,109679,118,469337,false,L-l-0 L-l-0 
job-9393,2,11,2,469293,578991,579010,109698,19,469501,false,L-m-0 L-m-0 
job-9395,5,4,4,469398,578991,579011,109593,20,469439,false,C-l-0 C-l-2 C-l-2 C-l-0 
job-9396,6,11,8,469447,579011,579057,109564,46,469511,false,C-l-0 C-l-2 C-l-0 C-l-2 C-l-1 C-m-0 C-l-1 L-m-0 
job-9398,3,8,5,469559,579011,579134,109452,123,469908,false,C-m-1 C-m-2 C-s-1 C-m-1 C-m-2 
job-9394,4,11,2,469336,578991,579165,109655,174,469611,false,L-l-0 L-l-0 
job-9397,2,7,7,469504,579011,579223,109507,212,469750,false,L-m-0 L-l-0 L-l-0 C-s-0 L-s-0 C-s-0 C-m-0 
job-9399,3,5,8,469601,579223,579235,109622,12,469757,false,L-m-0 L-l-0 L-s-0 L-l-0 L-l-0 L-l-0 C-s-1 L-m-0 
job-9401,5,12,3,469688,579223,579276,109535,53,469985,false,C-m-1 C-l-2 C-l-2 
job-9400,2,11,3,469640,579223,579332,109583,109,470027,false,C-m-0 L-m-0 C-m-0 
job-9404,5,6,7,469839,579332,579347,109493,15,470087,false,C-m-0 C-l-1 C-l-0 C-l-2 C-l-0 C-l-2 C-l-1 
job-9403,5,5,3,469792,579332,579399,109540,67,470016,false,L-l-0 L-m-0 L-l-0 
job-9402,3,8,1,469748,579332,579488,109584,156,470140,false,L-s-0 
job-9405,5,12,8,469891,579347,579570,109456,223,470151,false,C-m-1 C-l-0 C-l-1 C-l-2 C-l-0 C-l-2 C-l-1 C-m-0 
job-9406,6,12,7,469944,579570,579603,109626,33,470181,false,L-m-0 C-l-0 C-l-1 L-l-0 C-l-0 C-l-1 L-l-0 
job-9407,3,5,6,469983,579603,579613,109620,10,470051,false,L-m-0 L-l-0 L-l-0 L-m-0 L-l-0 L-l-0 
job-9409,1,12,6,470074,579603,579716,109529,113,470422,false,L-m-0 C-l-2 C-l-2 C-s-1 C-l-2 C-l-2 
job-9410,4,11,4,470121,579603,579732,109482,129,470472,false,C-m-1 C-m-1 C-m-2 C-m-2 
job-9408,4,4,6,470035,579603,579767,109568,164,470494,false,L-s-0 C-l-1 C-m-0 C-m-0 C-l-1 C-l-1 
job-9411,5,11,7,470180,579716,579996,109536,280,470574,false,L-l-0 C-l-2 C-l-0 C-l-2 C-l-0 L-l-0 L-m-0 
job-9412,5,11,2,470227,579996,580035,109769,39,470331,false,L-l-0 L-l-0 
job-9413,1,9,3,470268,579996,580067,109728,71,470364,false,L-s-0 L-l-0 L-l-0 
job-9415,3,7,6,470382,579996,580068,109614,72,470610,false,L-s-0 C-l-1 C-l-1 L-m-0 C-l-1 C-l-1 
job-9414,5,5,3,470329,579996,580100,109667,104,470631,false,L-m-0 C-l-0 C-l-0 
job-9416,5,8,4,470439,579996,580513,109557,517,471237,false,C-m-0 C-l-2 C-l-2 C-m-1 
job-9417,4,4,5,470481,580513,580535,110032,22,470525,false,L-m-0 L-l-0 L-l-0 L-l-0 L-m-0 
job-9419,5,11,8,470571,580535,580577,109964,42,470889,false,C-m-0 C-l-1 L-l-0 C-l-2 C-l-1 L-l-0 C-l-2 L-m-0 
job-9418,3,8,5,470524,580513,580629,109989,116,470678,false,L-s-0 C-l-0 C-l-0 C-l-0 C-l-0 
job-9420,2,9,6,470623,580535,580675,109912,140,470774,false,L-m-0 C-l-2 C-s-1 C-m-0 C-l-1 L-l-0 
job-9421,2,4,2,470666,580675,580718,110009,43,470845,false,L-s-0 L-s-0 
job-9422,4,5,6,470717,580675,580793,109958,118,470999,false,C-s-1 L-m-0 L-m-0 L-l-0 L-l-0 L-l-0 
job-9423,4,5,4,470766,580793,580819,110027,26,471063,false,L-l-0 L-l-0 L-s-0 L-l-0 
job-9424,3,9,6,470817,580793,580848,109976,55,470961,false,C-l-1 L-m-0 C-l-1 C-l-1 C-l-1 L-m-0 
job-9426,3,7,2,470903,580793,580902,109890,109,471252,false,C-m-1 C-m-1 
job-9425,4,9,5,470867,580793,580906,109926,113,471137,false,C-m-0 C-l-2 C-l-2 C-m-0 C-l-2 
job-9428,5,5,8,471001,580906,580926,109905,20,471198,false,C-m-0 C-l-0 C-l-0 C-l-2 C-l-1 C-l-2 C-m-1 C-l-1 
job-9427,3,10,7,470951,580902,580948,109951,46,471228,false,L-s-0 L-m-0 L-m-0 L-l-0 L-l-0 L-l-0 L-l-0 
job-9430,3,6,4,471096,580926,580991,109830,65,471316,false,C-l-0 C-l-0 C-l-0 C-l-0 
job-9431,1,12,3,471150,580926,581015,109776,89,471277,false,C-l-1 C-l-1 C-l-1 
job-9433,6,4,7,471233,580948,581046,109715,98,471567,false,C-m-1 L-l-0 C-l-2 C-m-0 C-l-2 L-l-0 L-m-0 
job-9432,1,11,2,471188,580926,581088,109738,162,471596,false,C-l-1 C-s-1 
job-9429,1,4,7,471047,580926,581112,109879,186,471337,false,C-s-2 L-m-0 L-m-0 C-s-2 C-s-2 L-s-0 C-s-2 
job-9435,6,6,8,471335,581112,581149,109777,37,471435,false,L-l-0 C-l-0 C-l-0 C-l-2 C-l-1 L-l-0 C-l-2 C-l-1 
job-9434,1,4,5,471288,581112,581268,109824,156,471544,false,L-m-0 L-m-0 L-m-0 L-m-0 L-m-0 
job-9436,1,7,4,471385,581112,581287,109727,175,471750,false,L-s-0 C-s-1 L-s-0 L-m-0 
job-9437,1,5,2,471433,581287,581360,109854,73,471528,false,L-s-0 L-s-0 
job-9439,5,10,5,471510,581360,581395,109850,35,471649,false,C-l-0 C-l-1 C-l-0 C-m-0 C-l-1 
job-9438,4,11,6,471474,581287,581500,109813,213,471933,false,L-m-0 L-l-0 C-s-1 L-m-0 L-l-0 L-l-0 
job-9440,4,4,3,471560,581500,581533,109940,33,471646,false,L-l-0 L-l-0 L-l-0 
job-9442,1,7,8,471668,581500,581564,109832,64,471787,false,L-s-0 C-l-0 C-l-0 C-l-0 C-l-0 C-l-0 L-s-0 L-m-0 
job-9441,1,10,2,471608,581500,581616,109892,116,471998,false,L-m-0 L-m-0 
job-9443,1,8,3,471708,581616,581636,109908,20,471740,false,L-m-0 L-m-0 L-m-0 
job-9444,2,8,5,471748,581616,581808,109868,192,472139,false,L-l-0 L-l-0 L-m-0 L-l-0 L-l-0 
job-9445,2,10,3,471796,581808,581829,110012,21,471855,false,L-m-0 L-m-0 L-m-0 
job-9446,2,9,4,471851,581808,581893,109957,85,472082,false,L-l-0 L-l-0 L-l-0 L-l-0 
job-9447,2,9,1,471895,581893,581924,109998,31,472083,false,L-s-0 
job-9449,6,12,4,471993,581924,582000,109931,76,472342,false,C-l-0 C-l-2 C-l-2 C-l-0 
job-9448,6,12,6,471944,581893,582064,109949,171,472339,false,L-m-0 C-l-1 L-l-0 C-m-0 C-l-1 L-l-0 
job-9451,4,4,5,472092,582064,582131,109972,67,472180,false,L-m-0 L-l-0 L-m-0 L-l-0 L-l-0 
job-9452,6,7,2,472156,582131,582144,109975,13,472352,false,L-l-0 L-l-0 
job-9453,5,9,8,472201,582131,582144,109930,13,472382,false,C-l-0 C-l-1 C-l-0 C-l-2 C-l-1 C-l-2 C-m-0 L-m-0 
job-9450,1,5,3,472044,582064,582182,110020,118,472191,false,L-s-0 L-s-0 L-s-0 
job-9454,4,7,6,472246,582131,582204,109885,73,472521,false,C-m-2 C-m-2 C-s-2 C-m-1 C-m-1 C-s-1 
job-9455,2,7,3,472299,582182,582229,109883,47,472578,false,L-m-0 L-m-0 L-m-0 
job-9458,5,6,2,472461,582204,582232,109743,28,472742,false,L-l-0 C-m-0 
job-9459,6,12,8,472514,582204,582261,109690,57,472771,false,C-m-2 C-l-1 C-l-2 C-l-1 C-l-0 C-l-2 C-l-0 C-m-1 
job-9457,1,6,8,472401,582182,582263,109781,81,472705,false,L-s-0 L-l-0 L-l-0 L-l-0 L-l-0 L-l-0 L-l-0 L-m-0 
job-9456,3,7,1,472356,582182,582277,109826,95,472633,false,L-s-0 
job-9460,1,5,6,472567,582263,582295,109696,32,472618,false,L-m-0 L-s-0 L-m-0 L-m-0 L-m-0 L-m-0 
job-9461,2,8,5,472616,582263,582340,109647,77,472865,false,L-l-0 L-l-0 L-l-0 L-l-0 L-l-0 
job-9462,4,5,3,472672,582263,582427,109591,164,473047,false,C-l-0 C-l-0 C-l-0 
job-9463,4,8,3,472744,582427,582443,109683,16,472815,false,L-l-0 L-l-0 L-l-0 
job-9464,3,10,7,472803,582427,582690,109624,263,473067,false,L-m-0 C-l-2 C-l-2 L-m-0 C-l-2 L-s-0 C-l-2 
job-9466,6,8,5,472911,582690,582757,109779,67,473133,false,L-l-0 C-l-0 L-l-0 C-m-0 C-l-0 
job-9467,6,9,4,472959,582757,582767,109798,10,473132,false,C-l-0 C-l-0 L-l-0 L-l-0 
job-9465,2,12,3,472859,582690,582778,109831,88,472948,false,L-m-0 L-m-0 L-s-0 
job-9468,6,9,7,473012,582757,582831,109745,74,473316,false,C-m-2 C-l-2 C-l-1 C-m-1 C-l-1 C-l-2 C-m-0 
job-9469,5,5,6,473062,582831,582903,109769,72,473316,false,L-m-0 C-l-0 C-l-0 C-m-0 L-l-0 L-l-0 
job-9470,6,10,6,473110,582831,582923,109721,92,473334,false,C-m-2 C-l-1 C-l-1 C-m-1 C-l-2 C-l-2 
job-9471,3,7,6,473166,582831,583310,109665,479,473661,false,L-s-0 C-s-1 C-s-2 C-m-0 C-s-0 L-m-0 
job-9472,1,4,3,473206,583310,583355,110104,45,473416,false,L-s-0 L-s-0 L-s-0 
job-9473,4,6,6,473263,583310,583476,110047,166,473509,false,C-s-1 L-l-0 L-l-0 L-m-0 L-l-0 L-m-0 
job-9474,1,8,8,473313,583476,583519,110163,43,473451,false,L-s-0 L-l-0 L-l-0 L-l-0 L-l-0 L-s-0 L-l-0 L-l-0 
job-9475,6,9,1,473360,583476,583539,110116,63,473575,false,L-m-0 
job-9476,3,10,4,473400,583476,583560,110076,84,473676,false,C-l-0 C-l-0 C-l-0 C-l-0 
job-9477,6,9,8,473453,583519,583678,110066,159,473834,false,C-l-1 L-l-0 C-l-2 C-l-2 C-l-1 L-l-0 C-m-1 C-m-0 
job-9480,4,6,5,473609,583678,583740,110069,62,473745,false,L-s-0 C-l-0 C-l-0 L-l-0 C-l-0 
job-9481,4,12,7,473660,583740,583758,110080,18,473780,false,C-s-2 C-l-1 C-l-1 C-s-1 C-l-1 L-l-0 L-s-0 
job-9478,6,12,1,473504,583678,583785,110174,107,473784,false,L-m-0 
job-9479,6,11,1,473563,583678,583823,110115,145,473868,false,L-l-0 
job-9482,6,9,4,473707,583740,584350,110033,610,474455,false,C-l-2 C-l-0 C-l-0 C-l-2 
job-9483,4,9,5,473761,584350,584498,110589,148,473986,false,L-m-0 L-l-0 L-l-0 L-l-0 L-m-0 
job-9485,1,12,8,473866,584498,584510,110632,12,474053,false,L-l-0 L-l-0 C-l-0 C-l-0 C-l-0 L-l-0 C-l-0 L-l-0 
job-9484,3,11,2,473811,584498,584513,110687,15,473984,false,L-m-0 L-m-0 
job-9486,5,10,2,473922,584498,584571,110576,73,474010,false,C-l-1 C-l-1 
job-9487,3,12,5,473977,584498,584598,110521,100,474261,false,C-l-2 C-l-2 C-l-2 L-s-0 C-l-2 
job-9488,6,9,8,474022,584513,584602,110491,89,474320,false,C-m-2 L-l-0 L-l-0 C-l-0 C-l-0 C-m-1 C-m-0 L-m-0 
job-9489,3,10,8,474067,584598,584810,110531,212,474463,false,C-l-1 C-l-1 C-l-2 C-l-1 C-l-1 C-l-2 C-l-2 C-l-2 
job-9490,5,9,1,474124,584810,584826,110686,16,474144,false,L-m-0 
job-9491,5,7,1,474189,584810,584848,110621,38,474466,false,L-l-0 
job-9493,4,10,3,474267,584848,584931,110581,83,474357,false,L-l-0 L-l-0 L-l-0 
job-9492,1,8,4,474224,584848,584988,110624,140,474467,false,L-m-0 L-m-0 L-m-0 L-m-0 
job-9494,6,10,5,474318,584848,585079,110530,231,474586,false,C-l-2 C-l-0 C-l-0 C-m-0 C-l-2 
job-9495,2,11,1,474372,585079,585098,110707,19,474673,false,L-s-0 
job-9496,6,5,1,474426,585079,585154,110653,75,474539,false,L-m-0 
job-9497,1,7,5,474470,585079,585217,110609,138,474894,false,L-l-0 L-m-0 L-m-0 L-l-0 L-l-0 
job-9501,2,12,8,474658,585217,585266,110559,49,474951,false,C-l-2 C-l-2 C-l-2 C-m-0 C-l-2 L-m-0 C-m-0 L-l-0 
job-9500,4,9,8,474602,585217,585269,110615,52,474874,false,L-s-0 C-l-0 C-l-0 C-l-1 C-l-1 L-l-0 C-l-0 C-l-1 
job-9498,1,4,5,474511,585217,585297,110706,80,474691,false,L-m-0 L-m-0 L-m-0 L-m-0 L-m-0 
job-9502,5,11,8,474710,585269,585357,110559,88,475089,false,C-l-0 L-l-0 C-l-0 C-l-1 C-l-1 C-l-2 C-l-2 C-m-0 
job-9499,6,6,1,474553,585217,585388,110664,171,474998,false,L-l-0 
job-9503,2,12,5,474764,585388,585406,110624,18,474977,false,L-l-0 L-s-0 L-l-0 L-l-0 L-l-0 
job-9504,6,6,3,474807,585388,585464,110581,76,475126,false,L-m-0 C-l-0 C-l-0 
job-9505,4,10,8,474853,585388,585537,110535,149,475094,false,C-l-2 C-l-1 C-l-1 C-l-2 C-l-2 C-m-0 C-l-1 C-m-0 
job-9506,2,6,3,474889,585464,585584,110575,120,475271,false,L-m-0 L-m-0 L-m-0 
job-9507,1,12,5,474933,585537,585597,110604,60,475271,false,L-l-0 L-l-0 L-m-0 L-l-0 L-l-0 
job-9509,4,8,8,475024,585537,585663,110513,126,475217,false,C-l-1 C-l-1 C-l-2 C-l-2 C-l-1 C-m-1 C-l-2 C-m-1 
job-9508,1,8,5,474976,585537,585891,110561,354,475594,false,C-m-0 C-m-0 L-s-0 C-m-0 C-m-0 
job-9512,6,6,8,475165,585891,585950,110726,59,475519,false,L-l-0 L-l-0 C-l-0 C-l-2 C-l-1 C-l-0 C-l-2 C-l-1 
job-9510,2,8,1,475062,585891,585986,110829,95,475175,false,L-s-0 
job-9511,2,10,2,475115,585891,586067,110776,176,475318,false,L-m-0 L-m-0 
job-9513,3,6,1,475208,586067,586122,110859,55,475536,false,L-s-0 
job-9514,6,6,4,475268,586067,586181,110799,114,475677,false,L-m-0 L-l-0 L-l-0 C-m-0 
job-9515,5,6,2,475316,586067,586276,110751,209,475624,false,C-l-0 C-l-0 
job-9516,5,7,6,475356,586276,586300,110920,24,475551,false,L-m-0 C-l-0 C-l-0 C-m-2 L-l-0 L-l-0 
job-9517,1,11,7,475421,586300,586320,110879,20,475642,false,L-m-0 L-l-0 L-l-0 L-s-0 L-l-0 L-l-0 L-m-0 
job-9519,6,9,5,475543,586320,586356,110777,36,475792,false,L-l-0 C-l-1 C-l-1 C-l-2 C-l-2 
job-9518,6,4,5,475482,586300,586389,110818,89,475837,false,C-l-0 L-m-0 L-l-0 C-m-0 C-l-0 
job-9520,3,8,2,475585,586389,586406,110804,17,475621,false,L-m-0 L-m-0 
job-9521,4,11,6,475628,586389,586494,110761,105,475952,false,C-m-1 L-l-0 L-l-0 C-m-1 L-l-0 L-s-0 
job-9522,1,11,3,475677,586494,586521,110817,27,475786,false,L-l-0 L-l-0 L-l-0 
job-9523,5,11,7,475721,586494,586784,110773,290,476280,false,C-m-0 C-l-1 C-l-0 C-l-0 C-l-1 L-l-0 L-m-0 
job-9524,6,11,6,475775,586784,586852,111009,68,475933,false,C-m-0 C-l-0 L-l-0 L-m-0 C-l-0 L-l-0 
job-9525,3,12,4,475825,586852,586880,111027,28,475881,false,L-l-0 L-l-0 L-l-0 L-l-0 
job-9526,4,12,7,475881,586852,586886,110971,34,475976,false,C-l-0 L-s-0 C-l-0 L-m-0 C-l-0 L-m-0 C-s-1 
job-9527,4,6,8,475931,586852,586904,110921,52,476106,false,C-m-0 C-l-2 C-l-1 C-l-2 C-l-2 C-m-0 C-l-1 C-l-1 
job-9528,3,7,3,475991,586886,586906,110895,20,476208,false,L-l-0 L-l-0 L-l-0 
job-9530,3,9,5,476085,586886,586914,110801,28,476372,false,C-s-1 C-l-0 C-l-0 C-l-0 C-l-0 
job-9529,2,5,7,476032,586886,586963,110854,77,476230,false,L-m-0 L-s-0 L-m-0 L-m-0 L-m-0 L-l-0 L-s-0 
job-9531,3,11,7,476128,586904,587175,110776,271,476642,false,C-s-0 C-l-1 C-l-1 C-m-0 C-l-1 C-l-1 C-m-0 
job-9532,2,4,6,476175,587175,587341,111000,166,476377,false,L-l-0 L-l-0 L-l-0 L-l-0 L-l-0 L-l-0 
job-9535,3,6,2,476331,587341,587437,111010,96,476523,false,C-m-0 C-m-0 
job-9534,2,4,8,476282,587341,587441,111059,100,476548,false,C-s-1 L-l-0 L-l-0 C-s-1 L-l-0 L-l-0 L-l-0 L-l-0 
job-9533,4,11,6,476229,587175,587445,110946,270,476732,false,C-s-0 C-m-2 L-m-0 C-m-2 L-m-0 L-s-0 
job-9536,1,12,7,476381,587341,587473,110960,132,476645,false,C-l-1 C-l-1 C-m-0 C-m-1 C-l-1 C-l-1 C-m-1 
job-9537,4,6,4,476438,587473,587484,111035,11,476559,false,L-l-0 L-l-0 L-s-0 L-l-0 
job-9540,4,10,5,476592,587473,587707,110881,234,476967,false,C-s-2 C-s-0 C-m-2 C-s-1 C-m-2 
job-9538,6,8,4,476494,587473,587711,110979,238,476963,false,L-m-0 C-l-1 C-l-1 C-m-0 
job-9539,3,10,8,476543,587473,587798,110930,325,477107,false,C-l-0 C-l-0 C-l-2 C-l-2 C-l-0 C-l-2 C-l-2 C-l-0 
job-9542,2,11,6,476699,587707,587852,111008,145,477086,false,L-s-0 C-m-0 C-s-1 C-m-1 C-m-1 L-m-0 
job-9543,4,4,6,476753,587798,587856,111045,58,477086,false,C-m-1 C-m-0 C-l-0 L-m-0 C-l-0 C-l-0 
job-9544,3,9,6,476803,587798,587859,110995,61,477117,false,C-m-2 C-l-1 C-l-1 C-m-2 C-l-1 C-l-1 
job-9541,6,9,2,476644,587707,587877,111063,170,477102,false,L-l-0 L-l-0 
job-9545,2,4,4,476836,587856,587943,111020,87,477199,false,L-m-0 C-m-2 L-m-0 L-m-0 
job-9546,6,7,3,476878,587943,587959,111065,16,477067,false,L-l-0 L-l-0 L-m-0 
job-9548,3,12,7,476994,587943,588081,110949,138,477146,false,C-l-0 C-l-1 C-l-1 C-l-1 C-l-1 C-l-0 C-l-0 
job-9547,4,11,2,476940,587943,588130,111003,187,477254,false,L-s-0 C-s-1 
job-9549,4,7,4,477043,588081,588137,111038,56,477207,false,L-l-0 L-m-0 L-l-0 L-m-0 
job-9550,6,5,5,477092,588081,588222,110989,141,477296,false,C-m-0 C-l-0 C-l-0 C-l-2 C-l-2 
job-9551,5,5,3,477146,588222,588272,111076,50,477274,false,L-l-0 L-l-0 L-m-0 
job-9553,3,11,8,477255,588222,588332,110967,110,477594,false,C-l-2 C-l-2 C-l-1 C-l-1 C-l-1 C-l-2 C-l-2 C-l-1 
job-9552,3,10,5,477205,588222,588363,111017,141,477498,false,L-m-0 C-l-0 C-l-0 C-l-0 C-l-0 
job-9554,2,12,3,477300,588332,588380,111032,48,477418,false,L-l-0 L-m-0 L-l-0 
job-9555,3,7,5,477357,588363,588386,111006,23,477445,false,L-m-0 L-l-0 L-s-0 L-m-0 L-l-0 
job-9557,5,4,1,477451,588363,588451,110912,88,477594,false,C-m-1 
job-9558,3,9,8,477510,588363,588455,110853,92,477723,false,C-s-0 C-l-1 C-l-1 C-s-1 C-l-1 C-l-1 C-s-2 C-m-1 
job-9556,1,8,6,477406,588363,588470,110957,107,477524,false,C-m-0 C-m-0 C-m-0 L-s-0 L-l-0 C-m-0 
job-9559,3,12,4,477553,588363,588643,110810,280,478128,false,C-l-0 C-l-0 C-l-0 C-l-0 
job-9561,5,9,7,477643,588643,588677,111000,34,477855,false,C-l-0 C-l-1 C-l-0 C-l-2 C-l-1 C-l-2 L-m-0 
job-9562,3,12,8,477695,588643,588759,110948,116,478044,false,C-m-2 L-m-0 C-m-2 L-s-0 C-m-0 C-m-1 C-m-1 C-m-0 
job-9560,2,4,6,477593,588643,588779,111050,136,478012,false,L-l-0 L-l-0 L-l-0 L-l-0 L-l-0 L-l-0 
job-9563,2,10,5,477744,588643,588885,110899,242,478133,false,C-s-2 C-l-2 C-l-1 C-s-1 C-l-0 
job-9565,6,6,3,477832,588759,588921,110927,162,478202,false,C-m-2 C-m-1 C-m-0 
job-9564,4,6,8,477787,588759,588928,110972,169,478127,false,L-m-0 C-l-1 C-l-0 C-l-2 C-l-1 C-l-2 C-l-0 L-m-0 
job-9566,4,5,4,477879,588885,588938,111006,53,478202,false,L-s-0 C-l-0 C-l-1 C-l-2 
job-9567,3,11,6,477930,588885,588944,110955,59,478032,false,C-s-0 L-l-0 L-l-0 C-s-2 L-l-0 L-l-0 
job-9568,5,8,4,477990,588938,588949,110948,11,478269,false,C-m-0 C-l-0 C-l-0 L-m-0 
job-9570,6,11,4,478085,588949,588970,110864,21,478317,false,C-m-0 C-l-0 C-l-0 L-m-0 
job-9571,2,10,8,478133,588949,588996,110816,47,478218,false,C-m-1 C-m-2 C-m-2 L-m-0 C-m-2 C-m-1 C-m-0 C-m-1 
job-9569,1,11,4,478043,588949,589079,110906,130,478304,false,L-l-0 L-l-0 L-l-0 L-l-0 
job-9573,6,9,4,478231,589079,589104,110848,25,478526,false,L-m-0 L-l-0 L-l-0 C-m-0 
job-9572,2,6,6,478181,588949,589110,110768,161,478480,false,C-s-2 C-s-2 L-s-0 C-s-1 L-s-0 C-s-1 
job-9574,5,7,8,478270,589079,589195,110809,116,478491,false,C-l-0 C-l-2 C-l-0 C-l-1 C-l-1 C-m-1 C-l-2 C-m-2 
job-9577,5,5,5,478406,589195,589296,110789,101,478655,false,C-m-1 C-m-2 C-l-2 C-m-0 C-l-2 
job-9576,6,4,6,478370,589195,589315,110825,120,478689,false,C-l-0 C-l-1 C-l-1 L-m-0 C-l-0 L-l-0 
job-9575,1,7,5,478324,589195,589345,110871,150,478565,false,L-l-0 L-l-0 L-l-0 L-l-0 L-l-0 
job-9578,6,7,3,478445,589296,589532,110851,236,478708,false,C-l-2 C-l-2 C-m-1 
job-9579,5,8,7,478483,589532,589601,111049,69,478578,false,C-l-1 L-l-0 C-l-0 C-l-1 C-l-0 L-l-0 L-m-0 
job-9580,6,7,2,478537,589601,589622,111064,21,478827,false,L-l-0 L-l-0 
job-9581,1,6,8,478580,589601,589638,111021,37,478880,false,L-s-0 L-m-0 C-s-1 L-s-0 L-m-0 L-m-0 C-s-1 L-m-0 
job-9582,6,12,3,478638,589601,589806,110963,205,479122,false,C-m-0 C-l-0 C-l-0 
job-9584,5,4,6,478732,589806,589816,111074,10,478840,false,C-l-1 L-l-0 C-l-0 C-l-1 C-l-0 L-l-0 
job-9583,3,6,2,478688,589806,589826,111118,20,478745,false,L-m-0 L-m-0 
job-9585,4,8,6,478779,589806,589941,111027,135,479151,false,L-s-0 C-l-2 C-l-2 C-m-0 C-l-2 C-m-0 
job-9586,2,11,5,478826,589941,589953,111115,12,478907,false,L-s-0 L-l-0 L-l-0 L-l-0 L-l-0 
job-9587,3,9,4,478876,589941,589984,111065,43,478975,false,L-m-0 L-m-0 C-m-0 C-m-0 
job-9588,5,8,4,478934,589941,590069,111007,128,479145,false,C-l-1 C-l-0 C-l-0 C-l-1 
job-9589,5,6,8,478979,589984,590118,111005,134,479270,false,C-m-1 L-l-0 L-l-0 C-l-2 C-l-2 C-m-0 C-m-2 L-m-0 
job-9590,6,9,5,479024,590118,590210,111094,92,479350,false,L-m-0 C-l-0 L-l-0 L-l-0 C-l-0 
job-9591,4,10,3,479085,590118,590212,111033,94,479397,false,L-s-0 C-m-0 C-m-0 
job-9592,5,10,2,479129,590210,590236,111081,26,479343,false,L-l-0 L-l-0 
job-9593,5,10,7,479165,590210,590462,111045,252,479475,false,L-m-0 C-l-1 C-l-1 C-l-2 C-l-0 C-l-2 C-l-0 
job-9594,4,12,8,479215,590462,590493,111247,31,479284,false,L-m-0 L-m-0 L-l-0 L-l-0 C-m-1 L-s-0 L-l-0 C-m-1 
job-9595,2,4,1,479269,590462,590533,111193,71,479577,false,C-s-1 
job-9597,2,6,3,479375,590533,590604,111158,71,479556,false,L-m-0 L-m-0 L-m-0 
job-9598,2,6,4,479431,590604,590654,111173,50,479755,false,L-m-0 L-m-0 L-m-0 L-m-0 
job-9599,5,4,2,479482,590654,590683,111172,29,479620,false,L-l-0 L-l-0 
job-9596,1,6,2,479330,590533,590713,111203,180,479630,false,L-s-0 L-s-0 
job-9600,6,11,1,479528,590654,590767,111126,113,479747,false,L-m-0 
job-9601,6,10,4,479567,590654,590918,111087,264,480022,false,C-l-2 C-l-0 C-l-0 C-l-2 
job-9603,2,9,4,479654,590918,590965,111264,47,479773,false,C-s-0 C-m-0 C-m-0 C-m-0 
job-9602,2,12,8,479609,590918,590969,111309,51,479917,false,L-m-0 L-s-0 C-s-1 L-l-0 L-l-0 L-l-0 L-l-0 L-m-0 
job-9604,6,5,1,479709,590918,591187,111209,269,480039,false,C-m-1 
job-9606,6,4,7,479810,591187,591234,111377,47,479882,false,C-l-0 C-l-1 C-l-1 L-m-0 C-l-2 C-l-2 C-l-0 
job-9607,4,4,7,479865,591187,591252,111322,65,480134,false,C-m-0 C-m-2 C-m-0 C-m-1 C-m-2 L-s-0 C-m-1 
job-9605,5,10,2,479768,591187,591268,111419,81,480069,false,L-l-0 L-l-0 
job-9608,4,4,5,479917,591234,591539,111317,305,480444,false,L-m-0 C-l-0 C-l-0 L-m-0 C-l-0 
job-9609,2,8,8,479949,591539,591621,111590,82,480070,false,L-l-0 L-l-0 L-l-0 L-l-0 L-l-0 L-s-0 L-l-0 L-s-0 
job-9610,1,9,1,479997,591539,591692,111542,153,480448,false,L-m-0 
job-9611,3,5,2,480056,591692,591771,111636,79,480415,false,L-m-0 L-m-0 
job-9612,3,11,7,480115,591692,591922,111577,230,480410,false,L-s-0 L-l-0 L-l-0 C-m-2 L-l-0 L-l-0 C-m-2 
job-9614,6,4,7,480198,591922,591935,111724,13,480325,false,L-l-0 C-l-1 C-l-0 L-m-0 C-l-0 L-l-0 C-l-1 
job-9617,3,5,6,480384,591922,592039,111538,117,480789,false,C-s-1 C-m-2 C-m-2 C-m-1 C-m-1 C-s-2 
job-9613,1,5,1,480157,591922,592074,111765,152,480401,false,L-s-0 
job-9616,2,6,7,480330,591922,592081,111592,159,480769,false,C-l-2 C-l-2 C-m-0 C-l-2 C-l-2 C-l-2 C-l-2 
job-9615,2,4,5,480266,591922,592211,111656,289,480809,false,L-s-0 L-m-0 C-m-0 C-m-0 C-m-0 
job-9619,4,6,7,480483,592211,592237,111728,26,480722,false,L-m-0 L-l-0 L-m-0 C-m-0 L-l-0 L-l-0 C-m-0 
job-9620,4,12,2,480551,592211,592316,111660,105,480793,false,C-m-1 C-m-1 
job-9618,2,4,1,480435,592211,592328,111776,117,480810,false,L-s-0 
job-9621,5,12,2,480596,592316,592338,111720,22,480904,false,L-l-0 L-l-0 
job-9622,4,11,1,480643,592316,592511,111673,195,481008,false,L-m-0 
job-9624,5,7,3,480736,592511,592530,111775,19,480966,false,L-l-0 L-l-0 C-m-0 
job-9623,6,11,1,480696,592511,592532,111815,21,480832,false,L-m-0 
job-9625,1,11,7,480779,592511,592554,111732,43,480962,false,L-s-0 L-l-0 C-s-1 C-m-0 L-m-0 L-l-0 C-m-0 
job-9626,5,4,1,480830,592511,592929,111681,418,481360,false,C-m-1 
job-9627,2,8,2,480889,592929,592952,112040,23,480994,false,L-s-0 L-s-0 
job-9630,5,12,6,481032,592929,592966,111897,37,481076,false,C-m-0 C-l-0 C-l-1 L-m-0 C-l-1 C-l-0 
job-9628,5,10,2,480949,592929,593027,111980,98,481135,false,L-l-0 L-l-0 
job-9631,6,8,5,481088,592966,593054,111878,88,481446,false,L-m-0 C-l-0 C-l-1 C-l-1 C-l-0 
job-9629,1,4,4,480985,592929,593071,111944,142,481381,false,L-m-0 L-m-0 L-l-0 L-l-0 
job-9632,5,7,5,481140,592966,593162,111826,196,481619,false,C-m-0 C-l-2 C-m-2 C-m-1 C-l-2 
job-9633,5,8,8,481185,593162,593269,111977,107,481513,false,L-l-0 C-l-0 C-l-1 C-l-1 C-l-0 L-l-0 C-m-0 L-m-0 
job-9634,4,10,2,481237,593269,593322,112032,53,481387,false,L-m-0 L-m-0 
job-9635,6,11,6,481286,593269,593683,111983,414,481941,false,L-l-0 C-l-0 C-l-1 C-l-1 C-l-0 L-l-0 
job-9636,5,11,6,481342,593683,593757,112341,74,481654,false,L-m-0 C-l-0 C-l-0 C-m-0 L-l-0 L-l-0 
job-9637,3,12,5,481402,593683,593837,112281,154,481564,false,L-s-0 L-m-0 C-m-1 C-m-1 C-m-0 
job-9638,2,7,8,481451,593837,593852,112386,15,481479,false,L-l-0 L-l-0 L-l-0 L-l-0 L-l-0 L-s-0 L-l-0 L-s-0 
job-9639,6,7,7,481495,593837,594111,112342,274,481821,false,L-m-0 C-l-0 C-l-0 C-l-1 C-l-2 C-l-2 C-l-1 
job-9641,4,9,7,481589,594111,594139,112522,28,481666,false,L-m-0 L-l-0 L-l-0 C-m-0 L-m-0 L-l-0 C-m-0 
job-9640,4,11,1,481539,594111,594178,112572,67,481887,false,L-s-0 
job-9642,4,7,1,481633,594111,594262,112478,151,481876,false,C-s-1 
job-9645,3,5,4,481774,594262,594322,112488,60,482101,false,L-s-0 L-m-0 C-s-1 L-m-0 
job-9643,4,9,4,481683,594111,594329,112428,218,482197,false,C-s-2 C-l-1 C-l-1 C-l-1 
job-9644,5,7,2,481733,594262,594354,112529,92,481841,false,L-l-0 L-l-0 
job-9646,1,9,5,481830,594322,594524,112492,202,482107,false,L-m-0 L-m-0 L-l-0 L-m-0 L-l-0 
job-9648,5,9,3,481944,594524,594535,112580,11,482063,false,L-l-0 L-l-0 C-m-0 
job-9647,3,11,2,481886,594524,594569,112638,45,482169,false,L-m-0 L-m-0 
job-9649,3,4,7,481995,594524,594760,112529,236,482312,false,L-s-0 C-l-0 C-l-0 C-m-0 C-l-0 C-l-0 C-s-1 
job-9651,6,9,4,482106,594760,594878,112654,118,482224,false,L-l-0 C-l-0 L-l-0 C-l-0 
job-9655,4,5,3,482292,594878,594916,112586,38,482484,false,C-l-2 C-l-2 C-l-2 
job-9653,3,5,3,482205,594878,594919,112673,41,482535,false,L-s-0 L-l-0 C-s-2 
job-9652,3,6,3,482154,594878,594921,112724,43,482479,false,L-l-0 L-l-0 L-l-0 
job-9650,1,10,3,482056,594760,594928,112704,168,482306,false,L-m-0 L-m-0 L-m-0 
job-9654,4,7,3,482252,594878,594937,112626,59,482532,false,C-l-0 C-l-0 C-l-0 
job-9656,2,7,5,482349,594916,594945,112567,29,482598,false,C-s-0 C-m-1 C-m-1 C-m-1 C-m-1 
job-9658,5,12,2,482450,594916,594945,112466,29,482777,false,C-l-1 C-l-1 
job-9659,5,7,7,482499,594937,594947,112438,10,482678,false,C-l-2 L-l-0 C-l-0 C-l-2 C-l-0 L-l-0 L-m-0 
job-9657,4,9,2,482392,594916,594948,112524,32,482601,false,C-m-0 C-m-0 
job-9660,3,11,7,482547,594945,594956,112398,11,482676,false,L-s-0 C-s-2 C-s-1 C-s-0 C-m-2 L-m-0 C-m-2 
job-9661,5,7,5,482595,594947,595002,112352,55,482834,false,L-l-0 C-l-0 L-m-0 C-l-0 L-l-0 
job-9662,2,9,5,482650,594947,595019,112297,72,482966,false,C-m-1 C-m-1 L-l-0 C-m-2 C-l-0 
job-9663,1,6,3,482707,594947,595316,112240,369,483221,false,C-l-1 C-m-1 C-m-1 
job-9668,2,10,8,482930,595316,595416,112386,100,483224,false,C-s-1 C-l-2 C-l-2 C-l-2 C-l-2 C-m-1 C-m-1 C-m-1 
job-9666,1,10,6,482847,595316,595421,112469,105,482952,false,L-s-0 C-l-1 C-l-1 L-m-0 C-l-1 C-l-1 
job-9665,3,7,6,482796,595316,595465,112520,149,483126,false,L-m-0 C-l-0 C-l-0 L-m-0 C-l-0 C-l-0 
job-9664,1,11,4,482751,595316,595482,112565,166,483163,false,L-l-0 L-l-0 L-l-0 L-l-0 
job-9667,2,9,3,482887,595316,595550,112429,234,483241,false,C-m-0 C-m-0 C-m-0 
job-9669,4,9,1,482991,595550,595584,112559,34,483087,false,L-s-0 
job-9670,1,6,8,483047,595550,595626,112503,76,483406,false,L-l-0 L-l-0 L-l-0 L-l-0 L-l-0 L-l-0 L-l-0 L-l-0 
job-9674,6,10,5,483238,595584,595665,112346,81,483368,false,C-m-0 C-l-2 C-m-2 C-m-1 C-l-2 
job-9671,3,7,5,483090,595550,595702,112460,152,483353,false,C-l-0 L-m-0 C-l-0 C-l-0 C-l-0 
job-9673,2,9,6,483184,595550,595744,112366,194,483595,false,C-l-1 C-l-1 C-l-1 C-s-0 C-l-1 C-l-1 
job-9672,4,12,2,483137,595550,595752,112413,202,483460,false,C-s-1 L-m-0 
job-9675,5,5,4,483292,595665,595863,112373,198,483777,false,C-l-2 L-l-0 L-l-0 C-l-2 
job-9677,4,10,8,483393,595752,595899,112359,147,483545,false,C-m-1 C-l-0 C-l-0 C-l-0 L-m-0 L-m-0 C-s-2 C-m-1 
job-9676,1,10,5,483345,595752,595955,112407,203,483774,false,L-s-0 L-l-0 L-l-0 C-l-2 C-l-2 
job-9678,3,12,3,483446,595752,595973,112306,221,483957,false,C-m-0 C-s-1 C-m-0 
job-9679,2,8,7,483487,595955,595974,112468,19,483650,false,L-l-0 L-l-0 C-m-0 L-l-0 L-l-0 L-l-0 L-l-0 
job-9680,3,4,6,483525,595955,596032,112430,77,483720,false,L-m-0 C-l-0 C-l-0 L-m-0 C-l-0 C-l-0 
job-9681,3,11,1,483576,595955,596036,112379,81,483934,false,L-s-0 
job-9682,4,4,4,483632,595955,596101,112323,146,484030,false,C-l-1 C-l-1 C-l-1 C-s-2 
job-9683,2,5,8,483691,596101,596117,112410,16,483973,false,L-l-0 L-s-0 L-l-0 L-l-0 L-l-0 L-s-0 L-l-0 L-l-0 
job-9684,4,9,6,483744,596101,596267,112357,166,484087,false,C-s-1 C-l-1 C-l-1 L-m-0 C-l-1 L-m-0 
job-9685,2,8,4,483790,596267,596290,112477,23,483999,false,L-m-0 L-m-0 L-m-0 L-m-0 
job-9687,3,5,7,483880,596267,596331,112387,64,484040,false,L-s-0 C-l-1 C-l-1 C-m-0 C-l-1 C-l-1 C-m-0 
job-9686,4,4,3,483833,596267,596342,112434,75,484022,false,L-l-0 L-l-0 L-l-0 
job-9689,2,4,4,483968,596267,596351,112299,84,484244,false,C-m-2 C-m-2 C-m-2 C-m-2 
job-9688,4,9,8,483923,596267,596356,112344,89,484204,false,C-m-1 C-l-2 C-l-0 C-l-0 C-l-2 C-l-0 C-l-2 C-m-1 
job-9690,5,6,8,484021,596356,596460,112335,104,484175,false,L-l-0 C-l-0 C-l-1 C-l-1 C-l-0 L-l-0 C-m-0 L-m-0 
job-9691,6,5,6,484074,596460,596482,112386,22,484191,false,C-m-0 C-l-0 L-l-0 L-m-0 C-l-0 L-l-0 
job-9692,1,5,8,484134,596460,596623,112326,163,484504,false,C-s-1 L-s-0 L-s-0 L-s-0 C-m-0 L-m-0 L-m-0 C-m-0 
job-9693,3,12,7,484186,596460,596648,112274,188,484628,false,C-s-2 C-l-1 C-l-1 C-m-1 C-l-1 C-l-1 C-m-1 
job-9694,2,5,1,484234,596648,596790,112414,142,484586,false,L-s-0 
job-9695,1,10,2,484282,596790,596800,112508,10,484491,false,L-m-0 L-m-0 
job-9696,5,7,7,484338,596790,596940,112452,150,484708,false,L-m-0 L-l-0 C-l-0 C-l-1 C-l-1 L-l-0 C-l-0 
job-9699,4,12,8,484484,596940,596983,112456,43,484556,false,C-l-0 C-l-2 C-s-0 C-s-1 C-l-0 C-l-2 C-l-2 C-l-0 
job-9697,4,4,6,484381,596940,596995,112559,55,484600,false,L-m-0 L-s-0 L-l-0 L-l-0 L-m-0 L-l-0 
job-9698,2,5,3,484430,596940,597015,112510,75,484803,false,C-m-0 C-m-0 C-m-0 
job-9701,5,10,3,484588,596983,597107,112395,124,484723,false,C-l-0 C-m-2 C-l-0 
job-9700,3,12,7,484544,596940,597127,112396,187,484836,false,C-s-2 C-l-1 C-l-1 C-m-1 C-l-1 C-l-1 C-m-1 
job-9702,5,10,8,484620,597107,597303,112487,196,485039,false,C-m-0 C-l-2 C-l-0 L-l-0 C-l-0 L-l-0 C-l-2 L-m-0 
job-9703,4,4,8,484676,597303,597315,112627,12,484888,false,L-m-0 L-l-0 L-l-0 L-l-0 C-m-0 L-s-0 L-m-0 C-m-0 
job-9704,4,8,8,484727,597303,597365,112576,62,485034,false,C-l-2 C-l-0 C-l-0 C-l-2 C-m-1 C-l-2 C-l-0 C-m-1 
job-9705,5,7,8,484777,597365,597433,112588,68,485029,false,L-l-0 C-l-0 C-l-1 C-l-1 C-l-0 L-l-0 C-m-0 L-m-0 
job-9707,2,10,3,484881,597433,597480,112552,47,484956,false,L-s-0 L-m-0 L-m-0 
job-9706,1,4,1,484828,597433,597558,112605,125,485217,false,L-s-0 
job-9708,4,11,2,484928,597558,597581,112630,23,485065,false,L-m-0 L-m-0 
job-9710,3,9,3,485031,597558,597709,112527,151,485214,false,L-s-0 L-l-0 C-s-2 
job-9709,1,9,4,484978,597558,597863,112580,305,485349,false,L-l-0 L-l-0 L-l-0 L-l-0 
job-9712,5,5,5,485129,597863,597881,112734,18,485274,false,C-m-0 L-l-0 C-l-0 C-l-0 L-l-0 
job-9713,6,7,3,485165,597863,597911,112698,48,485348,false,C-m-1 C-l-1 C-l-1 
job-9711,4,9,2,485086,597863,597934,112777,71,485322,false,L-m-0 L-m-0 
job-9714,1,5,1,485217,597911,598004,112694,93,485391,false,L-s-0 
job-9715,3,4,5,485268,597911,598010,112643,99,485662,false,L-l-0 L-s-0 L-l-0 L-l-0 L-l-0 
job-9717,5,4,7,485375,597911,598049,112536,138,485695,false,C-m-0 C-l-1 C-l-0 C-l-2 C-l-1 C-l-2 C-l-0 
job-9719,6,11,8,485471,598049,598061,112578,12,485623,false,L-l-0 C-l-1 C-l-0 C-l-2 C-l-1 C-l-0 L-l-0 C-l-2 
job-9718,4,6,2,485428,598004,598114,112576,110,485680,false,L-m-0 L-m-0 
job-9716,4,10,1,485322,597911,598130,112589,219,485744,false,C-s-1 
job-9720,6,6,8,485509,598061,598180,112552,119,485743,false,L-l-0 C-l-2 C-l-0 C-l-2 C-l-1 L-l-0 C-l-0 C-l-1 
job-9721,6,9,5,485555,598180,598197,112625,17,485638,false,L-m-0 C-l-0 L-l-0 L-l-0 C-l-0 
job-9722,2,5,1,485601,598197,598249,112596,52,485769,false,L-s-0 
job-9723,6,4,3,485648,598197,598597,112549,400,486256,false,L-l-0 L-m-0 L-l-0 
job-9724,6,4,8,485715,598597,598607,112882,10,485955,false,L-l-0 C-l-0 C-l-0 C-l-1 C-l-1 L-l-0 C-m-0 L-m-0 
job-9725,5,10,2,485772,598597,598898,112825,301,486310,false,C-l-2 C-l-2 
job-9727,5,8,4,485875,598898,598972,113023,74,486124,false,L-m-0 L-l-0 L-l-0 C-m-0 
job-9726,4,12,2,485824,598597,598991,112773,394,486386,false,L-s-0 C-s-2 
job-9728,5,7,2,485928,598972,598995,113044,23,486223,false,L-l-0 L-l-0 
job-9730,2,10,6,486026,598991,599019,112965,28,486104,false,C-m-0 C-m-1 C-m-0 C-m-1 C-m-0 C-m-1 
job-9731,5,10,4,486071,598991,599020,112920,29,486261,false,C-l-0 C-l-0 C-l-1 C-l-1 
job-9732,5,9,3,486123,598991,599053,112868,62,486219,false,C-l-2 C-l-2 C-m-2 
job-9729,1,8,8,485978,598972,599060,112994,88,486304,false,L-m-0 C-s-1 L-l-0 C-s-1 L-m-0 L-m-0 L-m-0 L-l-0 
job-9733,1,5,4,486178,599060,599098,112882,38,486254,false,L-m-0 L-m-0 L-m-0 L-m-0 
job-9734,1,9,6,486221,599060,599303,112839,243,486534,false,L-l-0 L-l-0 L-m-0 L-l-0 L-l-0 L-l-0 
job-9735,3,12,1,486273,599060,599309,112787,249,486594,false,L-s-0 
job-9736,5,5,1,486310,599303,599329,112993,26,486615,false,L-m-0 
job-9737,3,11,2,486353,599303,599346,112950,43,486461,false,L-l-0 L-m-0 
job-9738,2,6,1,486411,599346,599383,112935,37,486550,false,L-s-0 
job-9739,6,4,5,486461,599346,599459,112885,113,486869,false,L-m-0 C-l-0 L-l-0 L-l-0 C-l-0 
job-9740,1,10,7,486504,599346,599572,112842,226,487019,false,C-l-1 L-m-0 L-m-0 C-l-1 C-l-1 L-s-0 C-l-1 
job-9741,3,4,1,486565,599572,599651,113007,79,486737,false,L-s-0 
job-9742,3,11,5,486621,599572,599748,112951,176,487038,false,L-l-0 L-l-0 L-l-0 L-m-0 L-l-0 
job-9743,3,7,2,486666,599572,599930,112906,358,487252,false,C-s-1 L-m-0 
job-9744,6,12,2,486719,599930,599945,113211,15,486948,false,L-l-0 L-l-0 
job-9745,5,5,8,486763,599930,600101,113167,171,487098,false,C-m-0 C-l-0 C-l-0 C-l-1 C-l-1 C-l-2 C-l-2 L-m-0 
job-9747,4,6,5,486863,600101,600127,113238,26,487031,false,L-m-0 L-l-0 L-m-0 L-l-0 L-l-0 
job-9748,6,5,5,486918,600101,600158,113183,57,487110,false,C-m-0 C-l-2 C-l-0 C-l-2 C-l-0 
job-9746,1,5,1,486822,600101,600172,113279,71,486989,false,L-s-0 
job-9751,5,8,8,487062,600172,600221,113110,49,487178,false,C-l-0 C-m-0 C-l-1 C-l-2 C-l-2 C-l-1 C-l-0 L-m-0 
job-9749,3,10,1,486955,600172,600237,113217,65,487217,false,L-s-0 
job-9750,1,12,6,487011,600172,600301,113161,129,487368,false,L-m-0 L-l-0 L-l-0 L-m-0 L-l-0 L-l-0 
job-9752,4,5,7,487107,600172,600430,113065,258,487425,false,C-s-0 C-m-1 C-s-2 C-m-1 C-m-2 C-s-1 C-m-2 
job-9753,2,5,1,487149,600430,600460,113281,30,487326,false,L-s-0 
job-9754,1,4,1,487193,600460,600482,113267,22,487268,false,L-s-0 
job-9756,6,5,7,487296,600482,600530,113186,48,487348,false,L-l-0 C-l-1 C-l-0 L-l-0 C-l-1 C-l-0 L-m-0 
job-9757,6,7,8,487354,600530,600658,113176,128,487693,false,C-l-0 L-l-0 C-l-2 C-l-2 C-l-0 L-l-0 C-m-0 L-m-0 
job-9758,3,5,8,487412,600658,600690,113246,32,487567,false,C-m-0 L-l-0 L-l-0 L-l-0 L-l-0 L-m-0 C-m-0 L-m-0 
job-9759,6,9,4,487461,600658,600743,113197,85,487751,false,C-l-0 C-l-1 C-l-0 C-l-1 
job-9760,4,8,7,487516,600743,600754,113227,11,487822,false,L-m-0 L-l-0 L-l-0 C-m-0 L-l-0 L-m-0 C-m-0 
job-9755,2,10,1,487244,600482,600805,113238,323,487829,false,L-s-0 
job-9761,2,12,3,487569,600743,600867,113174,124,487931,false,C-l-0 C-l-0 C-l-0 
job-9763,6,4,8,487661,600805,601021,113144,216,488116,false,L-l-0 L-l-0 C-l-1 C-l-2 C-l-1 C-m-0 C-l-2 L-m-0 
job-9762,2,4,4,487613,600805,601138,113192,333,488063,false,L-s-0 C-l-0 C-l-0 C-l-0 
job-9764,2,11,3,487719,601138,601158,113419,20,487980,false,L-m-0 L-m-0 L-s-0 
job-9765,5,11,8,487771,601138,601242,113367,104,488043,false,C-l-2 C-l-0 C-l-0 C-l-1 C-l-1 L-l-0 C-l-2 L-l-0 
job-9766,1,5,8,487830,601242,601275,113412,33,488138,false,L-s-0 L-m-0 L-s-0 L-s-0 L-m-0 L-m-0 L-m-0 L-m-0 
job-9768,5,4,6,487910,601242,601297,113332,55,487968,false,C-l-0 C-l-1 C-l-1 C-l-2 C-l-2 C-l-0 
job-9767,3,8,5,487875,601242,601538,113367,296,488429,false,L-l-0 L-l-0 L-l-0 C-s-1 L-l-0 
job-9769,4,6,5,487972,601538,601554,113566,16,488152,false,L-m-0 L-l-0 L-l-0 L-l-0 L-m-0 
job-9770,5,8,3,488024,601538,601592,113514,54,488104,false,C-l-0 C-l-0 C-m-0 
job-9771,1,6,6,488076,601592,601602,113516,10,488251,false,L-l-0 L-l-0 L-l-0 L-l-0 L-l-0 L-l-0 
job-9773,5,6,5,488171,601592,601642,113421,50,488283,false,C-l-0 L-m-0 C-l-1 C-l-1 C-l-0 
job-9772,1,7,6,488121,601592,601838,113471,246,488429,false,L-m-0 L-s-0 L-l-0 L-m-0 L-m-0 L-s-0 
job-9774,2,6,3,488223,601838,601869,113615,31,488538,false,L-m-0 L-m-0 L-m-0 
job-9775,4,10,6,488272,601838,601893,113566,55,488365,false,L-s-0 L-l-0 C-m-0 C-m-0 L-l-0 L-l-0 
job-9776,3,5,2,488320,601893,601903,113573,10,488514,false,L-m-0 L-m-0 
job-9777,3,12,8,488371,601893,602005,113522,112,488750,false,L-l-0 C-l-0 C-l-0 C-l-0 C-l-0 L-l-0 L-l-0 L-l-0 
job-9778,4,12,5,488423,601893,602104,113470,211,488648,false,L-s-0 C-l-1 C-l-1 C-s-0 C-l-1 
job-9779,3,9,1,488482,602005,602168,113523,163,488733,false,L-m-0 
job-9780,1,5,1,488531,602168,602234,113637,66,488650,false,L-s-0 
job-9781,2,6,1,488579,602234,602258,113655,24,488873,false,L-s-0 
job-9782,5,11,5,488627,602234,602309,113607,75,488898,false,L-l-0 L-l-0 C-l-0 L-m-0 C-l-0 
job-9784,6,7,4,488730,602234,602359,113504,125,489070,false,C-l-1 C-l-2 C-l-1 C-l-2 
job-9783,1,8,8,488677,602234,602368,113557,134,488896,false,L-m-0 C-l-0 C-s-1 C-l-0 L-l-0 L-l-0 L-s-0 L-m-0 
job-9787,1,10,8,488863,602368,602410,113505,42,489009,false,C-l-1 C-l-1 L-s-0 C-l-1 C-l-1 C-m-0 C-m-0 C-m-0 
job-9785,5,4,1,488767,602368,602429,113601,61,488906,false,L-m-0 
job-9786,1,12,6,488811,602368,602429,113557,61,488917,false,L-m-0 L-l-0 L-m-0 L-l-0 L-l-0 L-l-0 
job-9788,6,5,8,488911,602410,602673,113499,263,489195,false,C-m-0 C-l-2 C-l-0 C-l-1 C-l-0 C-l-1 C-l-2 C-m-1 
job-9789,4,5,2,488956,602673,602754,113717,81,489197,false,L-m-0 L-m-0 
job-9790,6,10,3,489003,602673,602903,113670,230,489387,false,L-l-0 L-l-0 C-m-0 
job-9791,1,10,2,489059,602903,603079,113844,176,489277,false,L-m-0 L-m-0 
job-9792,4,6,2,489116,603079,603114,113963,35,489163,false,L-m-0 L-m-0 
job-9793,3,7,8,489170,603079,603290,113909,211,489397,false,L-l-0 L-l-0 C-l-0 C-l-0 C-l-0 C-l-0 L-l-0 L-l-0 
job-9795,6,6,4,489257,603290,603309,114033,19,489476,false,L-m-0 C-l-0 C-l-0 C-m-0 
job-9798,3,5,5,489399,603309,603338,113910,29,489611,false,C-s-1 C-l-1 C-l-1 C-l-1 C-l-1 
job-9796,1,7,5,489300,603309,603350,114009,41,489356,false,L-m-0 L-m-0 L-m-0 L-l-0 L-l-0 
job-9797,3,11,2,489346,603309,603350,113963,41,489403,false,L-s-0 L-m-0 
job-9794,5,9,2,489209,603290,603359,114081,69,489312,false,L-l-0 L-l-0 
job-9799,1,4,7,489455,603309,603482,113854,173,489795,false,C-m-1 C-s-1 C-m-1 C-m-1 C-m-1 C-m-1 L-s-0 
job-9800,6,8,5,489519,603482,603492,113963,10,489591,false,L-m-0 C-l-0 L-l-0 L-l-0 C-l-0 
job-9802,3,5,7,489617,603482,603537,113865,55,489833,false,L-s-0 C-l-1 C-l-1 C-m-1 C-l-1 C-l-1 C-m-1 
job-9801,1,4,3,489568,603482,603544,113914,62,489640,false,L-s-0 L-m-0 L-m-0 
job-9803,6,4,8,489664,603492,603547,113828,55,489825,false,L-l-0 L-m-0 C-l-0 C-l-2 C-l-2 C-l-0 L-l-0 C-m-0 
job-9805,6,10,4,489767,603547,603573,113780,26,489867,false,L-m-0 L-l-0 L-l-0 C-m-0 
job-9804,3,5,7,489714,603537,603582,113823,45,489784,false,C-m-1 L-s-0 C-l-1 C-m-1 C-l-1 C-l-1 C-l-1 
job-9806,2,10,3,489814,603573,603591,113759,18,489921,false,L-m-0 L-m-0 C-m-1 
job-9807,2,4,4,489873,603573,603617,113700,44,490139,false,L-l-0 L-m-0 L-l-0 L-m-0 
job-9808,1,9,3,489918,603617,603858,113699,241,490448,false,L-m-0 L-m-0 L-m-0 
job-9810,5,4,5,490014,603858,603868,113844,10,490179,false,L-l-0 L-l-0 C-l-0 L-m-0 C-l-0 
job-9809,1,8,3,489972,603858,603869,113886,11,490016,false,L-m-0 L-m-0 L-m-0 
job-9811,4,4,4,490063,603858,603919,113795,61,490356,false,L-s-0 C-l-1 C-l-1 C-l-1 
job-9812,6,11,7,490109,603919,603929,113810,10,490194,false,L-m-0 C-l-0 C-l-1 L-l-0 C-l-0 C-l-1 L-l-0 
job-9813,4,7,7,490164,603919,604053,113755,134,490352,false,L-s-0 C-l-2 C-l-2 C-m-1 C-l-2 C-s-1 C-m-1 
job-9814,2,4,2,490219,604053,604103,113834,50,490465,false,L-s-0 L-s-0 
job-9815,2,4,7,490281,604053,604127,113772,74,490480,false,L-l-0 L-m-0 L-l-0 L-l-0 L-l-0 L-m-0 L-l-0 
job-9817,5,10,4,490398,604127,604152,113729,25,490630,false,C-l-0 L-l-0 L-l-0 C-l-0 
job-9816,1,5,4,490342,604127,604172,113785,45,490576,false,L-m-0 L-m-0 L-m-0 L-m-0 
job-9818,5,10,8,490458,604152,604232,113694,80,490665,false,L-l-0 C-l-1 C-l-0 C-l-1 C-l-0 L-l-0 C-l-2 C-l-2 
job-9819,6,12,5,490506,604232,604286,113726,54,490731,false,L-m-0 C-l-0 L-l-0 L-l-0 C-l-0 
job-9820,2,8,5,490546,604232,604286,113686,54,490648,false,C-s-1 L-s-0 L-m-0 C-s-1 L-s-0 
job-9821,6,10,6,490600,604232,604349,113632,117,490928,false,C-m-0 C-l-2 C-l-1 C-m-1 C-l-2 C-l-1 
job-9822,6,5,6,490655,604286,604477,113631,191,491020,false,L-l-0 L-l-0 L-m-0 C-m-2 C-l-0 C-l-0 
job-9824,6,11,8,490758,604477,604609,113719,132,491049,false,L-m-0 L-l-0 C-l-0 C-l-2 C-l-0 C-l-1 C-l-2 C-l-1 
job-9823,1,12,3,490703,604477,604791,113774,314,491183,false,L-l-0 L-l-0 L-l-0 
job-9825,5,12,5,490813,604791,604807,113978,16,491118,false,L-m-0 L-l-0 C-l-0 L-l-0 C-l-0 
job-9827,4,7,8,490891,604791,604854,113900,63,491106,false,C-l-1 C-l-2 C-l-2 C-s-0 C-l-1 C-l-2 C-s-2 C-l-1 
job-9826,2,10,4,490859,604791,604855,113932,64,490952,false,L-s-0 L-l-0 C-l-0 L-m-0 
job-9829,1,6,8,490993,604855,604876,113862,21,491097,false,L-m-0 L-m-0 L-l-0 L-l-0 L-l-0 L-l-0 L-l-0 L-l-0 
job-9828,3,7,2,490945,604855,604887,113910,32,491109,false,L-m-0 L-m-0 
job-9830,4,9,8,491047,604855,605123,113808,268,491401,false,L-s-0 C-l-1 C-l-0 C-l-0 C-l-1 L-l-0 C-l-0 C-l-1 
job-9831,6,7,1,491088,604855,605132,113767,277,491391,false,C-m-0 
job-9833,5,11,5,491180,605123,605169,113943,46,491381,false,C-m-1 C-l-1 C-l-0 C-l-0 C-l-1 
job-9832,5,11,3,491136,605123,605196,113987,73,491248,false,L-l-0 L-l-0 L-m-0 
job-9834,6,4,4,491234,605132,605383,113898,251,491755,false,C-m-2 C-l-2 C-l-2 C-m-0 
job-9835,5,9,2,491284,605383,605445,114099,62,491523,false,L-l-0 L-l-0 
job-9836,2,4,7,491323,605445,605459,114122,14,491452,false,L-s-0 L-s-0 L-l-0 L-l-0 L-l-0 L-l-0 L-l-0 
job-9837,3,8,8,491379,605445,605514,114066,69,491448,false,C-m-0 C-l-1 C-l-1 C-l-1 C-l-1 L-m-0 C-m-0 L-m-0 
job-9838,2,10,8,491423,605514,605544,114091,30,491710,false,L-m-0 L-s-0 L-l-0 L-l-0 L-l-0 L-l-0 L-m-0 L-m-0 
job-9839,6,11,7,491456,605514,605554,114058,40,491677,false,C-l-1 C-l-0 C-l-1 C-l-2 C-l-0 C-l-2 C-m-0 
job-9841,4,6,8,491548,605554,605824,114006,270,492103,false,L-l-0 C-l-2 L-s-0 C-l-2 C-l-2 L-m-0 L-l-0 L-m-0 
job-9840,4,6,6,491501,605514,605853,114013,339,491940,false,C-s-1 C-m-1 C-m-1 C-m-2 L-l-0 C-m-2 
job-9842,1,6,7,491608,605853,605916,114245,63,491788,false,L-l-0 L-l-0 L-l-0 L-l-0 L-l-0 L-l-0 L-l-0 
job-9844,2,11,6,491717,605916,605926,114199,10,491745,false,L-m-0 L-s-0 L-l-0 L-l-0 L-l-0 L-l-0 
job-9845,4,5,2,491762,605916,605927,114154,11,491785,false,C-s-1 L-m-0 
job-9843,2,5,1,491663,605916,605962,114253,46,491944,false,L-s-0 
job-9847,5,11,7,491872,605962,606036,114090,74,491985,false,L-m-0 L-l-0 C-l-0 C-l-1 C-l-1 L-l-0 C-l-0 
job-9848,5,10,7,491916,606036,606097,114120,61,492271,false,C-l-1 L-l-0 C-l-0 C-l-1 C-l-0 L-l-0 L-m-0 
job-9849,4,4,1,491956,606036,606108,114080,72,492155,false,C-s-1 
job-9851,1,7,6,492081,606097,606117,114016,20,492143,false,L-m-0 L-m-0 C-s-2 L-m-0 L-l-0 L-m-0 
job-9850,2,12,3,492023,606097,606121,114074,24,492098,false,L-l-0 L-l-0 L-l-0 
job-9846,1,10,1,491813,605962,606122,114149,160,492038,false,L-s-0 
job-9852,3,4,6,492130,606097,606126,113967,29,492180,false,C-m-0 L-m-0 L-l-0 C-s-2 C-m-0 L-s-0 
job-9853,4,5,6,492190,606097,606223,113907,126,492561,false,C-l-0 C-l-1 C-l-0 C-l-0 C-l-1 C-l-1 
job-9854,4,8,6,492247,606097,606403,113850,306,492567,false,C-s-0 C-l-2 C-l-2 C-m-2 C-m-2 C-l-2 
job-9856,2,11,7,492335,606403,606428,114068,25,492558,false,C-m-0 L-l-0 L-l-0 C-m-0 L-l-0 L-l-0 L-s-0 
job-9857,4,11,7,492389,606403,606440,114014,37,492599,false,C-s-1 C-l-0 C-l-1 C-l-0 C-l-1 C-l-0 C-l-1 
job-9855,1,9,3,492299,606403,606475,114104,72,492643,false,L-m-0 L-m-0 L-m-0 
job-9858,2,9,2,492436,606403,606499,113967,96,492675,false,C-s-2 C-m-0 
job-9859,1,6,4,492485,606403,606529,113918,126,492868,false,C-s-2 C-m-2 C-m-2 C-m-2 
job-9861,6,10,2,492586,606499,606729,113913,230,493016,false,L-l-0 L-l-0 
job-9860,3,12,5,492533,606403,606750,113870,347,493159,false,C-l-2 C-m-2 C-l-2 C-l-2 C-l-2 
job-9864,5,8,3,492728,606729,606804,114001,75,492978,false,L-m-0 L-l-0 L-l-0 
job-9862,1,10,3,492634,606729,606817,114095,88,492932,false,L-s-0 C-m-2 C-m-2 
job-9863,2,8,1,492686,606729,606822,114043,93,492815,false,L-m-0 
job-9865,1,6,2,492786,606822,606876,114036,54,493058,false,L-s-0 L-s-0 
job-9866,1,6,1,492825,606822,607025,113997,203,493094,false,L-m-0 
job-9867,3,7,4,492868,607025,607054,114157,29,492915,false,L-l-0 L-l-0 L-l-0 L-l-0 
job-9868,3,6,3,492901,607025,607156,114124,131,493068,false,L-s-0 L-m-0 L-m-0 
job-9869,5,6,1,492954,607025,607312,114071,287,493274,false,C-m-0 
job-9870,2,11,3,493003,607312,607373,114309,61,493096,false,L-m-0 L-m-0 L-s-0 
job-9871,2,6,3,493047,607312,607449,114265,137,493215,false,L-l-0 L-m-0 L-l-0 
job-9873,3,7,7,493151,607312,607484,114161,172,493499,false,C-l-0 C-l-1 C-l-0 C-l-0 C-l-1 C-l-1 C-l-1 
job-9872,2,10,7,493105,607312,607532,114207,220,493550,false,C-m-0 L-l-0 L-l-0 C-s-0 L-l-0 C-m-0 C-m-0 
job-9874,5,11,1,493204,607312,607631,114108,319,493722,false,C-m-1 
job-9875,3,11,8,493244,607631,607669,114387,38,493446,false,L-m-0 L-l-0 L-l-0 L-m-0 L-l-0 L-l-0 C-s-2 L-s-0 
job-9876,3,10,6,493296,607631,607767,114335,136,493605,false,C-m-2 C-l-0 C-l-0 C-m-2 C-l-0 C-l-0 
job-9877,4,7,1,493345,607631,607876,114286,245,493642,false,C-s-1 
job-9878,5,9,5,493386,607631,607936,114245,305,493948,false,C-l-1 C-l-1 C-l-2 C-m-0 C-l-2 
job-9879,3,8,3,493441,607876,607989,114435,113,493794,false,L-m-0 L-m-0 C-m-0 
job-9880,5,11,1,493505,607876,608076,114371,200,493810,false,L-l-0 
job-9882,1,9,5,493611,608076,608095,114465,19,493744,false,L-m-0 L-m-0 L-s-0 L-m-0 C-s-1 
job-9881,1,7,6,493568,608076,608132,114508,56,493693,false,L-l-0 L-l-0 L-l-0 L-l-0 L-l-0 L-l-0 
job-9883,2,9,8,493671,608076,608459,114405,383,494228,false,C-m-0 C-l-1 C-l-1 C-l-1 C-l-1 C-m-0 C-l-1 C-m-0 
job-9884,1,11,8,493731,608459,608526,114728,67,493995,false,L-s-0 L-l-0 L-l-0 L-l-0 L-l-0 L-m-0 C-s-1 L-m-0 
job-9885,3,9,7,493785,608459,608539,114674,80,494138,false,C-m-0 C-l-0 C-l-0 C-m-0 C-l-0 C-l-0 L-m-0 
job-9886,1,5,3,493832,608539,608620,114707,81,493944,false,L-s-0 L-s-0 L-s-0 
job-9887,4,4,2,493881,608620,608630,114739,10,494156,false,L-m-0 L-m-0 
job-9888,5,6,1,493935,608620,608734,114685,114,494139,false,L-l-0 
job-9889,2,7,3,493995,608734,608853,114739,119,494153,false,L-m-0 L-m-0 L-m-0 
job-9891,6,10,8,494099,608853,608872,114754,19,494308,false,C-l-0 L-l-0 C-l-1 C-l-2 C-l-0 C-l-1 C-l-2 L-m-0 
job-9893,6,10,4,494212,608872,608882,114660,10,494446,false,L-l-0 C-l-0 C-l-0 L-m-0 
job-9890,1,6,6,494059,608853,608886,114794,33,494236,false,L-l-0 L-l-0 L-l-0 L-l-0 L-l-0 L-l-0 
job-9892,3,8,1,494157,608853,608902,114696,49,494234,false,L-s-0 
job-9895,5,11,1,494305,608872,608931,114567,59,494564,false,C-m-0 
job-9894,3,9,1,494259,608872,608941,114613,69,494458,false,C-s-1 
job-9896,3,9,6,494361,608872,609145,114511,273,494675,false,C-s-0 C-l-1 C-l-1 C-m-0 C-l-1 C-l-1 
job-9898,4,9,7,494444,609145,609199,114701,54,494638,false,C-l-1 C-l-0 C-l-1 L-s-0 C-l-0 C-l-0 C-l-1 
job-9900,3,10,7,494541,609199,609257,114658,58,494830,false,C-m-1 C-l-0 C-l-0 C-s-1 C-l-0 C-l-0 C-m-1 
job-9899,4,5,2,494493,609199,609261,114706,62,494709,false,L-s-0 C-s-2 
job-9897,6,8,4,494405,609145,609263,114740,118,494703,false,L-m-0 L-l-0 L-l-0 C-m-0 
job-9901,1,4,1,494580,609263,609357,114683,94,494747,false,L-s-0 
job-9902,1,7,3,494629,609263,609412,114634,149,494955,false,L-s-0 L-m-0 L-m-0 
job-9903,5,4,1,494692,609412,609589,114720,177,494963,false,L-m-0 
job-9904,4,6,3,494742,609589,609613,114847,24,494851,false,L-l-0 L-l-0 L-l-0 
job-9906,3,4,1,494844,609589,609628,114745,39,494949,false,L-m-0 
job-9908,5,5,7,494936,609628,609677,114692,49,495006,false,L-l-0 C-l-0 L-m-0 C-l-1 C-l-1 L-l-0 C-l-0 
job-9905,3,4,1,494799,609589,609689,114790,100,494928,false,L-s-0 
job-9907,1,5,3,494891,609628,610004,114737,376,495410,false,L-m-0 L-m-0 L-s-0 
job-9909,4,4,1,494986,610004,610016,115018,12,495189,false,L-s-0 
job-9910,1,8,6,495037,610004,610381,114967,377,495522,false,L-l-0 L-l-0 L-l-0 L-l-0 L-l-0 L-l-0 
job-9912,5,8,4,495122,610381,610510,115259,129,495298,false,C-m-0 L-l-0 L-l-0 L-m-0 
job-9911,1,11,7,495074,610004,610522,114930,518,495844,false,L-m-0 C-l-0 C-l-0 L-m-0 C-l-0 C-l-0 C-s-1 
job-9915,6,10,6,495266,610510,610523,115244,13,495381,false,C-l-1 C-l-1 C-l-2 C-m-0 L-m-0 C-l-2 
job-9914,6,12,2,495221,610510,610548,115289,38,495482,false,L-l-0 L-l-0 
job-9913,4,5,2,495173,610381,610550,115208,169,495492,false,L-s-0 C-s-2 
job-9916,1,7,6,495318,610510,610612,115192,102,495651,false,C-m-1 C-m-0 C-m-1 C-m-0 C-m-1 C-m-1 
job-9917,1,4,3,495370,610612,610665,115242,53,495719,false,L-s-0 L-s-0 L-s-0 
job-9918,6,7,2,495425,610612,610890,115187,278,495735,false,L-l-0 L-l-0 
job-9919,5,5,2,495472,610890,610904,115418,14,495598,false,L-l-0 L-l-0 
job-9922,5,9,6,495626,610890,610936,115264,46,495935,false,C-m-0 C-l-0 C-l-1 L-m-0 C-l-0 C-l-1 
job-9923,2,12,8,495675,610890,610939,115215,49,495793,false,C-l-0 C-l-2 C-l-2 C-l-2 C-l-1 C-l-2 C-s-1 C-m-0 
job-9921,4,11,4,495577,610890,610940,115313,50,495682,false,C-m-1 C-m-2 C-m-2 C-m-1 
job-9920,1,11,5,495524,610890,610968,115366,78,495719,false,L-s-0 L-m-0 L-l-0 L-m-0 L-l-0 
job-9924,5,7,1,495720,610968,611078,115248,110,495834,false,L-m-0 
job-9925,1,4,8,495768,611078,611089,115310,11,496061,false,L-m-0 L-m-0 L-m-0 L-m-0 L-m-0 L-m-0 L-m-0 L-m-0 
job-9926,4,8,6,495807,611078,611144,115271,66,495957,false,C-m-0 L-l-0 L-l-0 C-m-0 L-s-0 L-l-0 
job-9927,6,10,4,495856,611078,611289,115222,211,496198,false,C-l-0 C-l-1 C-l-1 C-l-0 
job-9928,6,5,1,495901,611289,611354,115388,65,496224,false,L-m-0 
job-9930,6,6,3,495993,611354,611382,115361,28,496206,false,L-m-0 C-l-1 C-l-1 
job-9929,3,8,6,495948,611289,611404,115341,115,496091,false,L-l-0 L-l-0 L-s-0 C-s-1 L-l-0 L-l-0 
job-9931,6,4,5,496044,611354,611464,115310,110,496387,false,C-l-2 C-l-2 C-l-0 C-m-0 C-l-0 
job-9932,5,10,1,496097,611354,611490,115257,136,496234,false,C-m-1 
job-9934,1,7,8,496190,611464,611651,115274,187,496465,false,L-s-0 L-m-0 L-m-0 C-m-2 C-m-1 C-m-1 C-m-2 C-m-1 
job-9933,6,4,4,496138,611382,611654,115244,272,496437,false,L-m-0 C-l-1 C-l-1 C-m-2 
job-9935,3,8,6,496236,611651,611665,115415,14,496503,false,L-s-0 L-l-0 L-l-0 C-s-1 L-l-0 L-l-0 
job-9936,1,7,7,496278,611651,611672,115373,21,496578,false,L-s-0 C-m-2 L-m-0 C-s-1 C-s-2 L-m-0 C-m-2 
job-9937,4,12,4,496326,611651,611851,115325,200,496719,false,C-l-2 C-l-2 C-l-2 C-s-0 
job-9938,6,8,7,496382,611654,611936,115272,282,496737,false,C-l-0 C-m-2 C-l-0 L-m-0 C-l-1 C-l-1 C-m-0 
job-9939,3,5,8,496429,611851,611944,115422,93,496668,false,L-l-0 L-l-0 L-l-0 C-l-2 C-l-2 L-l-0 C-l-2 C-l-2 
job-9940,5,7,4,496475,611936,611978,115461,42,496778,false,C-m-0 C-l-0 C-l-0 L-m-0 
job-9941,1,8,5,496515,611978,612090,115463,112,496908,false,L-l-0 L-l-0 L-l-0 L-l-0 L-l-0 
job-9942,2,5,3,496559,612090,612115,115531,25,496841,false,L-m-0 L-m-0 L-m-0 
job-9943,2,6,4,496611,612090,612150,115479,60,496673,false,L-l-0 L-m-0 L-l-0 L-l-0 
job-9944,2,6,3,496645,612150,612167,115505,17,496901,false,L-m-0 L-m-0 L-m-0 
job-9945,3,4,4,496701,612150,612173,115449,23,496793,false,L-l-0 L-l-0 L-l-0 L-l-0 
job-9946,3,10,4,496758,612150,612188,115392,38,496859,false,C-l-0 C-l-0 C-l-0 C-l-0 
job-9947,6,10,2,496812,612150,612195,115338,45,496940,false,C-l-1 C-l-1 
job-9948,5,8,1,496875,612150,612199,115275,49,496972,false,C-m-0 
job-9949,5,7,5,496921,612167,612327,115246,160,497226,false,L-m-0 C-l-2 C-m-2 C-m-1 C-l-2 
job-9950,2,12,1,496963,612327,612343,115364,16,497225,false,L-s-0 
job-9951,3,6,8,497000,612327,612398,115327,71,497152,false,C-m-0 L-l-0 L-l-0 L-l-0 L-l-0 L-m-0 C-m-0 L-m-0 
job-9952,3,4,3,497054,612327,612401,115273,74,497227,false,C-l-0 C-l-0 C-l-0 
job-9953,6,11,8,497101,612398,612465,115297,67,497250,false,L-l-0 L-l-0 C-l-1 C-l-2 C-l-1 C-m-0 C-l-2 L-m-0 
job-9954,3,11,4,497149,612465,612507,115316,42,497483,false,L-l-0 L-l-0 L-l-0 L-l-0 
job-9957,6,7,3,497331,612465,612635,115134,170,497624,false,C-l-0 C-l-0 C-m-0 
job-9956,2,7,3,497278,612465,612708,115187,243,497728,false,L-s-0 C-s-2 C-s-2 
job-9958,5,9,3,497381,612708,612723,115327,15,497600,false,C-m-0 L-l-0 L-l-0 
job-9959,3,9,2,497423,612708,612762,115285,54,497725,false,L-s-0 C-m-0 
job-9955,1,9,3,497216,612465,612765,115249,300,497782,false,L-m-0 L-m-0 L-m-0 
job-9960,1,12,3,497487,612708,612877,115221,169,497769,false,L-l-0 L-l-0 C-s-1 
job-9961,3,7,5,497530,612877,612891,115347,14,497603,false,L-l-0 L-s-0 L-l-0 L-l-0 L-l-0 
job-9962,6,8,3,497582,612877,612984,115295,107,497837,false,L-m-0 C-l-1 C-l-1 
job-9963,2,5,4,497627,612984,613012,115357,28,497673,false,L-m-0 L-m-0 L-m-0 L-m-0 
job-9964,6,12,7,497675,612984,613052,115309,68,497964,false,C-l-0 C-l-2 C-l-0 C-m-0 C-l-2 L-l-0 L-l-0 
job-9965,1,11,6,497728,612984,613068,115256,84,497923,false,L-s-0 C-l-1 C-l-1 C-m-0 C-l-1 C-l-1 
job-9966,3,6,1,497768,613012,613071,115244,59,497897,false,L-m-0 
job-9968,6,9,8,497871,613071,613181,115200,110,497981,false,L-l-0 C-l-0 L-l-0 C-l-2 C-l-0 L-m-0 C-l-2 C-m-0 
job-9967,1,12,1,497814,613071,613192,115257,121,498073,false,L-s-0 
job-9969,4,6,4,497909,613181,613217,115272,36,498072,false,L-m-0 L-l-0 L-l-0 L-m-0 
job-9970,6,9,7,497967,613181,613226,115214,45,498242,false,C-l-0 C-l-0 C-l-1 C-l-2 C-l-1 C-l-2 C-m-0 
job-9971,2,4,5,498019,613217,613249,115198,32,498133,false,L-m-0 C-m-0 L-m-0 L-m-0 L-m-0 
job-9972,5,11,6,498065,613226,613408,115161,182,498365,false,C-m-1 L-l-0 C-l-0 C-m-0 C-l-0 L-l-0 
job-9974,5,7,7,498162,613408,613437,115246,29,498408,false,C-m-0 C-l-1 C-l-0 C-l-2 C-l-1 C-l-2 C-l-0 
job-9975,3,12,2,498212,613408,613463,115196,55,498337,false,C-s-2 C-m-0 
job-9973,4,8,7,498106,613408,613466,115302,58,498185,false,L-l-0 L-m-0 L-s-0 L-l-0 L-m-0 L-l-0 C-s-1 
job-9976,5,7,2,498258,613408,613530,115150,122,498425,false,C-m-2 C-m-1 
job-9977,5,11,1,498297,613463,613562,115166,99,498695,false,C-m-0 
job-9979,5,8,6,498380,613562,613610,115182,48,498572,false,L-m-0 C-l-0 L-l-0 C-m-0 C-l-0 L-l-0 
job-9982,4,8,5,498540,613610,613675,115070,65,498749,false,C-s-1 C-m-0 C-m-0 C-s-0 L-l-0 
job-9981,3,5,3,498489,613610,613679,115121,69,498683,false,L-l-0 L-m-0 L-l-0 
job-9978,3,8,1,498338,613562,613704,115224,142,498702,false,L-s-0 
job-9980,2,8,2,498436,613610,613746,115174,136,498783,false,L-m-0 L-m-0 
job-9983,5,4,5,498596,613610,613782,115014,172,498909,false,C-m-1 C-l-1 C-l-0 C-l-0 C-l-1 
job-9984,4,10,3,498643,613782,613801,115139,19,498729,false,L-m-0 L-m-0 L-s-0 
job-9985,5,6,6,498712,613782,613884,115070,102,498930,false,L-l-0 C-l-0 C-l-0 C-l-1 C-l-1 L-l-0 
job-9986,2,9,8,498757,613782,614225,115025,443,499232,false,C-l-2 C-l-0 C-l-2 C-l-1 L-l-0 C-l-2 C-l-2 C-l-2 
job-9988,6,5,3,498843,614225,614317,115382,92,499059,false,L-l-0 L-l-0 L-m-0 
job-9987,4,6,1,498796,614225,614524,115429,299,499237,false,L-s-0 
job-9989,4,8,2,498887,614524,614545,115637,21,499106,false,L-m-0 L-m-0 
job-9990,6,11,4,498936,614524,614571,115588,47,499062,false,L-l-0 C-l-0 C-l-0 L-l-0 
job-9992,5,7,1,499032,614524,614587,115492,63,499286,false,C-m-0 
job-9991,2,7,3,498996,614524,614616,115528,92,499148,false,L-s-0 C-s-2 C-s-2 
job-9993,3,4,3,499084,614524,614726,115440,202,499498,false,C-m-1 C-m-1 C-m-0 
job-9994,1,4,2,499134,614726,614802,115592,76,499332,false,L-s-0 L-s-0 
job-9997,5,9,6,499259,614802,614828,115543,26,499367,false,C-l-0 C-l-2 C-l-2 C-l-1 C-l-0 C-l-1 
job-9995,2,6,3,499163,614726,614855,115563,129,499385,false,L-m-0 L-m-0 L-s-0 
job-9996,1,12,5,499221,614726,615008,115505,282,499774,false,L-l-0 L-l-0 L-m-0 L-l-0 L-l-0 
job-9998,1,9,8,499304,614802,615158,115498,356,499711,false,C-s-1 C-l-1 C-l-0 C-l-2 C-l-0 C-l-2 L-s-0 C-l-1 
job-9999,5,12,7,499360,615158,615279,115798,121,499606,false,L-m-0 L-l-0 C-l-0 C-l-1 C-l-0 L-l-0 C-l-1 

Total Jobs: ,10000
Deadline Met: ,2.0
Deadline Met Percentage: ,0.02%
