id,CPU (cores),Memory (GB),Executor,Arrival Time (T_A),Start Time (T_S),Finish Time (T_F),Waiting Time (T_W),Estimated Finish Time (T_est),Deadline Violation Time (T_D),Deadline Satisfied,Placement List
job-0,1,6,7,68,68,117,0,49,128,true,L-s-0 L-s-0 L-m-0 L-m-0 L-m-0 L-m-0 L-m-0 
job-2,4,4,6,171,171,204,0,33,437,true,L-s-0 L-m-0 L-m-0 C-s-0 C-s-1 C-s-2 
job-3,4,6,8,228,228,314,0,86,555,true,L-s-0 L-m-0 L-m-0 C-s-0 C-s-1 C-s-2 C-m-0 C-m-0 
job-6,4,4,2,395,395,460,0,65,654,true,C-m-0 C-l-0 
job-4,2,7,5,285,285,464,0,179,666,true,C-m-1 C-m-1 C-m-1 C-m-1 C-m-2 
job-5,4,11,8,338,338,614,0,276,804,true,C-m-2 L-s-0 L-m-0 L-m-0 C-s-0 C-s-1 C-s-2 C-m-0 
job-8,5,5,5,504,614,631,110,17,813,true,C-l-0 L-m-0 C-m-0 C-m-2 C-m-1 
job-1,6,7,2,112,112,752,0,640,997,true,L-l-0 L-l-0 
job-7,3,10,5,455,455,755,0,300,996,true,C-l-0 C-l-0 C-l-1 C-l-1 C-l-1 
job-11,5,10,2,667,755,777,88,22,938,true,L-l-0 C-l-0 
job-10,6,9,2,614,752,798,138,46,771,false,C-l-2 L-l-0 
job-13,3,12,5,780,780,815,0,35,938,true,C-l-1 C-l-1 L-s-0 C-s-0 C-s-1 
job-12,6,7,3,716,777,988,61,211,1174,true,L-l-0 C-l-0 C-l-1 
job-9,6,8,6,556,631,1084,75,453,1307,true,C-l-0 L-m-0 C-m-0 C-m-2 C-m-1 C-l-2 
job-14,6,4,7,832,1084,1186,252,102,1037,false,L-m-0 L-l-0 L-l-0 C-m-0 C-m-2 C-m-1 C-l-0 
job-17,2,4,7,976,1186,1201,210,15,1158,false,C-s-0 C-s-1 C-s-1 C-s-2 C-s-2 C-l-0 C-l-0 
job-18,1,7,4,1021,1186,1203,165,17,1126,false,L-m-0 C-m-0 C-m-2 C-m-1 
job-16,2,5,8,929,1186,1210,257,24,1230,true,L-m-0 L-l-0 C-m-0 C-m-2 C-m-1 L-s-0 L-s-0 C-s-0 
job-21,3,11,2,1159,1186,1236,27,50,1450,true,C-l-1 C-l-1 
job-19,5,9,2,1061,1186,1258,125,72,1395,true,C-l-0 C-l-2 
job-23,2,9,3,1258,1258,1290,0,32,1570,true,L-m-0 L-l-0 C-m-0 
job-15,5,9,6,877,1186,1308,309,122,1290,false,L-m-0 L-l-0 L-l-0 C-m-0 C-m-2 C-m-1 
job-22,4,7,3,1208,1208,1379,0,171,1423,true,C-l-0 C-l-1 C-s-1 
job-24,5,4,6,1317,1317,1425,0,108,1442,true,C-l-0 C-l-2 C-l-1 L-m-0 L-l-0 L-l-0 
job-20,1,8,7,1111,1186,1470,75,284,1606,true,C-l-0 C-l-0 C-l-0 C-l-2 C-l-2 C-l-2 C-l-2 
job-27,1,8,4,1478,1478,1527,0,49,1643,true,L-m-0 L-l-0 L-l-0 L-l-0 
job-29,2,7,4,1581,1581,1599,0,18,1609,true,L-m-0 L-l-0 L-l-0 L-l-0 
job-25,1,10,7,1374,1374,1615,0,241,1903,true,L-m-0 L-m-0 L-l-0 L-l-0 C-l-2 C-l-1 C-l-1 
job-30,4,9,5,1621,1621,1639,0,18,1685,true,L-m-0 L-l-0 L-l-0 C-l-1 C-l-0 
job-32,4,12,3,1725,1725,1744,0,19,1998,true,L-m-0 C-l-1 C-l-0 
job-31,6,8,1,1683,1683,1746,0,63,1790,true,L-l-0 
job-28,4,4,3,1518,1518,1814,0,296,2008,true,L-m-0 L-l-0 C-l-1 
job-26,3,12,3,1424,1424,1828,0,404,1843,true,C-l-0 C-l-1 L-s-0 
job-34,6,8,2,1839,1839,1879,0,40,2103,true,L-l-0 C-l-1 
job-35,3,11,7,1891,1891,1996,0,105,2059,true,L-l-0 L-l-0 C-m-0 C-m-2 C-m-1 C-l-1 C-l-1 
job-36,2,5,7,1942,1942,2011,0,69,2020,true,C-l-0 C-l-0 C-l-0 L-s-0 L-s-0 L-m-0 L-m-0 
job-37,5,10,3,1992,1996,2016,4,20,2264,true,L-l-0 C-l-1 C-l-2 
job-38,2,12,3,2042,2042,2063,0,21,2311,true,L-l-0 L-l-0 L-l-0 
job-33,5,11,6,1784,1784,2095,0,311,2152,true,L-l-0 C-l-1 C-l-0 C-m-0 C-m-2 C-m-1 
job-40,1,10,3,2125,2125,2160,0,35,2264,true,L-l-0 L-l-0 L-l-0 
job-39,1,6,1,2078,2078,2180,0,102,2403,true,L-l-0 
job-41,1,7,7,2172,2172,2306,0,134,2332,true,L-l-0 L-l-0 L-l-0 L-l-0 L-l-0 L-l-0 L-s-0 
job-43,4,5,5,2274,2274,2334,0,60,2453,true,L-l-0 C-s-1 C-s-0 C-s-2 C-m-1 
job-44,6,5,8,2318,2334,2352,16,18,2500,true,L-l-0 L-l-0 C-m-1 C-l-0 C-l-0 C-l-1 C-l-1 C-l-2 
job-46,5,9,1,2424,2424,2434,0,10,2648,true,C-m-1 
job-42,5,10,3,2224,2224,2474,0,250,2486,true,L-m-0 C-m-0 C-m-2 
job-45,2,12,8,2369,2369,2479,0,110,2595,true,L-m-0 C-m-0 C-m-2 L-s-0 L-l-0 L-l-0 L-l-0 L-l-0 
job-48,1,11,2,2513,2513,2552,0,39,2571,true,C-m-1 C-m-1 
job-47,6,7,7,2465,2465,2567,0,102,2624,true,C-m-1 C-l-0 C-l-0 C-l-1 C-l-1 C-l-2 C-l-2 
job-49,6,7,6,2555,2567,2590,12,23,2800,true,L-m-0 L-l-0 L-l-0 C-m-1 C-m-0 C-m-2 
job-50,4,6,1,2601,2601,2748,0,147,3034,true,L-s-0 
job-52,5,5,8,2707,2707,2750,0,43,2915,true,L-m-0 C-m-1 C-m-0 C-m-2 C-l-0 C-l-0 C-l-1 C-l-1 
job-53,5,10,5,2758,2758,2778,0,20,2932,true,C-m-1 C-m-0 C-m-2 C-l-0 C-l-0 
job-51,1,12,6,2656,2656,2779,0,123,2959,true,L-m-0 L-m-0 L-l-0 L-l-0 L-l-0 L-l-0 
job-54,6,8,6,2823,2823,2862,0,39,3059,true,L-m-0 L-l-0 L-l-0 C-m-1 C-m-0 C-m-2 
job-55,6,10,3,2867,2867,2891,0,24,2937,true,L-m-0 L-l-0 L-l-0 
job-56,4,11,3,2902,2902,2913,0,11,3133,true,L-s-0 L-m-0 L-m-0 
job-57,2,7,6,2932,2932,3028,0,96,3067,true,L-s-0 L-s-0 L-m-0 L-m-0 L-m-0 L-m-0 
job-58,3,8,8,2968,2968,3058,0,90,3100,true,L-l-0 L-l-0 L-l-0 L-l-0 C-s-1 C-s-0 C-s-2 C-m-1 
job-60,6,10,8,3071,3071,3216,0,145,3355,true,L-m-0 L-l-0 L-l-0 C-m-1 C-l-0 C-l-0 C-l-1 C-l-1 
job-59,6,11,2,3010,3010,3237,0,227,3446,true,C-m-0 C-m-2 
job-61,2,8,3,3117,3117,3290,0,173,3432,true,L-m-0 C-m-0 C-m-2 
job-64,3,6,8,3265,3265,3297,0,32,3368,true,C-m-1 C-m-0 C-m-0 C-m-2 C-m-2 L-s-0 C-s-1 C-s-0 
job-62,5,6,5,3162,3216,3308,54,92,3438,true,L-m-0 L-l-0 L-l-0 C-m-1 C-l-0 
job-66,3,11,6,3349,3349,3379,0,30,3648,true,C-m-0 C-l-0 C-l-0 L-s-0 L-m-0 L-m-0 
job-67,3,4,1,3409,3409,3523,0,114,3791,true,C-m-0 
job-69,1,11,4,3514,3514,3557,0,43,3625,true,L-s-0 L-m-0 L-m-0 L-l-0 
job-63,5,10,3,3213,3216,3567,3,351,3841,true,C-l-0 C-l-1 C-l-1 
job-70,6,7,7,3564,3564,3584,0,20,3700,true,L-m-0 L-l-0 L-l-0 C-m-1 C-m-2 C-l-2 C-l-2 
job-68,2,11,4,3458,3458,3586,0,128,3749,true,C-l-1 C-l-0 C-l-0 C-l-0 
job-65,5,4,1,3305,3305,3611,0,306,3866,true,C-m-0 
job-71,1,6,4,3606,3606,3661,0,55,3709,true,C-m-0 C-m-0 C-m-0 L-s-0 
job-73,2,8,5,3698,3698,3820,0,122,4024,true,L-m-0 L-l-0 L-l-0 L-l-0 L-s-0 
job-75,1,12,1,3799,3799,3873,0,74,4172,true,C-m-0 
job-74,3,7,8,3745,3745,3907,0,162,4097,true,C-s-1 C-s-0 C-s-2 C-m-0 C-m-0 C-m-1 C-m-1 C-m-2 
job-76,6,4,4,3851,3851,3925,0,74,4140,true,L-l-0 C-l-0 C-l-0 C-l-1 
job-77,6,8,1,3900,3900,3934,0,34,3966,true,C-l-1 
job-72,6,8,2,3649,3649,3944,0,295,4055,true,L-m-0 L-l-0 
job-80,3,11,5,4028,4028,4084,0,56,4288,true,L-l-0 C-m-0 C-m-1 C-m-2 C-l-1 
job-81,2,9,2,4065,4065,4108,0,43,4188,true,C-l-0 L-m-0 
job-82,3,8,5,4110,4110,4130,0,20,4140,true,L-l-0 C-m-0 C-m-1 C-m-2 C-l-1 
job-78,5,9,7,3936,3936,4283,0,347,4359,true,L-l-0 C-m-0 C-m-1 C-m-2 C-l-0 C-l-0 C-l-1 
job-79,4,5,3,3976,3976,4362,0,386,4539,true,L-l-0 C-l-1 L-s-0 
job-87,4,11,1,4363,4363,4394,0,31,4608,true,C-l-2 
job-83,5,5,6,4161,4283,4414,122,131,4404,false,L-l-0 C-l-1 L-m-0 C-m-0 C-m-1 C-m-2 
job-85,2,11,3,4259,4283,4433,24,150,4699,true,L-l-0 C-m-0 C-m-1 
job-88,3,7,2,4413,4413,4449,0,36,4559,true,C-m-2 C-l-2 
job-90,1,9,5,4499,4499,4527,0,28,4531,true,L-l-0 C-l-0 C-l-0 C-l-1 C-l-1 
job-84,1,5,2,4205,4283,4583,78,300,4552,false,L-m-0 L-m-0 
job-89,3,11,4,4458,4458,4586,0,128,4742,true,L-m-0 L-m-0 L-l-0 L-l-0 
job-91,5,7,4,4544,4544,4618,0,74,4883,true,C-l-1 C-l-2 C-m-0 C-m-1 
job-92,5,10,1,4596,4596,4657,0,61,4871,true,L-l-0 
job-93,6,12,6,4647,4647,4665,0,18,4875,true,C-l-1 C-l-2 L-m-0 C-m-0 C-m-1 C-m-2 
job-86,5,10,5,4310,4362,4762,52,400,4718,false,L-l-0 C-l-1 C-l-0 C-l-0 C-l-2 
job-95,1,6,6,4757,4762,4782,5,20,4938,true,L-m-0 L-m-0 L-m-0 L-l-0 L-l-0 C-m-0 
job-94,5,4,8,4699,4762,4789,63,27,4971,true,L-m-0 L-l-0 L-l-0 C-m-0 C-m-1 C-m-2 C-l-0 C-l-0 
job-96,3,7,7,4804,4804,4883,0,79,4941,true,L-s-0 L-m-0 L-m-0 L-l-0 L-l-0 L-l-0 L-l-0 
job-98,4,10,6,4912,4912,4942,0,30,4987,true,L-m-0 L-s-0 L-l-0 L-l-0 L-l-0 C-s-0 
job-99,3,12,5,4959,4959,4977,0,18,5128,true,L-m-0 L-s-0 L-l-0 L-l-0 L-l-0 
job-100,5,9,3,5012,5012,5041,0,29,5073,true,L-m-0 L-l-0 L-l-0 
job-97,2,12,2,4857,4857,5098,0,241,5126,true,L-m-0 C-s-1 
job-102,1,10,2,5117,5117,5129,0,12,5355,true,L-m-0 L-l-0 
job-101,2,10,6,5064,5064,5194,0,130,5341,true,L-m-0 L-m-0 L-s-0 L-l-0 L-l-0 L-l-0 
job-103,4,8,5,5170,5170,5274,0,104,5289,true,L-m-0 L-l-0 C-s-1 C-s-0 C-s-2 
job-105,4,6,6,5282,5282,5298,0,16,5514,true,L-m-0 L-l-0 L-l-0 C-s-1 C-s-0 C-s-2 
job-106,6,10,5,5326,5326,5347,0,21,5619,true,L-m-0 L-l-0 C-m-0 C-m-1 C-m-2 
job-104,1,9,7,5225,5225,5350,0,125,5518,true,L-m-0 L-m-0 L-l-0 L-l-0 L-l-0 L-l-0 L-s-0 
job-109,2,5,3,5476,5476,5506,0,30,5513,true,L-l-0 C-s-1 C-s-1 
job-107,4,8,3,5377,5377,5525,0,148,5571,true,L-s-0 L-m-0 L-m-0 
job-110,5,8,3,5532,5532,5550,0,18,5578,true,L-m-0 C-m-0 C-m-1 
job-108,5,12,2,5425,5425,5618,0,193,5703,true,L-l-0 L-l-0 
job-113,5,7,7,5671,5671,5703,0,32,5707,true,L-l-0 C-m-1 C-m-2 C-l-0 C-l-0 C-l-1 C-l-1 
job-112,3,5,3,5624,5624,5738,0,114,5965,true,C-m-0 L-l-0 L-l-0 
job-114,5,6,2,5727,5727,5774,0,47,5795,true,L-l-0 C-m-1 
job-111,4,4,7,5585,5585,5804,0,219,5884,true,L-s-0 L-m-0 L-m-0 C-s-1 C-s-0 C-s-2 C-m-0 
job-115,5,5,7,5790,5790,5852,0,62,5974,true,L-l-0 L-l-0 C-m-1 C-m-2 C-l-0 C-l-0 C-l-1 
job-116,5,7,2,5835,5835,5952,0,117,6178,true,C-l-1 L-m-0 
job-118,2,10,8,5931,5931,5973,0,42,6083,true,L-m-0 C-l-1 C-s-0 C-s-2 C-m-1 C-m-1 C-m-1 C-m-2 
job-119,1,9,1,5982,5982,6055,0,73,6167,true,C-l-1 
job-120,2,7,3,6023,6023,6128,0,105,6311,true,C-l-1 C-l-1 C-l-1 
job-122,6,8,3,6116,6116,6184,0,68,6313,true,L-m-0 C-m-1 C-m-2 
job-123,3,10,7,6168,6168,6202,0,34,6369,true,C-l-1 C-l-1 C-s-0 C-s-2 C-m-0 C-m-0 C-l-0 
job-117,4,7,6,5883,5883,6206,0,323,6482,true,C-l-1 L-s-0 L-l-0 L-l-0 L-l-0 C-s-1 
job-124,6,12,5,6209,6209,6275,0,66,6434,true,C-l-1 L-l-0 L-l-0 C-m-1 C-m-2 
job-125,2,4,1,6258,6258,6328,0,70,6543,true,L-m-0 
job-127,1,7,8,6360,6360,6378,0,18,6453,true,L-s-0 L-l-0 L-l-0 L-l-0 L-l-0 L-l-0 L-l-0 C-l-1 
job-126,3,4,6,6304,6304,6415,0,111,6671,true,L-m-0 C-l-1 C-l-1 C-l-1 L-s-0 L-l-0 
job-121,1,11,3,6066,6066,6434,0,368,6610,true,C-l-1 L-m-0 L-m-0 
job-128,6,5,4,6409,6409,6527,0,118,6696,true,L-l-0 C-m-1 C-m-2 C-m-0 
job-130,6,9,5,6504,6504,6570,0,66,6593,true,C-l-1 C-l-1 C-l-0 C-l-0 C-l-2 
job-131,2,8,3,6566,6566,6621,0,55,6918,true,L-m-0 L-l-0 L-l-0 
job-132,5,11,8,6619,6619,6695,0,76,6814,true,C-m-1 C-m-2 C-m-0 C-l-1 C-l-1 C-l-0 C-l-0 C-l-2 
job-129,5,10,2,6449,6449,6716,0,267,6764,true,L-l-0 L-m-0 
job-134,6,12,7,6742,6742,6808,0,66,6871,true,L-l-0 C-l-2 L-m-0 C-m-1 C-m-2 C-m-0 C-l-1 
job-133,4,5,6,6683,6683,6837,0,154,7133,true,L-l-0 C-l-2 L-s-0 C-s-1 C-s-0 C-s-2 
job-135,6,11,2,6786,6786,6897,0,111,6962,true,C-l-1 C-l-0 
job-136,4,11,2,6832,6832,6919,0,87,7179,true,L-l-0 L-l-0 
job-137,6,7,3,6877,6877,6931,0,54,7174,true,C-l-1 C-l-0 L-m-0 
job-138,3,7,1,6923,6923,6999,0,76,7054,true,C-l-1 
job-140,6,9,1,7017,7017,7043,0,26,7097,true,C-m-1 
job-139,4,9,8,6967,6967,7067,0,100,7239,true,C-l-1 C-l-1 L-s-0 L-m-0 L-m-0 L-l-0 L-l-0 L-l-0 
job-141,1,6,2,7062,7062,7074,0,12,7185,true,C-l-1 C-l-1 
job-143,2,9,7,7158,7158,7175,0,17,7300,true,L-m-0 L-l-0 C-m-1 L-s-0 C-s-1 C-s-0 C-s-2 
job-142,5,8,4,7113,7113,7182,0,69,7208,true,L-m-0 L-l-0 L-l-0 C-m-1 
job-146,3,5,6,7320,7320,7334,0,14,7444,true,L-l-0 C-s-1 C-s-0 C-s-2 C-m-0 C-m-0 
job-145,6,10,2,7268,7268,7454,0,186,7717,true,C-m-1 C-m-2 
job-144,4,6,5,7211,7211,7497,0,286,7697,true,L-s-0 L-m-0 L-m-0 L-l-0 L-l-0 
job-149,5,8,6,7459,7497,7539,38,42,7669,true,C-l-2 L-m-0 L-l-0 L-l-0 C-m-1 C-m-2 
job-150,6,9,5,7495,7539,7559,44,20,7689,true,C-l-2 L-m-0 L-l-0 L-l-0 C-m-1 
job-147,6,5,2,7370,7370,7591,0,221,7851,true,C-m-0 C-l-1 
job-148,5,4,4,7414,7414,7610,0,196,7635,true,C-l-1 C-l-0 C-l-0 C-l-2 
job-151,1,4,5,7534,7539,7636,5,97,7644,true,L-m-0 L-m-0 C-m-1 C-m-1 C-m-0 
job-152,2,8,8,7590,7590,7636,0,46,7658,true,L-m-0 L-m-0 L-m-0 C-m-1 C-m-1 C-m-1 C-l-0 C-l-2 
job-153,2,6,7,7645,7645,7656,0,11,7858,true,L-s-0 L-s-0 L-m-0 L-m-0 L-m-0 L-m-0 L-l-0 
job-154,1,12,5,7694,7694,7787,0,93,8043,true,L-s-0 L-m-0 L-m-0 L-l-0 L-l-0 
job-156,3,6,1,7783,7783,7802,0,19,7921,true,L-m-0 
job-155,3,10,5,7733,7733,7806,0,73,8066,true,L-l-0 L-l-0 C-s-1 C-s-0 C-s-2 
job-157,5,4,5,7833,7833,7908,0,75,8079,true,L-m-0 L-l-0 L-l-0 C-m-0 C-m-1 
job-158,2,11,4,7893,7893,7937,0,44,8083,true,L-m-0 L-l-0 C-m-0 C-m-1 
job-159,2,5,8,7940,7940,8044,0,104,8240,true,L-s-0 L-s-0 L-m-0 L-m-0 L-m-0 L-m-0 L-l-0 L-l-0 
job-161,4,4,8,8042,8042,8118,0,76,8280,true,C-s-1 C-s-0 C-s-2 C-l-1 C-l-1 C-l-1 C-l-0 C-l-0 
job-162,4,6,7,8088,8088,8120,0,32,8347,true,L-l-0 C-l-0 L-s-0 L-m-0 L-m-0 C-l-2 C-l-2 
job-163,2,11,4,8144,8144,8155,0,11,8425,true,L-l-0 L-l-0 L-l-0 C-m-0 
job-165,4,8,5,8231,8231,8287,0,56,8471,true,L-s-0 L-m-0 L-m-0 C-s-1 C-s-0 
job-166,4,9,1,8286,8286,8325,0,39,8403,true,C-s-2 
job-160,5,6,4,7994,7994,8340,0,346,8369,true,L-l-0 C-m-0 C-m-1 C-m-2 
job-168,1,9,5,8385,8385,8430,0,45,8660,true,L-l-0 C-m-0 C-m-0 L-s-0 L-m-0 
job-164,2,9,4,8187,8187,8482,0,295,8674,true,L-l-0 L-l-0 L-l-0 C-m-0 
job-169,5,11,2,8438,8438,8488,0,50,8733,true,C-m-0 L-m-0 
job-172,6,8,6,8567,8567,8582,0,15,8843,true,L-l-0 C-m-0 C-m-1 C-m-2 C-l-1 C-l-1 
job-167,2,9,1,8340,8340,8610,0,270,8883,true,L-l-0 
job-170,2,12,5,8474,8474,8639,0,165,8828,true,L-m-0 L-l-0 L-s-0 C-s-1 C-s-0 
job-173,2,8,8,8618,8618,8665,0,47,8928,true,L-m-0 L-l-0 L-l-0 L-l-0 L-l-0 C-s-2 C-s-2 C-m-0 
job-174,4,5,6,8658,8658,8726,0,68,8949,true,L-m-0 L-l-0 C-m-0 L-s-0 C-s-1 C-s-0 
job-176,3,5,2,8745,8745,8762,0,17,8782,true,L-m-0 L-l-0 
job-171,1,10,1,8527,8527,8826,0,299,8974,true,L-m-0 
job-177,2,5,6,8790,8790,8886,0,96,9154,true,L-m-0 L-m-0 L-l-0 L-l-0 L-l-0 L-s-0 
job-179,2,7,5,8881,8881,8935,0,54,9086,true,C-s-0 C-s-0 C-s-2 C-s-2 C-m-0 
job-180,4,8,5,8929,8929,8944,0,15,9073,true,L-m-0 L-l-0 C-m-0 C-m-1 C-m-1 
job-178,1,5,6,8837,8837,9002,0,165,9260,true,L-s-0 L-s-0 L-m-0 C-s-1 C-s-1 C-s-1 
job-181,6,11,7,8971,8971,9067,0,96,9115,true,L-l-0 C-m-0 C-m-1 C-m-2 C-l-1 C-l-1 C-l-0 
job-183,5,5,3,9066,9067,9112,1,45,9135,true,L-l-0 C-m-0 C-m-1 
job-175,3,6,3,8702,8702,9166,0,464,9283,true,L-m-0 L-l-0 L-l-0 
job-182,2,7,7,9015,9015,9180,0,165,9312,true,L-m-0 L-m-0 C-m-0 C-m-1 C-m-2 C-l-0 C-l-0 
job-184,6,7,5,9118,9118,9212,0,94,9240,true,L-l-0 C-m-0 C-m-1 C-m-2 C-l-0 
job-185,3,12,8,9174,9174,9242,0,68,9341,true,L-m-0 L-l-0 L-l-0 L-s-0 C-s-1 C-s-0 C-s-2 C-l-1 
job-186,2,11,4,9229,9229,9267,0,38,9332,true,L-m-0 L-l-0 L-l-0 C-l-1 
job-187,6,8,4,9276,9276,9348,0,72,9535,true,L-m-0 L-l-0 L-l-0 C-m-0 
job-191,6,9,4,9465,9465,9475,0,10,9698,true,C-m-1 C-m-2 C-l-1 C-l-1 
job-190,3,10,1,9421,9421,9494,0,73,9672,true,L-l-0 
job-192,2,12,4,9516,9516,9528,0,12,9536,true,L-l-0 C-s-1 C-s-0 C-s-2 
job-189,3,4,8,9370,9370,9541,0,171,9743,true,L-m-0 L-m-0 C-m-0 C-m-0 L-s-0 L-l-0 L-l-0 L-l-0 
job-188,1,12,3,9319,9319,9551,0,232,9612,true,L-m-0 L-m-0 C-m-0 
job-193,4,5,2,9561,9561,9604,0,43,9794,true,L-s-0 L-m-0 
job-194,1,10,4,9605,9605,9700,0,95,9810,true,L-s-0 L-m-0 L-m-0 L-m-0 
job-195,2,7,2,9663,9663,9738,0,75,9890,true,L-l-0 L-l-0 
job-197,5,10,3,9758,9758,9854,0,96,10017,true,L-l-0 C-m-1 C-m-2 
job-199,4,8,5,9851,9851,9934,0,83,10082,true,L-s-0 C-s-1 C-s-0 C-s-2 C-l-1 
job-198,1,12,5,9801,9801,9944,0,143,10012,true,L-m-0 L-m-0 L-l-0 L-l-0 C-m-1 
job-200,3,4,7,9905,9905,9961,0,56,10052,true,L-l-0 C-m-0 C-m-1 C-m-1 C-l-1 C-l-1 C-m-2 
job-196,5,7,3,9711,9711,9961,0,250,10101,true,L-l-0 L-m-0 C-m-0 
job-201,2,7,3,9954,9954,10022,0,68,10047,true,L-m-0 L-l-0 L-l-0 
job-203,6,6,3,10053,10053,10111,0,58,10305,true,C-m-0 C-m-1 C-m-2 
job-204,4,7,5,10106,10106,10191,0,85,10422,true,L-m-0 L-l-0 C-s-1 C-s-0 C-s-2 
job-205,2,11,5,10146,10146,10271,0,125,10480,true,C-m-0 C-m-0 C-m-1 C-m-1 C-m-2 
job-206,2,7,6,10189,10189,10336,0,147,10411,true,C-m-0 C-m-1 C-m-2 C-m-2 C-m-2 C-l-1 
job-202,4,9,4,9996,9996,10364,0,368,10414,true,L-m-0 L-l-0 L-l-0 L-s-0 
job-207,1,5,6,10237,10237,10367,0,130,10403,true,L-m-0 L-m-0 L-m-0 L-m-0 L-l-0 L-l-0 
job-209,4,9,1,10321,10321,10373,0,52,10409,true,C-s-0 
job-210,6,4,3,10366,10366,10400,0,34,10556,true,L-l-0 C-m-2 C-l-0 
job-211,6,6,5,10409,10409,10508,0,99,10805,true,L-m-0 L-l-0 L-l-0 C-m-2 C-l-0 
job-208,3,8,8,10284,10284,10552,0,268,10838,true,C-m-0 C-m-0 C-m-1 C-m-1 C-l-1 C-l-1 C-l-1 C-s-1 
job-212,5,8,6,10467,10508,10630,41,122,10858,true,L-m-0 L-l-0 L-l-0 C-m-2 C-l-0 C-l-0 
job-213,5,8,4,10505,10552,10638,47,86,10856,true,C-m-0 C-m-1 C-l-1 C-l-1 
job-215,4,6,3,10615,10630,10660,15,30,10775,true,C-l-0 L-s-0 C-s-1 
job-217,4,10,7,10714,10714,10804,0,90,10987,true,C-l-1 L-s-0 C-s-1 C-s-0 C-s-2 C-l-2 C-l-2 
job-220,2,5,5,10875,10875,10891,0,16,10989,true,L-l-0 C-l-0 C-l-2 C-l-2 C-l-2 
job-216,5,9,4,10672,10672,10901,0,229,11189,true,C-l-0 C-m-0 C-m-1 C-l-1 
job-219,5,7,1,10819,10819,10921,0,102,11066,true,C-l-2 
job-218,3,10,7,10767,10804,10925,37,121,11029,true,L-m-0 C-m-2 C-m-0 C-m-1 C-l-1 C-l-1 L-s-0 
job-214,5,11,5,10555,10630,11012,75,382,10979,false,L-m-0 L-l-0 L-l-0 C-m-2 C-l-0 
job-221,5,10,3,10937,10937,11015,0,78,11102,true,C-l-0 C-m-0 C-m-1 
job-223,3,10,8,11037,11037,11092,0,55,11280,true,L-m-0 C-m-2 C-l-0 C-l-0 L-s-0 C-s-1 C-s-0 C-s-2 
job-222,5,7,7,10984,11012,11177,28,165,11302,true,C-l-0 L-m-0 L-l-0 L-l-0 C-m-2 C-l-1 C-l-1 
job-224,6,12,8,11081,11177,11526,96,349,11672,true,L-m-0 L-l-0 L-l-0 C-m-2 C-m-0 C-m-1 C-l-1 C-l-1 
job-225,5,8,7,11132,11526,11629,394,103,11304,false,L-m-0 L-l-0 L-l-0 C-m-2 C-m-0 C-m-1 C-l-1 
job-226,5,4,8,11185,11629,11662,444,33,11446,false,L-m-0 L-l-0 L-l-0 C-m-2 C-m-0 C-m-1 C-l-1 C-l-1 
job-228,3,4,1,11274,11629,11693,355,64,11445,false,L-m-0 
job-231,1,7,4,11441,11662,11697,221,35,11749,true,L-m-0 L-m-0 L-m-0 L-m-0 
job-232,2,5,7,11513,11662,11796,149,134,11753,false,L-l-0 L-l-0 C-l-0 C-l-1 C-l-1 C-l-2 C-l-2 
job-227,4,6,5,11232,11629,11843,397,214,11708,false,L-s-0 C-s-1 C-s-0 C-s-2 C-l-0 
job-233,3,8,5,11581,11796,11865,215,69,11706,false,L-l-0 C-l-1 C-l-2 C-l-2 L-m-0 
job-229,2,8,8,11330,11629,11935,299,306,11923,false,L-l-0 C-m-2 C-m-0 C-m-1 C-l-1 C-l-0 C-l-0 C-l-0 
job-230,6,10,6,11377,11662,11969,285,307,11881,false,L-l-0 C-m-2 C-m-0 C-m-1 C-l-1 C-l-2 
job-235,5,8,4,11693,11969,11999,276,30,11751,false,C-l-2 C-l-0 L-l-0 L-l-0 
job-241,5,7,1,11987,11999,12019,12,20,12117,true,C-l-0 
job-234,6,8,3,11628,11865,12035,237,170,11895,false,C-l-0 C-l-2 L-m-0 
job-240,5,6,3,11951,11999,12038,48,39,12213,true,L-l-0 L-l-0 C-l-2 
job-239,1,7,7,11905,11969,12056,64,87,12080,true,C-m-0 C-l-2 C-l-0 C-m-1 C-m-1 C-m-1 C-m-1 
job-242,4,6,8,12047,12047,12059,0,12,12344,true,L-m-0 L-l-0 L-l-0 C-l-2 C-l-2 C-l-0 C-l-0 C-l-1 
job-236,2,5,8,11741,11969,12130,228,161,11993,false,L-m-0 L-l-0 L-s-0 L-s-0 C-s-1 C-s-1 C-s-0 C-s-0 
job-237,2,7,5,11799,11969,12147,170,178,12146,false,C-s-2 C-s-2 C-m-2 C-m-2 C-m-2 
job-243,1,7,4,12107,12107,12166,0,59,12332,true,L-m-0 L-m-0 L-m-0 L-l-0 
job-238,2,7,4,11856,11969,12179,113,210,12291,true,C-m-2 C-m-0 C-m-0 C-m-0 
job-244,1,10,8,12153,12153,12182,0,29,12404,true,L-m-0 L-l-0 L-l-0 L-l-0 L-l-0 C-m-0 C-m-2 C-m-2 
job-245,6,11,4,12211,12211,12223,0,12,12352,true,L-m-0 L-l-0 L-l-0 C-m-0 
job-246,2,9,1,12262,12262,12354,0,92,12611,true,L-s-0 
job-247,3,12,5,12312,12312,12378,0,66,12517,true,L-m-0 L-m-0 L-l-0 L-l-0 L-l-0 
job-249,4,9,8,12391,12391,12479,0,88,12656,true,L-l-0 L-l-0 L-s-0 L-m-0 L-m-0 C-s-1 C-s-0 C-m-0 
job-248,1,9,2,12348,12348,12494,0,146,12584,true,L-l-0 C-s-2 
job-250,1,9,4,12431,12431,12646,0,215,12837,true,L-l-0 L-l-0 C-m-0 C-m-0 
job-252,3,12,6,12528,12528,12676,0,148,12777,true,L-l-0 C-m-2 C-s-2 C-m-1 C-m-1 C-l-2 
job-253,5,11,5,12581,12581,12874,0,293,12881,true,C-l-2 C-l-0 C-l-0 C-l-1 C-l-1 
job-251,3,12,8,12483,12483,12887,0,404,13052,true,L-l-0 C-m-0 L-s-0 L-m-0 L-m-0 C-s-1 C-s-0 C-m-2 
job-254,5,4,7,12629,12874,12887,245,13,12784,false,L-l-0 C-m-2 C-m-0 C-m-1 C-l-0 C-l-0 C-l-1 
job-255,6,10,8,12669,12887,13172,218,285,12954,false,L-m-0 L-l-0 L-l-0 C-m-2 C-m-0 C-m-1 C-l-0 C-l-0 
job-257,6,5,4,12758,13172,13188,414,16,12925,false,C-l-0 C-l-1 C-l-1 C-l-2 
job-256,5,7,7,12720,13172,13290,452,118,13036,false,L-m-0 L-l-0 L-l-0 C-m-2 C-m-0 C-m-1 C-l-0 
job-258,6,11,7,12810,13290,13352,480,62,12968,false,L-m-0 L-l-0 L-l-0 C-m-2 C-m-0 C-m-1 C-l-0 
job-260,5,12,3,12914,13290,13363,376,73,13083,false,C-l-1 C-l-1 C-l-2 
job-259,3,11,5,12864,13290,13389,426,99,13133,false,C-l-0 C-l-0 L-s-0 C-s-1 C-s-0 
job-261,5,4,8,12977,13352,13523,375,171,13339,false,C-l-0 C-l-2 L-m-0 L-l-0 L-l-0 C-m-2 C-m-0 C-m-1 
job-263,2,12,4,13069,13523,13567,454,44,13374,false,L-m-0 L-l-0 C-m-2 C-m-0 
job-264,2,11,8,13130,13523,13593,393,70,13348,false,C-m-1 L-s-0 C-s-1 C-s-0 C-s-2 C-l-0 C-l-0 C-l-0 
job-267,1,9,1,13301,13593,13612,292,19,13419,false,C-m-1 
job-262,5,4,6,13022,13523,13655,501,132,13361,false,L-m-0 L-l-0 L-l-0 C-m-2 C-m-0 C-m-1 
job-266,1,4,6,13255,13593,13670,338,77,13439,false,L-m-0 L-m-0 L-m-0 L-l-0 L-l-0 C-m-1 
job-269,5,12,3,13409,13655,13683,246,28,13581,false,L-m-0 C-m-1 C-m-2 
job-268,6,11,1,13360,13655,13695,295,40,13641,false,L-l-0 
job-270,2,5,3,13455,13655,13697,200,42,13662,false,L-l-0 L-l-0 C-m-1 
job-265,6,4,6,13200,13593,13729,393,136,13625,false,C-l-0 C-l-0 C-l-2 C-l-2 C-l-1 C-l-1 
job-271,5,6,3,13505,13683,13747,178,64,13721,false,C-m-1 L-m-0 C-m-2 
job-273,2,11,3,13623,13683,13816,60,133,13987,true,L-s-0 C-s-1 C-s-0 
job-275,4,4,6,13713,13729,13839,16,110,14064,true,L-l-0 L-l-0 C-s-2 C-l-0 C-l-0 C-l-0 
job-274,6,11,1,13677,13683,13842,6,159,14112,true,C-m-0 
job-278,5,10,5,13850,13850,13905,0,55,14160,true,L-l-0 L-l-0 C-m-0 C-m-1 C-l-0 
job-277,6,10,1,13803,13803,13918,0,115,13934,true,C-m-2 
job-272,2,10,3,13563,13683,13964,120,281,13943,false,L-m-0 L-l-0 C-m-2 
job-276,5,4,1,13760,13760,13982,0,222,14189,true,L-m-0 
job-279,1,6,1,13898,13898,13997,0,99,14227,true,L-m-0 
job-280,3,8,1,13948,13948,14041,0,93,14044,true,L-l-0 
job-282,1,8,5,14040,14040,14077,0,37,14149,true,L-m-0 L-m-0 L-l-0 L-l-0 L-l-0 
job-281,6,10,7,13992,13992,14097,0,105,14394,true,L-m-0 L-l-0 C-m-2 C-m-0 C-m-1 C-l-0 C-l-0 
job-283,3,12,1,14091,14091,14152,0,61,14228,true,L-l-0 
job-284,6,5,5,14135,14135,14203,0,68,14382,true,L-l-0 L-m-0 C-m-2 C-m-0 C-m-1 
job-285,6,10,7,14192,14192,14321,0,129,14458,true,L-l-0 C-l-0 C-l-0 C-l-2 C-l-2 C-l-1 C-l-1 
job-286,4,4,7,14248,14248,14402,0,154,14404,true,L-l-0 L-s-0 L-m-0 L-m-0 C-s-2 C-s-1 C-s-0 
job-287,4,7,4,14288,14288,14419,0,131,14554,true,C-m-2 C-m-2 C-m-0 C-m-0 
job-288,6,12,5,14343,14343,14443,0,100,14496,true,L-l-0 C-m-1 C-l-0 C-l-0 C-l-2 
job-291,2,8,1,14490,14490,14522,0,32,14542,true,L-l-0 
job-290,5,10,6,14435,14443,14526,8,83,14749,true,L-l-0 C-l-2 C-m-1 C-m-2 C-m-0 C-l-0 
job-289,4,10,8,14392,14402,14587,10,185,14868,true,L-l-0 C-l-2 L-s-0 L-m-0 L-m-0 C-s-2 C-s-1 C-s-0 
job-293,6,12,4,14588,14588,14613,0,25,14709,true,L-l-0 L-m-0 C-m-1 C-m-2 
job-292,3,12,1,14541,14541,14650,0,109,14757,true,L-l-0 
job-295,2,4,6,14676,14676,14695,0,19,14778,true,L-m-0 L-l-0 C-s-0 C-s-0 C-m-1 C-m-1 
job-294,3,5,8,14631,14631,14740,0,109,14889,true,L-l-0 L-l-0 L-l-0 L-s-0 L-m-0 L-m-0 C-s-2 C-s-1 
job-296,2,6,5,14731,14731,14783,0,52,14811,true,L-m-0 L-l-0 C-s-0 C-s-0 C-m-1 
job-298,1,5,5,14827,14827,14905,0,78,15088,true,L-m-0 L-m-0 L-l-0 L-l-0 L-l-0 
job-297,6,7,2,14781,14781,14971,0,190,15064,true,L-m-0 L-l-0 
job-301,4,8,6,14975,14975,15000,0,25,15098,true,L-m-0 L-l-0 L-l-0 C-l-1 L-s-0 C-s-0 
job-299,6,4,8,14884,14884,15220,0,336,15225,true,C-m-1 C-m-2 C-m-0 C-l-2 C-l-2 C-l-0 C-l-0 C-l-1 
job-300,1,6,4,14931,14931,15221,0,290,15447,true,L-m-0 L-m-0 L-l-0 L-l-0 
job-304,5,9,1,15129,15220,15266,91,46,15324,true,C-l-1 
job-303,4,4,7,15063,15220,15276,157,56,15293,true,L-s-0 C-s-0 C-s-2 C-s-1 C-l-0 C-l-0 C-l-0 
job-305,2,6,2,15178,15220,15293,42,73,15513,true,C-m-1 C-m-2 
job-306,1,8,2,15235,15235,15306,0,71,15440,true,L-m-0 L-m-0 
job-302,5,12,8,15029,15220,15471,191,251,15388,false,L-m-0 L-l-0 L-l-0 C-m-1 C-m-2 C-m-0 C-l-2 C-l-2 
job-307,5,10,5,15278,15471,15568,193,97,15442,false,L-m-0 L-l-0 L-l-0 C-m-1 C-m-2 
job-309,4,6,4,15366,15471,15574,105,103,15470,false,C-s-0 C-s-2 C-s-1 C-m-0 
job-310,3,10,1,15414,15471,15577,57,106,15672,true,C-m-0 
job-313,5,4,4,15549,15549,15599,0,50,15847,true,C-l-2 C-l-0 C-l-0 C-l-1 
job-312,1,6,4,15500,15500,15600,0,100,15683,true,L-s-0 L-s-0 L-m-0 C-m-0 
job-311,5,10,1,15462,15471,15604,9,133,15846,true,C-l-2 
job-314,6,11,3,15596,15596,15627,0,31,15735,true,L-l-0 C-m-1 C-m-2 
job-315,2,12,7,15641,15641,15691,0,50,15872,true,L-s-0 L-m-0 L-m-0 L-l-0 L-l-0 L-l-0 C-m-1 
job-308,2,4,5,15324,15471,15727,147,256,15613,false,L-m-0 L-l-0 C-m-1 C-m-2 L-s-0 
job-316,2,10,3,15691,15691,15847,0,156,15890,true,L-s-0 L-m-0 L-m-0 
job-317,2,4,6,15744,15744,15856,0,112,15998,true,L-s-0 L-m-0 L-m-0 L-l-0 L-l-0 L-l-0 
job-319,4,11,2,15837,15837,15894,0,57,16070,true,C-s-0 C-s-2 
job-321,4,10,7,15934,15934,15972,0,38,16069,true,L-m-0 C-s-0 C-s-2 C-s-1 C-l-2 C-l-2 C-l-2 
job-318,5,7,4,15784,15784,15998,0,214,16146,true,L-l-0 C-m-1 C-m-2 C-m-0 
job-320,4,8,3,15888,15888,16032,0,144,16286,true,L-l-0 L-s-0 L-m-0 
job-322,6,6,7,15982,15998,16078,16,80,16210,true,L-l-0 C-m-1 C-m-2 C-m-0 C-l-2 C-l-2 C-l-0 
job-323,2,11,6,16037,16037,16139,0,102,16344,true,L-l-0 L-l-0 L-l-0 C-m-1 C-m-2 C-m-0 
job-324,6,7,8,16087,16087,16182,0,95,16431,true,L-l-0 C-m-1 C-m-2 C-m-0 L-m-0 C-l-2 C-l-2 C-l-0 
job-325,6,4,5,16134,16182,16216,48,34,16365,true,L-m-0 L-l-0 L-l-0 C-m-1 C-m-2 
job-326,3,11,4,16187,16187,16266,0,79,16411,true,L-s-0 C-s-0 C-s-2 C-s-1 
job-327,3,11,7,16251,16251,16299,0,48,16578,true,L-m-0 L-m-0 L-l-0 L-l-0 L-l-0 L-l-0 C-m-1 
job-328,1,8,2,16312,16312,16327,0,15,16538,true,L-s-0 L-s-0 
job-330,1,8,6,16405,16405,16445,0,40,16531,true,L-m-0 L-l-0 L-l-0 C-s-0 C-s-0 C-s-2 
job-329,3,10,6,16356,16356,16446,0,90,16549,true,L-s-0 L-m-0 L-m-0 L-l-0 L-l-0 L-l-0 
job-331,5,7,8,16448,16448,16484,0,36,16498,true,L-m-0 L-l-0 L-l-0 C-m-1 C-m-2 C-m-0 C-l-2 C-l-2 
job-333,4,6,8,16536,16536,16567,0,31,16825,true,L-s-0 C-s-0 C-s-2 C-s-1 C-m-0 C-m-0 C-l-2 C-l-2 
job-332,6,7,5,16489,16489,16615,0,126,16621,true,L-m-0 L-l-0 L-l-0 C-m-1 C-m-2 
job-334,5,10,6,16588,16588,16643,0,55,16657,true,C-m-0 C-l-2 C-l-2 C-l-0 C-l-0 C-l-1 
job-335,2,9,4,16647,16647,16679,0,32,16789,true,L-s-0 L-m-0 L-m-0 L-m-0 
job-336,3,11,5,16700,16700,16814,0,114,17007,true,L-s-0 L-m-0 L-m-0 L-l-0 L-l-0 
job-338,4,12,1,16793,16793,16832,0,39,16995,true,C-s-2 
job-337,4,6,2,16746,16746,16889,0,143,17133,true,L-l-0 C-s-0 
job-339,4,5,6,16842,16842,16911,0,69,17102,true,L-l-0 L-l-0 L-s-0 L-m-0 L-m-0 C-s-2 
job-342,2,9,4,17001,17001,17020,0,19,17143,true,L-m-0 L-m-0 C-m-0 C-s-2 
job-341,1,12,6,16959,16959,17061,0,102,17221,true,L-l-0 L-l-0 L-l-0 C-m-0 L-s-0 L-m-0 
job-344,6,9,5,17123,17123,17134,0,11,17339,true,C-l-2 C-l-0 C-l-0 C-l-1 C-l-1 
job-345,3,5,5,17166,17166,17224,0,58,17305,true,C-l-2 C-l-2 C-l-0 C-l-0 C-l-0 
job-343,4,4,8,17063,17063,17241,0,178,17496,true,L-l-0 L-l-0 C-m-0 L-s-0 L-m-0 L-m-0 C-s-2 C-l-2 
job-347,5,7,2,17263,17263,17282,0,19,17551,true,L-l-0 C-l-2 
job-346,2,8,8,17215,17215,17343,0,128,17553,true,C-l-2 C-l-0 C-l-1 C-l-1 C-l-1 C-l-1 C-l-1 C-l-1 
job-348,6,7,5,17327,17343,17379,16,36,17593,true,L-l-0 L-m-0 C-l-1 C-l-1 C-l-2 
job-340,4,10,8,16897,16897,17394,0,497,17528,true,L-l-0 C-s-0 C-s-1 C-m-1 C-m-1 C-m-2 C-m-2 C-m-0 
job-350,3,6,2,17425,17425,17465,0,40,17634,true,L-m-0 L-m-0 
job-351,1,6,5,17471,17471,17482,0,11,17758,true,L-m-0 L-m-0 L-m-0 L-m-0 L-s-0 
job-349,2,5,1,17373,17373,17552,0,179,17729,true,L-m-0 
job-352,6,5,6,17511,17511,17605,0,94,17803,true,L-m-0 L-l-0 L-l-0 C-m-1 C-m-2 C-m-0 
job-353,4,4,4,17578,17578,17615,0,37,17797,true,L-s-0 C-s-0 C-s-1 C-s-2 
job-355,2,4,8,17684,17684,17756,0,72,17984,true,L-s-0 L-m-0 L-m-0 L-m-0 L-m-0 L-l-0 L-l-0 L-l-0 
job-357,3,6,6,17778,17778,17832,0,54,17896,true,L-s-0 L-l-0 L-l-0 L-m-0 L-m-0 C-m-1 
job-354,1,7,1,17622,17622,17849,0,227,18148,true,L-s-0 
job-356,2,10,6,17735,17735,17901,0,166,17955,true,L-l-0 L-l-0 L-l-0 C-s-0 C-s-1 C-s-2 
job-360,2,5,5,17916,17916,17948,0,32,18084,true,L-l-0 L-l-0 L-l-0 C-m-1 C-m-1 
job-361,5,8,1,17968,17968,17993,0,25,18104,true,L-l-0 
job-363,4,6,4,18078,18078,18129,0,51,18358,true,C-m-1 C-l-0 L-s-0 C-s-0 
job-362,1,5,6,18036,18036,18148,0,112,18195,true,L-l-0 L-l-0 L-l-0 L-l-0 L-l-0 L-l-0 
job-359,6,8,8,17868,17868,18235,0,367,18434,true,L-m-0 L-l-0 C-m-0 C-l-1 C-l-1 C-l-2 C-l-2 C-l-0 
job-358,2,8,8,17825,17825,18268,0,443,18383,true,L-m-0 C-m-1 C-m-1 C-m-2 C-m-2 C-m-2 C-m-2 C-m-0 
job-365,4,9,1,18170,18235,18271,65,36,18422,true,C-m-1 
job-364,6,7,5,18116,18235,18298,119,63,18351,true,L-m-0 C-m-0 L-l-0 L-l-0 C-l-1 
job-366,5,12,6,18219,18268,18358,49,90,18507,true,C-l-1 C-m-2 C-l-2 C-l-2 C-l-0 C-l-0 
job-367,6,7,6,18273,18298,18611,25,313,18759,true,C-l-1 L-m-0 L-l-0 L-l-0 C-m-0 C-m-1 
job-368,5,10,7,18314,18611,18623,297,12,18582,false,L-m-0 L-l-0 L-l-0 C-m-0 C-m-1 C-m-2 C-l-1 
job-370,3,6,3,18413,18611,18642,198,31,18569,false,C-l-1 L-s-0 C-s-0 
job-371,6,12,1,18463,18611,18665,148,54,18531,false,C-l-2 
job-374,3,7,5,18593,18623,18690,30,67,18929,true,C-m-2 C-l-1 C-l-1 L-l-0 L-l-0 
job-373,5,10,3,18557,18623,18749,66,126,18849,true,L-m-0 C-m-0 C-m-1 
job-375,1,4,2,18642,18642,18759,0,117,18917,true,L-l-0 L-l-0 
job-376,5,8,4,18683,18690,18773,7,83,18851,true,L-l-0 L-l-0 C-m-2 C-l-2 
job-369,3,7,5,18367,18611,18775,244,164,18819,true,L-m-0 C-m-0 C-m-1 C-m-2 C-l-1 
job-377,5,6,1,18741,18741,18789,0,48,18858,true,C-l-1 
job-378,1,11,8,18793,18793,18809,0,16,18955,true,C-l-2 C-l-2 C-l-2 L-s-0 L-m-0 L-m-0 L-l-0 L-l-0 
job-372,4,5,3,18515,18611,18931,96,320,19113,true,C-l-2 C-s-1 C-s-2 
job-382,3,11,1,18980,18980,18994,0,14,19102,true,C-m-2 
job-379,4,12,5,18839,18839,19053,0,214,19305,true,C-l-2 C-l-2 L-s-0 L-m-0 L-m-0 
job-380,5,8,6,18886,18886,19058,0,172,19130,true,L-l-0 L-l-0 C-m-0 C-m-1 C-m-2 C-l-1 
job-381,2,9,3,18931,18931,19082,0,151,19309,true,L-l-0 C-m-0 C-m-1 
job-383,2,4,7,19032,19032,19111,0,79,19249,true,C-m-2 C-l-2 C-l-2 C-l-1 C-l-1 C-l-1 C-s-1 
job-384,2,5,3,19088,19088,19143,0,55,19387,true,C-s-1 C-m-2 C-m-2 
job-386,1,12,6,19198,19198,19266,0,68,19299,true,C-m-2 C-m-2 L-s-0 L-m-0 L-m-0 L-l-0 
job-387,5,12,7,19254,19254,19345,0,91,19579,true,L-l-0 L-l-0 C-m-0 C-m-1 C-l-1 C-l-1 C-l-2 
job-388,2,6,3,19310,19310,19374,0,64,19435,true,L-l-0 C-m-0 C-m-1 
job-390,2,11,7,19433,19433,19466,0,33,19758,true,L-l-0 C-m-0 C-m-2 L-s-0 L-m-0 L-m-0 C-s-1 
job-389,3,9,6,19366,19366,19489,0,123,19574,true,L-l-0 L-l-0 L-l-0 C-m-2 C-m-0 C-m-0 
job-385,3,8,1,19136,19136,19527,0,391,19773,true,C-m-2 
job-391,5,5,6,19493,19493,19550,0,57,19738,true,C-m-2 L-m-0 L-l-0 L-l-0 C-m-0 C-m-1 
job-392,2,9,4,19544,19544,19626,0,82,19822,true,L-m-0 L-l-0 C-m-2 C-m-0 
job-394,4,7,5,19637,19637,19671,0,34,19758,true,L-m-0 L-l-0 L-l-0 L-s-0 C-s-1 
job-393,1,12,2,19593,19593,19687,0,94,19901,true,L-m-0 L-l-0 
job-396,4,12,8,19752,19752,19827,0,75,19852,true,L-m-0 L-m-0 L-l-0 L-l-0 L-l-0 C-s-1 C-s-2 C-s-0 
job-395,4,10,1,19698,19698,19860,0,162,19878,true,L-s-0 
job-398,5,8,6,19858,19858,19882,0,24,19994,true,C-m-2 L-m-0 L-l-0 L-l-0 C-m-0 C-m-1 
job-397,1,4,2,19818,19818,19940,0,122,20201,true,C-m-2 C-m-2 
job-401,3,12,2,20036,20036,20061,0,25,20236,true,C-m-2 L-s-0 
job-399,5,10,1,19908,19908,20096,0,188,20378,true,C-m-2 
job-400,6,4,3,19970,19970,20116,0,146,20309,true,L-m-0 L-l-0 L-l-0 
job-403,1,5,1,20139,20139,20182,0,43,20461,true,C-m-2 
job-402,5,10,3,20101,20101,20194,0,93,20269,true,C-m-2 C-m-0 C-m-1 
job-406,3,11,7,20306,20306,20344,0,38,20493,true,L-l-0 C-s-1 C-s-2 C-s-0 C-m-2 C-m-2 C-m-0 
job-405,2,9,5,20260,20260,20395,0,135,20530,true,L-m-0 L-l-0 L-l-0 L-l-0 L-l-0 
job-408,5,5,5,20401,20401,20420,0,19,20608,true,L-l-0 C-m-2 C-m-0 C-m-1 C-l-1 
job-407,4,10,3,20347,20347,20462,0,115,20581,true,L-l-0 C-s-1 C-s-2 
job-410,2,7,5,20487,20487,20500,0,13,20661,true,L-s-0 L-l-0 L-l-0 L-l-0 C-m-2 
job-404,2,9,3,20194,20194,20581,0,387,20729,true,L-s-0 L-m-0 L-m-0 
job-409,3,5,8,20442,20442,20634,0,192,20801,true,L-m-0 L-l-0 L-l-0 C-s-0 C-m-2 C-m-2 C-m-0 C-m-0 
job-412,5,8,5,20592,20634,20645,42,11,20667,true,L-l-0 C-l-2 L-m-0 C-m-2 C-m-0 
job-411,5,8,5,20544,20544,20722,0,178,20730,true,L-l-0 C-m-1 C-l-1 C-l-1 C-l-2 
job-413,3,6,4,20648,20648,20764,0,116,20815,true,L-l-0 L-l-0 C-m-1 C-l-2 
job-414,4,6,5,20692,20692,20803,0,111,20821,true,C-l-2 L-s-0 L-m-0 L-m-0 C-s-0 
job-416,5,6,8,20775,20775,20841,0,66,20934,true,L-l-0 C-l-2 C-m-1 C-m-2 C-m-0 C-l-1 C-l-1 C-l-0 
job-415,3,4,1,20731,20731,20921,0,190,20983,true,L-l-0 
job-417,1,11,6,20835,20835,20931,0,96,20959,true,L-l-0 L-l-0 L-l-0 C-m-1 C-m-1 C-m-2 
job-418,3,7,8,20890,20890,20994,0,104,21164,true,L-l-0 C-m-1 C-m-2 C-m-2 L-s-0 L-m-0 L-m-0 C-s-0 
job-420,5,12,4,20982,20982,21002,0,20,21028,true,L-l-0 C-m-1 C-m-0 C-l-1 
job-421,1,10,1,21018,21018,21029,0,11,21086,true,L-m-0 
job-419,2,9,1,20942,20942,21092,0,150,21107,true,L-m-0 
job-422,1,8,4,21069,21069,21218,0,149,21361,true,L-m-0 L-m-0 L-s-0 L-s-0 
job-424,2,11,3,21178,21178,21228,0,50,21366,true,C-s-0 C-s-1 C-s-2 
job-423,3,9,5,21123,21123,21264,0,141,21413,true,L-m-0 L-l-0 L-l-0 L-l-0 L-l-0 
job-425,6,7,4,21227,21227,21331,0,104,21595,true,C-m-2 C-m-1 C-m-0 C-l-1 
job-427,2,9,8,21340,21340,21406,0,66,21676,true,L-m-0 C-l-1 C-l-1 C-l-1 L-s-0 C-s-0 C-s-1 C-s-2 
job-426,6,10,6,21286,21286,21416,0,130,21709,true,C-l-1 L-m-0 L-l-0 L-l-0 C-l-2 C-l-2 
job-430,6,4,5,21484,21484,21511,0,27,21676,true,L-m-0 L-l-0 L-l-0 C-l-1 C-l-1 
job-428,5,9,4,21391,21391,21568,0,177,21756,true,C-m-2 C-m-1 C-m-0 C-l-0 
job-431,6,7,2,21527,21527,21597,0,70,21795,true,L-m-0 L-l-0 
job-432,3,8,7,21576,21576,21659,0,83,21908,true,L-l-0 L-l-0 C-m-2 C-m-2 C-m-1 C-m-1 C-m-0 
job-433,6,12,6,21629,21629,21659,0,30,21899,true,L-l-0 C-l-0 L-m-0 C-l-1 C-l-1 C-l-2 
job-429,2,8,8,21434,21434,21689,0,255,21877,true,C-m-2 C-m-1 C-m-0 C-l-0 C-l-0 C-l-0 L-s-0 L-s-0 
job-435,3,8,3,21727,21727,21751,0,24,21773,true,C-m-0 L-s-0 L-m-0 
job-434,2,8,8,21673,21673,21820,0,147,21839,true,C-m-2 C-m-2 C-m-2 C-m-1 C-m-1 C-m-1 C-m-0 C-m-0 
job-437,1,6,6,21849,21849,21965,0,116,21979,true,L-s-0 L-m-0 L-m-0 C-m-0 C-m-0 C-m-0 
job-439,5,5,5,21935,21935,21965,0,30,22063,true,C-m-2 C-m-1 C-l-0 C-l-0 C-l-1 
job-438,3,11,3,21889,21889,21977,0,88,22164,true,L-l-0 L-l-0 L-l-0 
job-442,2,5,1,22089,22089,22182,0,93,22381,true,L-m-0 
job-436,3,8,4,21789,21789,22255,0,466,22508,true,C-m-0 L-s-0 L-m-0 L-m-0 
job-443,3,5,7,22133,22133,22260,0,127,22444,true,C-m-0 C-s-0 C-s-1 C-s-2 C-l-2 C-l-2 C-l-2 
job-444,3,4,7,22186,22260,22311,74,51,22323,true,L-s-0 L-m-0 L-m-0 C-s-0 C-s-1 C-s-2 C-m-0 
job-440,6,4,7,21989,21989,22323,0,334,22333,true,L-l-0 L-l-0 C-m-2 C-m-1 C-l-0 C-l-0 C-l-1 
job-445,1,4,3,22251,22260,22363,9,103,22387,true,L-s-0 L-m-0 L-m-0 
job-441,6,10,1,22039,22039,22373,0,334,22429,true,C-l-1 
job-446,4,12,1,22279,22279,22378,0,99,22524,true,C-m-0 
job-447,6,4,5,22332,22332,22392,0,60,22593,true,L-m-0 C-l-1 L-l-0 L-l-0 C-m-2 
job-448,3,4,8,22386,22386,22442,0,56,22642,true,C-l-1 C-l-1 L-s-0 C-s-0 C-s-1 C-s-2 C-m-0 C-m-0 
job-449,1,10,6,22441,22441,22460,0,19,22564,true,L-s-0 C-s-0 C-s-1 C-s-2 C-m-0 C-m-0 
job-450,4,11,7,22486,22486,22501,0,15,22574,true,L-s-0 L-m-0 L-m-0 L-l-0 L-l-0 L-l-0 C-s-0 
job-451,6,6,1,22539,22539,22654,0,115,22852,true,L-m-0 
job-453,6,4,7,22641,22641,22683,0,42,22726,true,L-l-0 L-l-0 C-m-0 C-m-2 C-m-1 C-l-1 C-l-1 
job-454,4,10,2,22679,22679,22705,0,26,23002,true,L-m-0 C-s-0 
job-452,2,12,2,22591,22591,22727,0,136,22921,true,L-m-0 L-s-0 
job-456,1,9,7,22786,22786,22810,0,24,23069,true,L-s-0 L-m-0 L-m-0 C-s-0 C-s-1 C-s-2 C-m-0 
job-455,3,6,8,22737,22737,22826,0,89,23101,true,L-s-0 L-m-0 L-m-0 L-l-0 L-l-0 L-l-0 L-l-0 C-s-0 
job-457,5,12,8,22831,22831,22863,0,32,22915,true,L-m-0 L-l-0 L-l-0 C-m-0 C-m-2 C-m-1 C-l-1 C-l-1 
job-458,4,11,3,22891,22891,22916,0,25,23002,true,L-s-0 L-m-0 L-m-0 
job-459,5,11,3,22955,22955,22971,0,16,23260,true,L-m-0 L-l-0 L-l-0 
job-461,2,9,4,23051,23051,23103,0,52,23385,true,L-m-0 L-m-0 L-m-0 L-l-0 
job-460,2,8,1,23001,23001,23171,0,170,23452,true,L-s-0 
job-462,6,8,2,23116,23116,23208,0,92,23437,true,L-m-0 L-l-0 
job-463,3,8,2,23178,23178,23232,0,54,23312,true,L-l-0 L-l-0 
job-464,3,11,2,23229,23229,23266,0,37,23310,true,L-l-0 L-l-0 
job-466,5,10,2,23355,23355,23366,0,11,23503,true,C-m-2 C-m-1 
job-465,5,6,4,23282,23282,23460,0,178,23596,true,L-m-0 L-l-0 L-l-0 C-m-0 
job-469,6,12,1,23496,23496,23508,0,12,23692,true,L-l-0 
job-467,3,6,6,23392,23392,23568,0,176,23833,true,L-m-0 C-m-0 L-s-0 C-s-0 C-s-1 C-s-2 
job-471,1,11,7,23591,23591,23624,0,33,23624,false,L-l-0 L-l-0 C-m-1 C-m-1 L-s-0 L-m-0 L-m-0 
job-468,2,7,6,23446,23446,23626,0,180,23834,true,L-l-0 C-m-2 C-m-2 C-m-2 C-m-2 C-m-1 
job-470,6,9,1,23550,23550,23712,0,162,23813,true,L-l-0 
job-473,4,12,7,23693,23693,23769,0,76,23849,true,C-m-2 C-m-2 C-m-1 C-m-1 C-m-0 C-m-0 C-l-1 
job-472,3,10,8,23640,23640,23797,0,157,23891,true,L-l-0 L-l-0 L-s-0 L-m-0 L-m-0 C-s-0 C-s-1 C-s-2 
job-474,4,11,6,23747,23747,23869,0,122,24143,true,L-l-0 C-l-1 C-l-1 C-l-0 C-l-0 C-l-0 
job-475,5,7,6,23791,23797,23933,6,136,23960,true,L-l-0 L-m-0 C-m-2 C-m-1 C-m-0 C-l-2 
job-477,5,10,6,23891,23933,24006,42,73,24143,true,L-l-0 C-l-2 L-m-0 C-m-2 C-m-1 C-m-0 
job-478,1,8,4,23947,23947,24110,0,163,24403,true,L-m-0 L-m-0 L-l-0 L-l-0 
job-476,5,8,4,23833,23869,24170,36,301,24261,true,L-l-0 C-l-2 C-l-0 C-l-0 
job-482,5,9,2,24143,24143,24183,0,40,24293,true,C-m-1 C-m-0 
job-481,2,4,5,24096,24096,24185,0,89,24416,true,L-s-0 L-m-0 L-l-0 L-l-0 C-m-2 
job-479,2,7,6,23989,23989,24196,0,207,24339,true,C-m-2 C-m-1 C-m-0 C-l-2 C-l-0 L-s-0 
job-484,2,11,2,24247,24247,24302,0,55,24574,true,L-m-0 C-s-1 
job-483,3,9,7,24204,24204,24355,0,151,24554,true,L-m-0 L-s-0 L-l-0 L-l-0 L-l-0 L-l-0 C-s-0 
job-486,5,9,5,24354,24354,24399,0,45,24653,true,C-m-0 C-l-0 C-l-0 C-l-2 C-l-2 
job-487,4,8,3,24407,24407,24425,0,18,24677,true,L-m-0 C-m-0 L-s-0 
job-488,6,4,5,24449,24449,24528,0,79,24530,true,L-l-0 L-l-0 C-l-0 C-l-0 C-l-2 
job-489,3,4,1,24504,24504,24531,0,27,24794,true,L-m-0 
job-490,6,4,8,24563,24563,24594,0,31,24631,true,L-l-0 L-l-0 C-l-0 C-l-0 C-l-2 C-l-2 C-l-1 C-l-1 
job-485,3,6,6,24295,24295,24619,0,324,24723,true,C-s-2 C-m-2 C-m-2 C-m-1 C-m-1 C-m-0 
job-491,3,8,4,24618,24618,24667,0,49,24745,true,L-m-0 C-m-0 L-s-0 L-l-0 
job-492,6,7,3,24666,24666,24732,0,66,24770,true,L-l-0 C-m-2 C-m-1 
job-493,2,5,7,24715,24715,24807,0,92,24830,true,L-m-0 L-m-0 L-l-0 L-l-0 L-l-0 C-m-2 C-m-1 
job-480,3,8,1,24049,24049,24847,0,798,24988,true,L-m-0 
job-495,1,5,7,24820,24820,24893,0,73,25018,true,L-m-0 L-m-0 L-m-0 L-m-0 L-l-0 L-l-0 L-l-0 
job-494,6,9,4,24772,24772,24921,0,149,25100,true,L-l-0 C-m-2 C-m-1 C-m-0 
job-497,6,7,1,24929,24929,24959,0,30,25017,true,L-l-0 
job-496,4,10,4,24877,24877,25009,0,132,25234,true,L-m-0 L-s-0 C-s-2 C-s-0 
job-498,1,5,4,24974,24974,25031,0,57,25141,true,L-m-0 L-m-0 L-m-0 L-m-0 
job-500,4,5,1,25077,25077,25109,0,32,25303,true,L-s-0 
job-499,5,11,2,25026,25026,25194,0,168,25355,true,L-l-0 L-l-0 
job-501,3,11,4,25133,25133,25269,0,136,25421,true,L-s-0 L-m-0 L-m-0 C-s-2 
job-502,5,7,4,25183,25183,25318,0,135,25486,true,C-m-2 C-m-1 C-m-0 C-l-0 
job-504,2,7,6,25278,25278,25363,0,85,25407,true,L-l-0 L-l-0 L-l-0 L-l-0 C-m-2 C-m-1 
job-506,1,4,4,25377,25377,25408,0,31,25697,true,L-l-0 L-l-0 L-l-0 L-l-0 
job-503,4,4,2,25226,25226,25428,0,202,25441,true,C-l-0 L-l-0 
job-508,4,4,7,25503,25503,25559,0,56,25757,true,C-l-0 L-s-0 L-m-0 L-m-0 L-l-0 L-l-0 L-l-0 
job-507,2,5,3,25436,25436,25599,0,163,25817,true,C-m-2 C-m-1 C-l-0 
job-509,1,10,2,25557,25557,25611,0,54,25761,true,C-m-2 C-m-1 
job-510,4,4,4,25611,25611,25645,0,34,25891,true,C-l-0 L-s-0 L-m-0 L-m-0 
job-511,2,12,1,25656,25656,25692,0,36,25907,true,C-m-2 
job-512,3,12,7,25701,25701,25846,0,145,25848,true,C-m-2 C-m-1 C-l-0 C-l-0 L-s-0 L-m-0 L-m-0 
job-514,5,6,2,25797,25846,25876,49,30,26066,true,C-l-0 L-m-0 
job-513,5,8,7,25757,25757,25889,0,132,25926,true,L-l-0 L-l-0 C-m-0 C-l-2 C-l-2 C-l-1 C-l-1 
job-516,6,8,1,25881,25881,25941,0,60,25942,true,C-l-0 
job-515,1,5,4,25840,25846,25948,6,102,26201,true,L-m-0 L-m-0 L-m-0 L-l-0 
job-505,5,10,3,25327,25327,25961,0,634,26110,true,C-m-2 C-m-1 C-l-0 
job-517,2,4,7,25927,25927,26003,0,76,26206,true,L-m-0 L-m-0 L-l-0 L-l-0 L-l-0 L-l-0 L-l-0 
job-519,4,5,8,26027,26027,26061,0,34,26305,true,L-s-0 L-m-0 L-m-0 L-l-0 L-l-0 L-l-0 C-s-2 C-s-0 
job-518,6,11,3,25977,25977,26068,0,91,26076,true,C-m-2 C-m-1 C-m-0 
job-521,1,5,7,26123,26123,26160,0,37,26428,true,C-s-2 C-s-2 C-s-2 C-s-0 C-s-0 C-s-0 C-s-1 
job-522,3,6,3,26170,26170,26208,0,38,26455,true,C-s-2 C-s-0 C-s-1 
job-520,4,10,6,26070,26070,26240,0,170,26384,true,L-s-0 L-m-0 L-m-0 L-l-0 L-l-0 L-l-0 
job-523,5,4,2,26215,26215,26307,0,92,26360,true,C-m-2 C-m-1 
job-524,2,12,4,26253,26253,26320,0,67,26500,true,C-m-2 C-m-1 L-s-0 L-m-0 
job-525,1,4,3,26310,26310,26403,0,93,26473,true,L-s-0 L-m-0 L-m-0 
job-526,2,7,5,26352,26352,26427,0,75,26526,true,L-s-0 L-m-0 L-m-0 L-m-0 L-l-0 
job-527,6,4,8,26404,26404,26546,0,142,26706,true,L-l-0 C-m-2 C-m-1 C-m-0 C-l-0 C-l-0 C-l-2 C-l-2 
job-529,3,7,2,26500,26500,26605,0,105,26608,true,L-m-0 L-m-0 
job-531,1,10,2,26596,26596,26615,0,19,26907,true,C-m-1 C-m-1 
job-532,6,11,8,26644,26644,26671,0,27,26757,true,L-m-0 C-m-1 C-m-0 C-l-0 C-l-0 C-l-2 C-l-2 C-l-1 
job-528,2,12,8,26452,26452,26696,0,244,26900,true,L-l-0 L-l-0 L-l-0 C-m-2 C-m-1 C-m-0 L-s-0 L-m-0 
job-530,3,6,4,26546,26546,26794,0,248,27027,true,L-l-0 L-l-0 C-m-2 C-m-2 
job-535,4,6,7,26788,26788,26818,0,30,26825,true,L-s-0 C-s-2 C-s-0 C-s-1 C-l-2 C-l-2 C-l-2 
job-534,2,9,4,26753,26753,26866,0,113,27012,true,L-m-0 C-m-2 C-m-1 C-m-0 
job-533,5,12,6,26698,26698,26919,0,221,27065,true,L-l-0 L-m-0 C-m-1 C-m-0 C-l-0 C-l-0 
job-536,4,7,4,26841,26841,26924,0,83,27085,true,L-l-0 C-m-2 L-s-0 C-s-2 
job-537,6,6,3,26893,26893,27018,0,125,27300,true,C-l-2 C-l-2 C-l-1 
job-538,2,9,6,26942,26942,27068,0,126,27218,true,C-l-1 C-l-1 C-l-1 L-s-0 L-m-0 L-m-0 
job-540,2,10,6,27041,27041,27118,0,77,27330,true,C-l-1 C-l-1 L-l-0 L-l-0 L-l-0 L-l-0 
job-539,3,4,1,26994,26994,27138,0,144,27434,true,L-m-0 
job-542,6,4,2,27158,27158,27235,0,77,27417,true,C-l-1 C-l-0 
job-543,5,6,1,27210,27210,27241,0,31,27463,true,L-m-0 
job-544,4,5,1,27264,27264,27293,0,29,27517,true,C-l-1 
job-541,6,12,7,27104,27104,27339,0,235,27460,true,C-l-1 C-m-1 C-m-0 C-m-2 C-l-2 C-l-2 C-l-0 
job-547,3,12,8,27414,27414,27424,0,10,27717,true,C-l-1 C-l-1 C-l-1 C-l-1 C-l-0 C-l-0 C-l-0 C-l-0 
job-545,6,11,8,27315,27339,27464,24,125,27661,true,L-m-0 L-l-0 L-l-0 C-m-1 C-m-0 C-m-2 C-l-2 C-l-2 
job-550,4,8,5,27572,27572,27614,0,42,27740,true,C-m-0 C-m-0 C-m-2 C-m-2 C-l-2 
job-546,3,11,4,27362,27362,27615,0,253,27676,true,L-s-0 C-s-2 C-s-0 C-s-1 
job-548,2,5,6,27466,27466,27621,0,155,27642,true,L-m-0 L-m-0 L-m-0 L-m-0 L-l-0 L-l-0 
job-551,6,12,7,27625,27625,27718,0,93,27972,true,L-l-0 L-m-0 C-m-0 C-m-2 C-l-2 C-l-2 C-l-1 
job-554,6,10,7,27749,27749,27764,0,15,27815,true,L-m-0 L-l-0 C-m-0 C-m-2 C-l-1 C-l-2 C-l-2 
job-552,6,8,2,27669,27669,27807,0,138,27815,true,C-l-1 C-l-0 
job-549,3,8,4,27518,27518,27818,0,300,28015,true,L-l-0 L-l-0 C-m-1 C-m-1 
job-557,4,6,8,27878,27878,27895,0,17,27966,true,C-l-0 L-s-0 L-l-0 L-l-0 L-l-0 C-s-2 C-s-0 C-s-1 
job-555,3,8,1,27795,27795,27896,0,101,28119,true,L-m-0 
job-553,2,12,5,27708,27708,27899,0,191,27918,true,L-m-0 C-m-1 C-m-0 C-m-2 C-l-0 
job-556,3,6,8,27838,27838,27907,0,69,27992,true,L-m-0 C-m-1 C-m-1 C-m-0 C-m-0 C-m-2 C-m-2 C-l-0 
job-558,1,5,3,27931,27931,27975,0,44,28185,true,L-s-0 L-s-0 L-s-0 
job-561,3,10,6,28074,28074,28122,0,48,28384,true,C-m-1 C-m-1 C-m-0 C-m-0 C-m-2 C-m-2 
job-560,2,12,6,28030,28030,28161,0,131,28283,true,L-l-0 L-l-0 L-l-0 C-s-2 C-s-0 C-s-1 
job-564,3,6,3,28218,28218,28239,0,21,28408,true,L-l-0 C-m-1 C-m-0 
job-563,4,12,5,28165,28165,28240,0,75,28398,true,L-l-0 L-l-0 C-l-2 C-s-2 C-s-0 
job-559,1,8,7,27982,27982,28261,0,279,28507,true,L-s-0 L-s-0 L-m-0 L-m-0 L-m-0 L-m-0 L-l-0 
job-565,3,12,3,28253,28253,28284,0,31,28447,true,L-l-0 L-l-0 L-l-0 
job-567,4,5,5,28351,28351,28398,0,47,28631,true,C-l-2 L-s-0 L-m-0 L-m-0 L-l-0 
job-569,1,4,2,28450,28450,28513,0,63,28666,true,C-m-1 C-m-1 
job-562,5,11,8,28132,28132,28526,0,394,28765,true,C-m-1 C-m-0 C-m-2 C-l-0 C-l-0 C-l-1 C-l-1 C-l-2 
job-568,4,4,7,28399,28399,28530,0,131,28727,true,C-l-2 L-s-0 L-m-0 L-m-0 L-l-0 L-l-0 L-l-0 
job-570,4,4,3,28487,28487,28533,0,46,28534,true,C-s-2 C-s-0 C-s-1 
job-572,6,6,5,28576,28576,28649,0,73,28793,true,C-l-1 L-m-0 L-l-0 L-l-0 C-l-2 
job-571,5,9,6,28534,28534,28697,0,163,28979,true,C-m-1 C-m-0 C-m-2 C-l-0 C-l-0 C-l-1 
job-566,1,12,6,28306,28306,28737,0,431,28936,true,C-m-1 C-m-0 C-m-2 C-l-0 C-l-0 C-l-1 
job-573,4,7,2,28625,28625,28742,0,117,28859,true,C-l-2 L-s-0 
job-574,6,12,4,28681,28681,28746,0,65,28998,true,C-l-1 C-l-2 L-m-0 L-l-0 
job-576,2,10,4,28767,28767,28796,0,29,28889,true,L-m-0 L-m-0 L-l-0 C-m-1 
job-577,4,12,4,28827,28827,28843,0,16,29090,true,L-m-0 L-l-0 C-m-1 C-m-0 
job-575,2,12,8,28725,28725,28844,0,119,29095,true,L-m-0 L-l-0 L-l-0 L-l-0 C-m-1 C-m-0 C-m-2 C-l-2 
job-578,4,8,3,28866,28866,28918,0,52,29124,true,L-s-0 L-m-0 L-m-0 
job-579,3,4,4,28919,28919,28941,0,22,29135,true,L-s-0 L-m-0 L-m-0 L-l-0 
job-580,3,8,2,28966,28966,29100,0,134,29139,true,L-s-0 L-m-0 
job-582,4,5,7,29072,29072,29106,0,34,29116,true,L-l-0 L-l-0 C-s-2 C-s-0 C-s-1 C-m-1 C-m-1 
job-584,6,12,2,29170,29170,29189,0,19,29272,true,C-l-1 C-l-1 
job-583,6,4,6,29118,29118,29226,0,108,29381,true,L-l-0 C-m-1 C-m-0 C-m-2 C-l-2 C-l-2 
job-581,1,8,7,29017,29017,29236,0,219,29369,true,L-s-0 L-m-0 L-m-0 L-m-0 L-l-0 L-l-0 L-l-0 
job-586,2,11,7,29264,29264,29309,0,45,29370,true,L-s-0 L-m-0 L-m-0 L-l-0 L-l-0 L-l-0 L-l-0 
job-588,6,5,7,29360,29360,29414,0,54,29523,true,L-m-0 L-l-0 L-l-0 C-m-1 C-m-0 C-m-2 C-l-2 
job-589,4,8,8,29418,29418,29429,0,11,29724,true,L-m-0 L-l-0 L-l-0 L-l-0 C-m-1 C-m-1 C-m-0 C-m-0 
job-585,1,4,1,29211,29211,29482,0,271,29780,true,L-s-0 
job-590,5,4,7,29465,29465,29553,0,88,29841,true,L-m-0 L-l-0 L-l-0 C-m-1 C-m-0 C-m-2 C-l-2 
job-591,4,12,8,29513,29513,29558,0,45,29725,true,C-l-2 L-s-0 C-l-1 C-l-1 C-l-1 C-l-0 C-l-0 C-l-0 
job-592,5,11,8,29559,29559,29579,0,20,29689,true,L-m-0 L-l-0 L-l-0 C-m-1 C-m-0 C-m-2 C-l-2 C-l-2 
job-587,2,7,7,29308,29308,29625,0,317,29865,true,L-m-0 C-s-2 C-s-2 C-s-0 C-s-0 C-s-1 C-s-1 
job-593,5,7,7,29607,29607,29694,0,87,29906,true,L-m-0 L-l-0 L-l-0 C-m-1 C-m-0 C-m-2 C-l-2 
job-594,2,6,8,29663,29663,29736,0,73,29951,true,L-m-0 L-l-0 C-m-1 C-m-0 C-m-2 C-l-2 C-l-2 C-l-2 
job-595,2,6,8,29701,29701,29766,0,65,29848,true,L-m-0 L-m-0 L-m-0 L-l-0 L-l-0 L-l-0 L-l-0 L-l-0 
job-599,3,6,3,29908,29908,29933,0,25,30098,true,L-l-0 C-m-0 C-m-2 
job-597,4,9,4,29799,29799,29958,0,159,30173,true,L-m-0 L-m-0 L-l-0 L-l-0 
job-596,3,8,6,29752,29752,30021,0,269,30183,true,L-s-0 C-s-2 C-s-0 C-s-1 C-m-1 C-m-1 
job-598,5,4,1,29854,29854,30026,0,172,30084,true,C-m-0 
job-601,2,7,4,30015,30015,30044,0,29,30226,true,L-m-0 L-m-0 L-m-0 L-m-0 
job-600,1,7,8,29966,29966,30082,0,116,30317,true,L-s-0 C-s-2 C-s-0 C-s-1 C-m-1 C-m-1 C-m-0 C-m-0 
job-602,6,4,3,30070,30070,30083,0,13,30262,true,C-m-1 C-m-0 L-m-0 
job-603,2,9,3,30119,30119,30195,0,76,30312,true,L-s-0 L-m-0 L-m-0 
job-604,4,8,4,30162,30162,30221,0,59,30276,true,L-m-0 L-l-0 L-l-0 L-l-0 
job-605,2,8,8,30220,30220,30253,0,33,30265,true,L-m-0 L-m-0 L-s-0 L-s-0 C-s-2 C-s-2 C-s-0 C-s-0 
job-606,5,12,3,30261,30261,30312,0,51,30513,true,L-m-0 L-l-0 L-l-0 
job-607,6,11,2,30318,30318,30408,0,90,30562,true,L-m-0 L-l-0 
job-609,1,4,7,30447,30447,30518,0,71,30714,true,L-l-0 L-l-0 L-l-0 L-l-0 L-l-0 L-l-0 C-m-1 
job-610,6,11,8,30490,30490,30524,0,34,30666,true,L-m-0 C-m-2 C-l-2 C-l-2 C-l-1 C-l-1 C-l-0 C-l-0 
job-611,1,10,5,30536,30536,30556,0,20,30714,true,L-l-0 L-l-0 L-l-0 L-l-0 C-m-1 
job-612,3,7,5,30587,30587,30613,0,26,30624,true,L-l-0 L-l-0 L-s-0 L-m-0 L-m-0 
job-608,6,7,3,30383,30383,30652,0,269,30805,true,L-l-0 C-m-1 C-m-0 
job-613,6,5,1,30635,30635,30702,0,67,30746,true,L-l-0 
job-614,5,11,3,30696,30696,30790,0,94,30854,true,L-l-0 L-m-0 C-m-1 
job-616,6,12,6,30799,30799,30842,0,43,31042,true,L-m-0 L-l-0 C-m-1 C-m-0 C-m-2 C-l-2 
job-615,1,9,3,30748,30748,30880,0,132,30970,true,L-m-0 L-m-0 L-l-0 
job-617,1,6,5,30857,30857,30994,0,137,31148,true,L-m-0 L-m-0 L-l-0 L-l-0 L-l-0 
job-618,5,10,8,30911,30911,31070,0,159,31185,true,L-m-0 L-l-0 C-m-1 C-m-0 C-m-2 C-l-2 C-l-2 C-l-1 
job-620,2,4,5,31000,31000,31082,0,82,31333,true,L-m-0 L-l-0 L-l-0 L-l-0 C-m-1 
job-619,6,4,2,30955,30955,31088,0,133,31387,true,C-l-1 C-l-0 
job-623,4,9,1,31149,31149,31174,0,25,31295,true,L-l-0 
job-621,2,7,3,31053,31053,31191,0,138,31424,true,C-m-0 C-m-2 C-l-2 
job-622,5,11,6,31104,31104,31280,0,176,31408,true,C-m-0 C-m-2 C-l-2 C-l-2 L-m-0 L-l-0 
job-624,4,5,8,31208,31208,31365,0,157,31390,true,L-l-0 L-s-0 C-s-2 C-s-0 C-s-1 C-m-1 C-m-1 C-l-1 
job-625,4,6,3,31265,31265,31430,0,165,31542,true,C-l-1 C-l-1 C-l-0 
job-626,2,9,4,31312,31312,31453,0,141,31635,true,L-l-0 L-l-0 L-l-0 L-l-0 
job-628,2,11,2,31414,31414,31517,0,103,31647,true,L-m-0 L-l-0 
job-629,6,12,8,31471,31471,31595,0,124,31808,true,L-l-0 C-l-0 C-m-1 C-m-2 C-l-1 C-l-1 C-l-2 C-l-2 
job-630,6,8,6,31516,31595,31612,79,17,31633,true,C-l-0 L-l-0 L-l-0 C-m-1 C-m-2 C-l-1 
job-634,1,12,2,31700,31700,31729,0,29,31825,true,L-m-0 L-m-0 
job-627,3,4,5,31356,31356,31731,0,375,31876,true,C-l-0 C-l-0 L-m-0 L-m-0 C-m-0 
job-633,4,6,6,31655,31655,31770,0,115,31856,true,L-s-0 C-s-2 C-s-0 C-s-1 C-m-2 C-m-2 
job-636,3,6,4,31796,31796,31812,0,16,31828,true,C-m-0 C-m-1 C-l-0 C-l-2 
job-631,6,7,1,31563,31595,31815,32,220,31974,true,C-l-1 
job-635,4,9,4,31748,31748,31867,0,119,32159,true,C-l-0 L-m-0 L-m-0 C-l-2 
job-637,4,8,8,31851,31851,31883,0,32,31913,true,C-l-1 C-l-2 C-l-2 L-s-0 C-s-2 C-s-0 C-s-1 C-m-2 
job-632,5,11,6,31610,31612,31909,2,297,32111,true,C-m-0 C-l-0 C-l-1 L-l-0 L-l-0 C-m-1 
job-638,6,5,6,31912,31912,31999,0,87,32023,true,L-m-0 L-l-0 L-l-0 C-m-0 C-m-1 C-m-2 
job-639,2,5,6,31962,31962,32026,0,64,32134,true,L-m-0 C-m-0 C-m-1 C-m-2 L-s-0 L-s-0 
job-640,5,6,1,32020,32020,32102,0,82,32373,true,L-m-0 
job-641,2,7,1,32078,32078,32135,0,57,32431,true,L-m-0 
job-642,1,11,2,32135,32135,32183,0,48,32283,true,L-s-0 L-m-0 
job-643,4,12,8,32195,32195,32220,0,25,32472,true,L-s-0 L-m-0 L-m-0 L-l-0 L-l-0 L-l-0 C-s-2 C-s-0 
job-644,1,12,7,32236,32236,32248,0,12,32254,true,L-s-0 L-m-0 L-m-0 L-l-0 L-l-0 L-l-0 L-l-0 
job-646,3,7,6,32338,32338,32390,0,52,32419,true,L-s-0 C-s-2 C-s-0 C-s-1 C-m-1 C-m-1 
job-650,6,8,3,32538,32538,32550,0,12,32660,true,C-l-0 C-l-0 C-l-1 
job-649,3,9,2,32484,32484,32563,0,79,32620,true,C-m-1 C-m-1 
job-651,4,9,8,32580,32580,32593,0,13,32717,true,C-m-1 L-s-0 C-s-2 C-s-0 C-s-1 C-l-0 C-l-0 C-l-0 
job-647,2,4,5,32388,32388,32630,0,242,32754,true,L-m-0 C-m-1 C-m-0 C-m-2 C-m-2 
job-648,3,6,1,32442,32442,32675,0,233,32819,true,C-m-2 
job-652,2,12,5,32645,32645,32752,0,107,32784,true,L-m-0 C-m-0 C-m-2 C-m-2 L-s-0 
job-653,1,7,7,32696,32696,32785,0,89,32979,true,C-m-2 C-s-2 C-s-2 C-s-0 C-s-0 C-s-1 C-s-1 
job-655,1,5,7,32809,32809,32834,0,25,33065,true,C-m-2 C-m-2 C-m-2 C-m-2 C-m-2 L-s-0 L-s-0 
job-645,6,6,4,32283,32283,32843,0,560,32984,true,L-m-0 L-l-0 L-l-0 C-m-0 
job-656,3,6,7,32855,32855,32960,0,105,33119,true,L-m-0 L-m-0 C-m-0 C-m-0 C-m-2 C-m-2 L-s-0 
job-654,1,4,5,32754,32754,32972,0,218,33150,true,L-m-0 L-m-0 C-m-0 C-m-0 C-m-2 
job-658,2,10,5,32968,32968,33027,0,59,33178,true,L-m-0 L-m-0 L-l-0 C-m-0 C-m-0 
job-659,4,8,4,33027,33027,33153,0,126,33191,true,L-s-0 L-m-0 L-m-0 C-s-2 
job-661,5,11,3,33140,33140,33197,0,57,33478,true,C-m-0 C-m-2 C-m-1 
job-660,1,10,7,33081,33081,33212,0,131,33332,true,L-l-0 L-l-0 L-l-0 C-s-0 C-s-1 C-m-0 C-m-0 
job-657,3,4,3,32911,32911,33250,0,339,33353,true,L-l-0 L-l-0 L-l-0 
job-663,4,10,2,33250,33250,33303,0,53,33571,true,C-l-0 C-l-0 
job-664,3,10,6,33308,33308,33321,0,13,33528,true,C-l-0 C-l-0 L-l-0 L-l-0 L-l-0 L-l-0 
job-665,3,7,4,33350,33350,33435,0,85,33459,true,C-l-0 C-l-0 L-l-0 L-l-0 
job-668,1,4,3,33509,33509,33523,0,14,33747,true,C-m-1 C-m-1 C-l-0 
job-666,6,11,6,33407,33407,33642,0,235,33741,true,L-l-0 C-m-0 C-m-2 C-m-1 C-l-1 C-l-1 
job-667,2,7,5,33447,33447,33671,0,224,33943,true,L-l-0 L-l-0 L-l-0 C-m-0 C-m-2 
job-671,5,11,2,33653,33653,33689,0,36,33886,true,C-m-2 C-l-2 
job-672,2,9,8,33700,33700,33727,0,27,33999,true,L-l-0 L-l-0 L-l-0 C-m-0 C-l-0 C-l-2 C-l-2 C-l-2 
job-674,4,5,2,33817,33817,33842,0,25,33986,true,C-l-2 C-s-0 
job-662,4,4,5,33191,33191,33845,0,654,34061,true,L-s-0 L-m-0 L-m-0 C-s-2 C-l-0 
job-669,5,4,2,33559,33559,33888,0,329,34062,true,C-l-0 C-l-2 
job-676,6,10,1,33910,33910,33963,0,53,34031,true,C-l-2 
job-673,1,10,6,33755,33755,33964,0,209,33998,true,L-l-0 L-l-0 L-l-0 C-m-0 C-m-0 C-l-0 
job-675,3,10,7,33864,33864,34020,0,156,34060,true,C-l-0 C-l-0 C-l-2 C-l-2 L-s-0 L-m-0 L-m-0 
job-670,6,10,2,33607,33642,34037,35,395,34108,true,L-l-0 C-m-0 
job-677,6,7,8,33964,34020,34089,56,69,34198,true,L-l-0 L-m-0 C-m-2 C-m-1 C-l-0 C-l-0 C-l-2 C-l-2 
job-679,2,9,3,34079,34079,34137,0,58,34313,true,L-m-0 L-l-0 L-l-0 
job-680,1,12,7,34130,34130,34197,0,67,34232,true,L-m-0 L-l-0 L-l-0 C-l-1 C-l-1 C-l-1 L-s-0 
job-678,5,11,1,34014,34020,34257,6,237,34439,true,C-l-1 
job-681,4,6,4,34188,34188,34307,0,119,34346,true,L-m-0 L-l-0 L-l-0 C-s-2 
job-684,5,4,6,34341,34341,34357,0,16,34564,true,L-m-0 L-l-0 C-m-1 C-m-0 C-l-0 C-l-0 
job-682,1,11,7,34237,34237,34377,0,140,34646,true,L-m-0 L-m-0 L-l-0 L-l-0 L-l-0 C-l-1 C-l-1 
job-685,6,8,2,34392,34392,34498,0,106,34600,true,C-l-1 L-m-0 
job-687,6,6,3,34482,34482,34540,0,58,34711,true,C-m-1 C-m-0 C-l-0 
job-688,4,5,1,34539,34539,34561,0,22,34776,true,C-l-1 
job-683,6,10,2,34287,34287,34575,0,288,34599,true,C-l-1 C-m-2 
job-686,4,5,7,34434,34434,34588,0,154,34635,true,L-s-0 L-l-0 L-l-0 L-l-0 C-s-2 C-s-0 C-s-1 
job-691,6,11,6,34674,34674,34700,0,26,34758,true,C-m-2 C-m-1 C-m-0 C-l-1 C-l-1 C-l-0 
job-690,3,6,3,34630,34630,34702,0,72,34757,true,L-l-0 L-l-0 L-l-0 
job-689,1,6,8,34588,34588,34738,0,150,34786,true,L-s-0 L-s-0 L-m-0 L-m-0 L-m-0 L-m-0 L-m-0 L-l-0 
job-692,4,4,8,34728,34728,34786,0,58,35051,true,L-l-0 L-l-0 C-s-2 C-s-0 C-s-1 C-m-2 C-m-2 C-m-1 
job-693,6,8,3,34783,34783,34836,0,53,35072,true,L-m-0 C-m-0 C-l-1 
job-694,2,4,5,34840,34840,34851,0,11,35026,true,L-s-0 L-s-0 L-m-0 L-m-0 L-m-0 
job-695,4,8,8,34884,34884,34894,0,10,34906,true,L-s-0 L-m-0 L-m-0 L-l-0 L-l-0 L-l-0 C-s-2 C-s-0 
job-698,4,12,3,35018,35018,35028,0,10,35228,true,C-s-2 C-s-0 C-s-1 
job-697,6,10,5,34976,34976,35030,0,54,35267,true,L-m-0 L-l-0 L-l-0 C-m-2 C-m-1 
job-700,3,9,8,35122,35122,35144,0,22,35171,true,L-l-0 L-l-0 L-l-0 L-l-0 C-s-2 C-s-0 C-s-1 C-m-2 
job-696,1,6,2,34931,34931,35187,0,256,35315,true,L-s-0 L-s-0 
job-701,1,11,8,35175,35175,35357,0,182,35402,true,L-l-0 L-l-0 L-l-0 L-l-0 C-s-2 C-s-0 C-s-1 C-m-2 
job-703,6,9,6,35270,35357,35369,87,12,35498,true,C-l-1 L-l-0 L-l-0 C-l-0 C-l-0 C-l-2 
job-705,4,12,1,35380,35380,35430,0,50,35716,true,C-s-2 
job-706,3,5,1,35426,35426,35485,0,59,35532,true,L-s-0 
job-707,1,4,2,35472,35472,35491,0,19,35638,true,L-m-0 L-m-0 
job-704,5,10,5,35331,35369,35500,38,131,35653,true,C-l-1 L-l-0 L-l-0 C-l-0 C-l-0 
job-699,1,4,7,35067,35067,35519,0,452,35671,true,L-s-0 L-m-0 L-m-0 L-m-0 L-m-0 L-m-0 L-m-0 
job-702,6,12,4,35225,35225,35550,0,325,35628,true,C-m-2 C-m-1 C-m-0 C-l-1 
job-709,3,4,3,35558,35558,35569,0,11,35592,true,L-m-0 C-l-1 C-l-1 
job-708,3,6,4,35519,35519,35689,0,170,35689,false,C-l-1 C-l-1 L-s-0 L-m-0 
job-711,1,6,7,35657,35657,35709,0,52,35888,true,L-s-0 L-m-0 L-m-0 L-l-0 L-l-0 L-l-0 L-l-0 
job-712,2,11,2,35707,35707,35748,0,41,36031,true,L-m-0 L-l-0 
job-713,5,9,2,35750,35750,35863,0,113,35950,true,L-m-0 L-l-0 
job-710,3,5,5,35611,35611,35881,0,270,36071,true,L-m-0 C-l-1 C-l-1 L-l-0 L-l-0 
job-715,1,11,7,35858,35858,35989,0,131,36072,true,C-l-1 C-l-1 L-s-0 C-s-2 C-s-0 C-s-1 C-m-2 
job-714,1,5,3,35799,35799,35991,0,192,36096,true,L-l-0 C-l-1 C-l-1 
job-716,4,4,2,35922,35922,35993,0,71,36185,true,L-l-0 L-l-0 
job-717,2,5,7,35955,35955,36044,0,89,36324,true,L-s-0 L-l-0 C-s-2 C-s-0 C-s-1 C-m-2 C-m-2 
job-719,1,12,3,36063,36063,36157,0,94,36386,true,L-m-0 L-m-0 L-l-0 
job-721,3,10,1,36171,36171,36204,0,33,36288,true,L-m-0 
job-722,2,6,8,36217,36217,36258,0,41,36375,true,L-m-0 L-m-0 L-l-0 C-s-0 C-s-1 C-s-1 C-m-1 C-m-1 
job-718,4,8,4,36008,36008,36285,0,277,36568,true,L-l-0 L-l-0 C-m-2 L-m-0 
job-723,2,10,3,36268,36268,36407,0,139,36703,true,L-m-0 L-m-0 L-l-0 
job-724,3,12,1,36313,36313,36499,0,186,36763,true,L-m-0 
job-727,4,4,3,36476,36476,36559,0,83,36849,true,L-l-0 C-m-2 C-l-0 
job-726,5,12,6,36427,36427,36593,0,166,36845,true,L-m-0 C-m-1 C-m-0 C-l-1 C-l-1 C-l-0 
job-720,2,8,8,36114,36114,36602,0,488,36675,true,L-l-0 C-m-2 C-m-2 L-s-0 L-s-0 C-s-2 C-s-2 C-s-0 
job-729,5,4,5,36574,36602,36631,28,29,36852,true,C-m-2 C-l-0 C-l-0 C-l-2 C-l-2 
job-728,6,6,6,36523,36593,36661,70,68,36607,false,L-l-0 L-m-0 C-m-1 C-m-0 C-l-1 C-l-1 
job-730,4,7,3,36616,36616,36698,0,82,36990,true,L-s-0 C-s-2 C-s-0 
job-731,6,5,1,36663,36663,36700,0,37,36850,true,L-l-0 
job-725,1,10,3,36370,36370,36777,0,407,36819,true,L-l-0 L-l-0 L-l-0 
job-732,1,12,6,36709,36709,36809,0,100,36996,true,L-l-0 L-s-0 L-m-0 L-m-0 C-s-2 C-s-0 
job-733,1,9,2,36759,36759,36845,0,86,37055,true,C-s-1 C-m-1 
job-734,1,4,7,36809,36809,36858,0,49,36951,true,C-s-1 C-m-1 C-m-1 C-m-1 C-m-1 C-m-1 L-s-0 
job-737,6,4,8,36960,36960,36991,0,31,37268,true,L-l-0 C-m-1 C-m-0 C-m-2 C-l-1 C-l-1 C-l-0 C-l-0 
job-739,1,4,5,37059,37059,37091,0,32,37327,true,L-s-0 L-s-0 L-m-0 C-s-1 C-s-1 
job-736,1,9,7,36907,36907,37173,0,266,37430,true,L-m-0 L-m-0 L-m-0 L-l-0 L-l-0 L-l-0 L-l-0 
job-738,2,11,1,37013,37013,37173,0,160,37370,true,L-l-0 
job-740,4,12,3,37117,37117,37229,0,112,37255,true,C-s-1 C-s-2 C-s-0 
job-743,5,8,1,37244,37244,37255,0,11,37267,true,L-m-0 
job-735,2,8,1,36857,36857,37280,0,423,37542,true,L-s-0 
job-742,4,9,1,37192,37192,37325,0,133,37356,true,C-l-1 
job-741,6,12,4,37152,37152,37355,0,203,37499,true,C-m-1 C-m-0 C-m-2 C-l-1 
job-744,5,9,4,37294,37294,37373,0,79,37604,true,L-m-0 L-l-0 L-l-0 C-l-0 
job-745,4,7,2,37351,37351,37477,0,126,37675,true,C-l-1 C-l-0 
job-746,6,11,3,37409,37409,37483,0,74,37539,true,C-l-1 C-l-0 L-m-0 
job-748,4,10,2,37511,37511,37552,0,41,37580,true,C-l-2 L-s-0 
job-747,5,7,6,37458,37458,37613,0,155,37761,true,L-l-0 L-l-0 C-m-1 C-m-0 C-m-2 C-l-2 
job-749,4,11,4,37556,37556,37635,0,79,37847,true,C-l-2 L-s-0 L-m-0 L-m-0 
job-752,2,12,4,37710,37710,37726,0,16,37940,true,C-m-0 L-s-0 L-m-0 L-m-0 
job-751,3,4,6,37654,37654,37782,0,128,37968,true,L-l-0 L-l-0 L-l-0 C-m-1 C-m-1 C-m-0 
job-750,2,12,3,37604,37604,37794,0,190,37879,true,L-l-0 C-m-1 C-m-0 
job-753,6,12,2,37765,37765,37798,0,33,38052,true,L-m-0 C-m-2 
job-755,6,11,6,37862,37862,37930,0,68,38218,true,L-l-0 L-l-0 C-m-1 C-m-0 C-m-2 C-l-2 
job-754,5,11,1,37819,37819,37973,0,154,38039,true,L-m-0 
job-756,1,12,6,37920,37920,38014,0,94,38060,true,L-m-0 C-m-1 C-m-0 C-m-2 C-l-2 C-l-2 
job-757,4,11,2,37976,37976,38153,0,177,38251,true,L-m-0 C-m-1 
job-760,3,4,6,38130,38130,38228,0,98,38331,true,C-s-0 C-m-0 C-m-0 C-m-2 C-m-2 C-l-2 
job-761,1,7,7,38174,38174,38255,0,81,38465,true,L-m-0 L-m-0 C-s-0 C-s-2 C-m-0 C-m-0 C-m-2 
job-763,4,4,3,38288,38288,38316,0,28,38566,true,L-m-0 C-m-1 C-l-1 
job-758,4,12,7,38031,38031,38317,0,286,38564,true,L-m-0 C-m-1 L-s-0 L-l-0 L-l-0 L-l-0 C-s-1 
job-759,2,6,1,38094,38094,38338,0,244,38508,true,C-s-2 
job-764,6,6,5,38336,38336,38381,0,45,38588,true,C-l-1 L-m-0 L-l-0 L-l-0 C-m-1 
job-765,5,4,4,38387,38387,38410,0,23,38684,true,C-l-1 L-m-0 L-l-0 L-l-0 
job-762,5,6,5,38230,38230,38467,0,237,38685,true,C-m-0 C-m-2 C-l-2 C-l-2 C-l-1 
job-768,2,8,5,38535,38535,38569,0,34,38578,true,L-m-0 L-m-0 L-m-0 L-m-0 L-l-0 
job-767,4,10,2,38497,38497,38583,0,86,38713,true,C-l-1 C-l-1 
job-769,5,4,5,38584,38584,38626,0,42,38893,true,C-l-1 L-m-0 L-l-0 L-l-0 C-m-0 
job-766,4,8,2,38435,38435,38628,0,193,38922,true,C-l-1 L-s-0 
job-770,4,6,1,38630,38630,38749,0,119,38878,true,L-s-0 
job-771,6,6,4,38690,38690,38839,0,149,39103,true,L-m-0 L-l-0 L-l-0 C-m-0 
job-772,4,5,8,38736,38736,38846,0,110,38861,true,C-s-2 C-s-1 C-s-0 C-m-2 C-m-2 C-m-1 C-m-1 C-l-1 
job-773,3,8,4,38789,38789,38893,0,104,39156,true,C-l-1 C-l-1 L-s-0 C-l-2 
job-775,3,5,7,38878,38878,38925,0,47,39081,true,L-m-0 C-l-2 C-l-1 C-l-1 C-s-2 C-s-1 C-s-0 
job-776,5,4,8,38927,38927,38964,0,37,39060,true,C-l-2 C-m-2 C-m-1 C-m-0 C-l-1 C-l-1 C-l-0 C-l-0 
job-774,5,7,4,38833,38839,39007,6,168,39259,true,C-l-2 L-m-0 L-l-0 L-l-0 
job-778,3,11,5,39033,39033,39091,0,58,39181,true,L-m-0 C-l-2 C-l-2 C-l-2 L-s-0 
job-779,1,5,5,39093,39093,39208,0,115,39247,true,L-m-0 L-m-0 L-m-0 L-m-0 L-m-0 
job-781,5,9,2,39195,39195,39218,0,23,39393,true,C-l-1 C-l-1 
job-780,5,11,6,39139,39139,39235,0,96,39346,true,C-l-2 L-l-0 L-l-0 C-m-2 C-m-1 C-m-0 
job-783,2,5,5,39286,39286,39314,0,28,39487,true,L-m-0 L-s-0 L-s-0 L-l-0 L-l-0 
job-777,3,5,2,38989,38989,39334,0,345,39345,true,L-m-0 C-l-2 
job-786,1,4,4,39411,39411,39448,0,37,39658,true,L-m-0 L-m-0 L-m-0 L-m-0 
job-785,1,9,1,39370,39370,39510,0,140,39577,true,L-s-0 
job-789,6,4,2,39545,39545,39621,0,76,39662,true,C-m-2 C-m-1 
job-788,1,12,4,39496,39496,39669,0,173,39767,true,L-m-0 C-l-2 C-l-2 C-s-0 
job-787,1,5,4,39446,39446,39670,0,224,39937,true,L-m-0 C-s-2 C-s-1 C-l-2 
job-784,3,4,7,39333,39333,39685,0,352,39922,true,L-s-0 L-l-0 L-l-0 L-l-0 L-l-0 C-s-2 C-s-1 
job-791,1,11,1,39644,39644,39700,0,56,39765,true,L-s-0 
job-792,3,8,8,39698,39698,39720,0,22,39932,true,L-m-0 C-m-2 C-m-2 C-m-1 C-m-1 C-l-2 C-l-1 C-l-1 
job-790,2,8,8,39591,39591,39744,0,153,39849,true,L-m-0 C-m-2 C-m-1 C-m-0 C-m-0 C-m-0 C-m-0 C-l-1 
job-782,3,6,4,39246,39246,39793,0,547,40026,true,L-m-0 C-l-2 C-l-2 C-l-2 
job-794,6,9,1,39814,39814,39848,0,34,40139,true,L-m-0 
job-793,1,7,2,39756,39756,39917,0,161,40156,true,L-m-0 L-m-0 
job-796,2,9,5,39910,39910,40024,0,114,40073,true,L-l-0 L-l-0 L-l-0 C-s-2 C-s-1 
job-795,2,7,7,39856,39856,40047,0,191,40300,true,L-m-0 L-m-0 L-s-0 L-s-0 L-l-0 L-l-0 L-l-0 
job-797,2,12,3,39968,39968,40081,0,113,40185,true,L-m-0 C-s-0 C-m-0 
job-799,3,9,7,40088,40088,40130,0,42,40190,true,L-m-0 L-m-0 L-l-0 L-l-0 C-m-0 C-m-0 L-s-0 
job-800,3,5,5,40143,40143,40254,0,111,40270,true,L-m-0 L-m-0 L-l-0 L-l-0 C-m-0 
job-798,2,5,5,40029,40029,40268,0,239,40506,true,L-m-0 L-l-0 L-l-0 L-l-0 C-m-0 
job-802,6,4,3,40224,40224,40321,0,97,40565,true,C-m-2 C-m-1 C-l-2 
job-801,1,9,5,40182,40182,40325,0,143,40572,true,C-m-0 C-m-0 L-s-0 C-s-0 C-s-2 
job-803,4,9,1,40276,40276,40330,0,54,40509,true,C-m-0 
job-804,5,10,2,40319,40319,40344,0,25,40495,true,C-l-2 L-m-0 
job-805,2,5,4,40369,40369,40407,0,38,40484,true,L-s-0 L-s-0 L-m-0 L-m-0 
job-806,5,8,6,40424,40424,40439,0,15,40486,true,L-m-0 L-l-0 L-l-0 C-m-0 C-m-2 C-m-1 
job-807,5,5,3,40475,40475,40631,0,156,40913,true,L-m-0 L-l-0 L-l-0 
job-809,3,8,3,40562,40562,40632,0,70,40746,true,C-m-2 C-m-1 C-m-1 
job-808,3,4,8,40524,40524,40659,0,135,40928,true,L-m-0 L-s-0 C-s-0 C-s-2 C-s-1 C-m-0 C-m-0 C-m-2 
job-810,6,4,1,40622,40622,40709,0,87,40891,true,C-l-2 
job-811,5,12,3,40675,40675,40723,0,48,40808,true,C-l-2 L-m-0 L-l-0 
job-812,1,7,4,40727,40727,40749,0,22,40945,true,L-s-0 L-s-0 L-m-0 L-m-0 
job-814,2,7,8,40857,40857,40867,0,10,40871,true,L-m-0 L-m-0 L-m-0 L-m-0 L-l-0 L-l-0 L-l-0 L-l-0 
job-813,2,11,1,40793,40793,40996,0,203,41292,true,L-s-0 
job-816,4,8,7,40968,40968,41043,0,75,41230,true,L-m-0 L-l-0 L-l-0 L-l-0 C-s-0 C-s-2 C-s-1 
job-817,5,5,7,41021,41021,41104,0,83,41294,true,C-m-1 C-m-2 C-m-0 C-l-2 C-l-2 C-l-1 C-l-1 
job-819,5,11,4,41124,41124,41156,0,32,41445,true,L-m-0 C-m-1 C-m-2 C-m-0 
job-820,6,9,7,41180,41180,41194,0,14,41275,true,C-m-1 C-m-2 C-m-0 C-l-2 C-l-2 C-l-1 C-l-1 
job-815,1,7,3,40916,40916,41195,0,279,41310,true,L-m-0 L-m-0 L-m-0 
job-818,4,12,6,41069,41069,41223,0,154,41230,true,L-s-0 L-l-0 L-l-0 L-l-0 C-s-0 C-s-2 
job-822,6,12,8,41290,41290,41334,0,44,41516,true,L-l-0 L-l-0 C-m-1 C-m-2 C-m-0 C-l-2 C-l-2 C-l-1 
job-824,6,6,4,41411,41411,41427,0,16,41518,true,C-m-1 C-m-2 C-m-0 C-l-2 
job-821,2,8,5,41235,41235,41472,0,237,41558,true,L-s-0 L-s-0 L-m-0 L-m-0 L-m-0 
job-825,4,5,5,41450,41450,41510,0,60,41636,true,C-s-0 C-s-2 C-s-1 C-m-1 C-m-1 
job-823,3,6,4,41356,41356,41521,0,165,41804,true,L-l-0 L-l-0 L-l-0 L-l-0 
job-826,3,8,8,41488,41488,41543,0,55,41810,true,L-s-0 L-m-0 L-m-0 C-m-2 C-m-2 C-m-0 C-m-0 C-l-2 
job-827,5,5,6,41528,41528,41751,0,223,41865,true,C-l-2 L-l-0 L-l-0 C-m-1 C-l-1 C-l-1 
job-829,4,11,1,41646,41646,41752,0,106,42041,true,L-s-0 
job-831,4,10,7,41743,41751,41773,8,22,41798,true,C-m-0 C-l-2 C-l-2 L-l-0 L-l-0 L-l-0 C-m-1 
job-828,4,11,1,41603,41603,41789,0,186,41938,true,C-l-2 
job-832,2,9,2,41793,41793,41824,0,31,41969,true,C-m-0 C-m-0 
job-830,4,11,8,41691,41691,41836,0,145,41896,true,L-m-0 L-m-0 C-s-0 C-s-2 C-s-1 C-m-2 C-m-2 C-m-0 
job-833,3,6,1,41836,41836,41883,0,47,42072,true,L-s-0 
job-834,5,4,4,41879,41879,41968,0,89,42045,true,L-m-0 L-l-0 L-l-0 C-m-2 
job-836,6,9,3,41978,41978,41998,0,20,42143,true,L-l-0 L-l-0 C-m-1 
job-835,3,11,7,41927,41927,42005,0,78,42160,true,L-m-0 C-m-2 L-s-0 C-s-0 C-s-2 C-s-1 C-m-0 
job-837,6,6,2,42020,42020,42105,0,85,42339,true,L-m-0 L-l-0 
job-839,5,9,1,42110,42110,42146,0,36,42197,true,L-l-0 
job-838,5,11,1,42063,42063,42149,0,86,42332,true,L-l-0 
job-840,4,12,8,42156,42156,42167,0,11,42330,true,L-s-0 L-m-0 L-m-0 L-l-0 L-l-0 L-l-0 C-s-0 C-s-2 
job-841,2,8,2,42199,42199,42222,0,23,42402,true,L-s-0 L-s-0 
job-842,2,5,8,42244,42244,42340,0,96,42481,true,L-s-0 L-s-0 L-m-0 L-m-0 L-m-0 L-m-0 L-l-0 L-l-0 
job-845,2,8,7,42408,42408,42432,0,24,42664,true,C-m-2 C-m-0 C-m-1 C-l-1 C-l-1 C-l-1 L-s-0 
job-846,1,9,3,42445,42445,42460,0,15,42598,true,C-m-2 C-m-2 C-m-0 
job-844,1,7,5,42355,42355,42463,0,108,42651,true,L-l-0 L-l-0 L-l-0 L-l-0 L-l-0 
job-843,6,5,7,42305,42305,42507,0,202,42729,true,L-l-0 C-m-2 C-m-0 C-m-1 C-l-2 C-l-2 C-l-1 
job-847,3,12,5,42491,42491,42541,0,50,42660,true,L-l-0 L-l-0 C-l-1 C-l-1 L-s-0 
job-848,6,11,7,42533,42533,42548,0,15,42560,true,L-l-0 C-l-1 L-m-0 C-m-2 C-m-0 C-m-1 C-l-2 
job-849,3,9,4,42591,42591,42618,0,27,42750,true,L-s-0 L-m-0 L-m-0 L-l-0 
job-850,3,8,8,42636,42636,42725,0,89,42761,true,L-s-0 L-m-0 L-m-0 L-l-0 L-l-0 L-l-0 L-l-0 C-s-0 
job-851,5,8,2,42684,42684,42743,0,59,42792,true,C-m-2 C-m-0 
job-852,1,4,4,42735,42735,42745,0,10,43039,true,C-m-2 C-m-2 C-m-2 C-m-0 
job-853,5,11,3,42785,42785,42914,0,129,42939,true,L-m-0 L-l-0 L-l-0 
job-854,4,8,3,42838,42838,42918,0,80,43087,true,L-s-0 C-s-0 C-s-2 
job-855,2,10,1,42888,42888,43010,0,122,43269,true,L-m-0 
job-856,5,9,7,42952,42952,43030,0,78,43063,true,L-m-0 L-l-0 L-l-0 C-m-2 C-m-0 C-m-1 C-l-1 
job-858,2,6,1,43053,43053,43129,0,76,43146,true,C-l-2 
job-857,4,10,7,43006,43006,43134,0,128,43401,true,C-l-1 L-s-0 C-s-0 C-s-2 C-s-1 C-l-2 C-l-2 
job-859,4,7,8,43097,43097,43177,0,80,43423,true,C-l-1 C-l-1 L-m-0 L-m-0 L-l-0 L-l-0 L-l-0 C-m-2 
job-860,2,11,5,43153,43153,43181,0,28,43233,true,C-m-2 C-m-2 C-l-1 C-l-1 L-s-0 
job-861,6,11,5,43209,43209,43220,0,11,43244,true,L-m-0 L-l-0 L-l-0 C-m-2 C-m-0 
job-862,5,6,3,43273,43273,43297,0,24,43402,true,L-m-0 L-l-0 L-l-0 
job-864,4,10,3,43363,43363,43375,0,12,43611,true,L-l-0 L-l-0 L-l-0 
job-863,4,9,3,43312,43312,43392,0,80,43553,true,L-s-0 L-m-0 L-m-0 
job-865,1,4,3,43409,43409,43483,0,74,43569,true,L-s-0 L-s-0 L-s-0 
job-867,6,12,2,43513,43513,43525,0,12,43824,true,C-l-2 C-l-2 
job-870,4,11,1,43663,43663,43714,0,51,43975,true,C-s-2 
job-871,2,7,4,43726,43726,43759,0,33,43913,true,C-s-0 C-s-2 C-s-2 C-s-1 
job-869,1,7,7,43612,43612,43772,0,160,43848,true,C-m-0 C-m-0 C-m-1 C-m-1 L-s-0 L-s-0 C-s-0 
job-866,6,4,8,43478,43478,43789,0,311,44053,true,L-m-0 L-l-0 L-l-0 C-m-2 C-m-0 C-m-1 C-l-1 C-l-1 
job-868,2,5,2,43568,43568,43817,0,249,44090,true,L-m-0 C-m-2 
job-873,2,5,3,43821,43821,43890,0,69,43911,true,C-s-0 L-s-0 L-s-0 
job-875,2,10,7,43924,43924,43959,0,35,43992,true,L-s-0 L-l-0 L-l-0 L-l-0 L-l-0 C-s-2 C-s-1 
job-877,6,11,7,44019,44019,44042,0,23,44225,true,C-m-0 C-m-1 C-m-2 C-l-1 C-l-1 C-l-2 C-l-2 
job-878,3,4,7,44065,44065,44091,0,26,44209,true,C-s-0 L-s-0 C-s-2 C-s-1 C-m-0 C-m-0 C-m-1 
job-874,2,4,4,43870,43870,44142,0,272,44304,true,L-m-0 L-m-0 L-m-0 L-m-0 
job-880,6,9,4,44181,44181,44234,0,53,44481,true,L-m-0 C-m-2 C-l-1 C-l-1 
job-872,1,9,1,43769,43769,44248,0,479,44293,true,C-s-0 
job-879,3,6,7,44118,44118,44264,0,146,44494,true,C-s-0 L-s-0 C-s-2 C-s-1 C-m-0 C-m-0 C-m-1 
job-876,6,9,2,43971,43971,44313,0,342,44355,true,L-l-0 L-l-0 
job-881,2,7,5,44241,44241,44329,0,88,44485,true,C-m-0 C-m-1 C-m-1 L-m-0 L-m-0 
job-882,5,9,8,44305,44305,44491,0,186,44553,true,C-m-0 C-m-2 C-l-1 C-l-1 C-l-2 C-l-2 C-l-0 C-l-0 
job-885,3,7,3,44477,44477,44496,0,19,44715,true,L-l-0 L-l-0 L-l-0 
job-884,3,12,3,44414,44414,44544,0,130,44702,true,L-s-0 L-m-0 L-m-0 
job-886,6,8,8,44527,44527,44579,0,52,44594,true,C-m-0 C-m-2 L-l-0 L-l-0 C-m-1 C-l-1 C-l-1 C-l-2 
job-883,2,8,2,44367,44367,44616,0,249,44780,true,C-m-0 C-m-2 
job-887,5,6,6,44582,44582,44673,0,91,44690,true,C-m-0 C-m-2 L-m-0 L-l-0 L-l-0 C-m-1 
job-888,2,9,1,44634,44634,44703,0,69,44985,true,L-m-0 
job-889,6,9,8,44679,44679,44705,0,26,44776,true,L-m-0 L-l-0 L-l-0 C-m-0 C-m-2 C-m-1 C-l-1 C-l-1 
job-890,2,8,2,44731,44731,44760,0,29,44949,true,L-s-0 L-s-0 
job-892,3,9,2,44820,44820,44925,0,105,45090,true,L-s-0 C-s-0 
job-894,6,11,2,44932,44932,44952,0,20,44984,true,C-l-1 C-l-1 
job-893,6,9,2,44876,44876,44961,0,85,45126,true,C-m-2 C-m-1 
job-896,3,5,6,45024,45024,45083,0,59,45153,true,C-m-2 C-m-2 C-m-1 C-m-1 C-l-1 C-l-1 
job-897,2,11,4,45073,45073,45097,0,24,45099,true,L-m-0 C-m-2 C-m-1 C-m-0 
job-898,4,8,2,45129,45129,45142,0,13,45264,true,C-m-2 C-m-2 
job-891,6,5,4,44777,44777,45144,0,367,45252,true,L-m-0 L-l-0 L-l-0 C-m-0 
job-899,5,4,3,45182,45182,45251,0,69,45540,true,L-m-0 L-l-0 L-l-0 
job-901,5,4,1,45294,45294,45328,0,34,45622,true,L-m-0 
job-900,4,4,2,45231,45231,45368,0,137,45396,true,C-m-0 C-m-0 
job-902,2,6,6,45348,45348,45384,0,36,45502,true,L-m-0 L-m-0 L-m-0 L-m-0 L-l-0 L-l-0 
job-903,4,11,8,45401,45401,45432,0,31,45648,true,L-m-0 L-m-0 L-l-0 L-l-0 L-l-0 C-m-0 C-m-0 C-m-2 
job-904,1,12,3,45443,45443,45461,0,18,45566,true,L-m-0 L-m-0 L-l-0 
job-907,2,12,6,45586,45586,45605,0,19,45607,true,L-l-0 L-l-0 C-m-0 C-m-0 C-m-2 C-m-2 
job-905,2,5,5,45490,45490,45629,0,139,45805,true,L-m-0 L-m-0 L-m-0 L-m-0 L-l-0 
job-895,4,9,4,44982,44982,45666,0,684,45753,true,L-s-0 C-s-0 C-s-2 C-s-1 
job-908,1,7,4,45634,45634,45736,0,102,45886,true,L-l-0 L-l-0 L-l-0 L-l-0 
job-906,1,12,1,45540,45540,45797,0,257,45915,true,L-l-0 
job-911,3,9,8,45798,45798,45811,0,13,45874,true,L-m-0 C-m-0 C-m-2 C-m-1 C-l-2 C-l-2 L-s-0 C-s-0 
job-910,6,9,3,45740,45740,45827,0,87,46055,true,L-l-0 C-l-1 C-l-2 
job-912,1,7,3,45839,45839,45886,0,47,46058,true,L-m-0 L-m-0 L-m-0 
job-909,5,5,6,45684,45684,45906,0,222,45926,true,L-l-0 L-m-0 C-m-0 C-m-2 C-m-1 C-l-1 
job-913,4,10,2,45878,45878,45953,0,75,46116,true,L-l-0 C-l-1 
job-914,5,8,5,45936,45936,45985,0,49,46253,true,L-l-0 C-l-1 L-m-0 C-m-0 C-m-2 
job-916,6,10,2,46054,46054,46076,0,22,46200,true,C-m-0 C-m-2 
job-915,3,6,7,45994,45994,46091,0,97,46160,true,L-s-0 L-m-0 L-m-0 L-l-0 L-l-0 L-l-0 L-l-0 
job-918,3,4,1,46146,46146,46184,0,38,46375,true,L-s-0 
job-917,6,8,4,46108,46108,46199,0,91,46491,true,L-m-0 L-l-0 L-l-0 C-m-0 
job-919,1,4,2,46186,46186,46309,0,123,46311,true,L-m-0 L-m-0 
job-921,4,9,1,46296,46296,46316,0,20,46361,true,C-l-1 
job-920,6,10,7,46238,46238,46386,0,148,46459,true,L-m-0 L-l-0 L-l-0 C-m-0 C-m-2 C-m-1 C-l-1 
job-923,4,4,8,46388,46388,46455,0,67,46608,true,C-l-1 L-s-0 L-m-0 L-m-0 L-l-0 L-l-0 L-l-0 C-s-0 
job-924,3,8,2,46434,46434,46490,0,56,46627,true,C-s-2 C-s-1 
job-922,6,12,1,46344,46344,46506,0,162,46646,true,C-l-1 
job-925,1,8,3,46476,46476,46510,0,34,46728,true,C-s-2 C-s-1 C-l-1 
job-927,3,9,4,46575,46575,46598,0,23,46877,true,L-l-0 L-l-0 L-l-0 L-l-0 
job-926,3,4,3,46530,46530,46654,0,124,46900,true,L-s-0 L-m-0 L-m-0 
job-929,4,8,6,46658,46658,46725,0,67,46785,true,L-s-0 L-m-0 L-m-0 C-s-2 C-s-1 C-s-0 
job-928,6,5,2,46618,46618,46747,0,129,46786,true,L-l-0 L-l-0 
job-930,2,7,3,46713,46713,46818,0,105,47029,true,C-m-0 C-m-0 C-m-0 
job-932,1,5,7,46794,46794,46843,0,49,46845,true,L-m-0 L-m-0 L-l-0 L-l-0 L-l-0 L-l-0 L-l-0 
job-933,1,12,3,46852,46852,46874,0,22,46987,true,L-m-0 L-m-0 L-l-0 
job-934,4,4,6,46904,46904,47003,0,99,47060,true,L-l-0 L-s-0 C-s-2 C-s-1 C-s-0 C-m-0 
job-935,5,9,3,46954,46954,47012,0,58,47044,true,C-m-2 C-m-1 C-l-1 
job-931,6,5,2,46749,46749,47034,0,285,47055,true,L-m-0 L-l-0 
job-936,5,11,6,47010,47010,47044,0,34,47163,true,L-l-0 C-l-1 C-m-0 C-l-2 C-l-2 C-l-0 
job-937,1,7,3,47050,47050,47081,0,31,47339,true,L-s-0 L-s-0 L-m-0 
job-939,4,8,1,47155,47155,47180,0,25,47234,true,L-m-0 
job-940,1,8,4,47199,47199,47261,0,62,47462,true,L-s-0 L-m-0 L-m-0 L-m-0 
job-938,3,7,1,47100,47100,47305,0,205,47469,true,L-s-0 
job-942,3,11,1,47307,47307,47340,0,33,47425,true,L-s-0 
job-943,4,8,5,47361,47361,47442,0,81,47553,true,L-s-0 L-m-0 L-m-0 C-s-2 C-s-1 
job-944,6,12,7,47412,47412,47452,0,40,47748,true,C-m-1 C-m-0 C-l-1 C-l-1 C-l-2 C-l-2 C-l-0 
job-946,3,7,4,47514,47514,47575,0,61,47835,true,L-s-0 L-m-0 L-m-0 C-s-2 
job-948,3,8,5,47603,47603,47621,0,18,47726,true,C-m-1 L-s-0 L-m-0 L-m-0 C-s-2 
job-945,1,4,1,47465,47465,47628,0,163,47668,true,C-m-2 
job-947,4,12,3,47553,47553,47650,0,97,47771,true,C-s-1 C-s-0 C-m-1 
job-949,3,5,2,47663,47663,47707,0,44,47842,true,L-s-0 L-m-0 
job-941,6,9,3,47256,47256,47765,0,509,47808,true,L-l-0 L-l-0 C-m-2 
job-950,5,10,3,47698,47698,47792,0,94,47810,true,L-m-0 C-m-1 C-m-0 
job-952,1,11,6,47818,47818,47865,0,47,47999,true,L-m-0 L-m-0 C-m-1 C-m-1 L-s-0 L-l-0 
job-953,5,7,1,47876,47876,47942,0,66,47992,true,L-m-0 
job-951,3,8,2,47741,47741,47996,0,255,48029,true,L-m-0 C-m-1 
job-955,1,7,7,47969,47969,48001,0,32,48181,true,L-m-0 L-m-0 L-m-0 C-m-1 C-m-1 L-s-0 L-s-0 
job-954,3,10,1,47917,47917,48072,0,155,48270,true,C-m-1 
job-958,4,8,5,48092,48092,48117,0,25,48335,true,L-l-0 L-l-0 C-m-1 C-s-1 C-s-0 
job-956,1,6,8,48014,48014,48119,0,105,48246,true,C-m-1 C-m-1 C-m-1 L-s-0 L-s-0 L-m-0 L-m-0 L-m-0 
job-957,1,10,2,48050,48050,48243,0,193,48479,true,L-m-0 L-l-0 
job-959,4,7,5,48137,48137,48302,0,165,48481,true,L-m-0 L-l-0 L-l-0 L-s-0 C-s-1 
job-960,2,6,5,48188,48188,48311,0,123,48577,true,L-m-0 L-l-0 C-s-0 C-s-0 C-s-2 
job-962,3,12,5,48289,48289,48315,0,26,48517,true,C-m-0 C-l-1 C-l-1 C-l-1 C-l-1 
job-961,4,7,5,48235,48235,48372,0,137,48620,true,C-m-1 C-m-1 C-m-2 C-m-2 C-m-0 
job-963,6,4,5,48347,48347,48375,0,28,48531,true,L-m-0 L-l-0 L-l-0 C-l-1 C-l-1 
job-965,6,6,8,48450,48450,48491,0,41,48587,true,L-l-0 C-m-1 C-m-2 C-m-0 C-l-1 C-l-1 C-l-2 C-l-2 
job-968,5,8,8,48588,48588,48602,0,14,48630,true,C-m-2 C-m-0 C-l-1 C-l-1 C-l-2 C-l-2 C-l-0 C-l-0 
job-964,2,6,8,48399,48399,48641,0,242,48891,true,L-s-0 L-s-0 L-m-0 L-m-0 L-m-0 L-m-0 L-l-0 L-l-0 
job-966,2,11,1,48500,48500,48649,0,149,48804,true,L-l-0 
job-967,6,5,2,48538,48538,48649,0,111,48716,true,L-l-0 C-m-1 
job-969,6,7,2,48631,48631,48656,0,25,48662,true,C-m-2 C-m-0 
job-970,3,11,2,48684,48684,48734,0,50,48751,true,L-s-0 L-m-0 
job-971,5,11,1,48744,48744,48791,0,47,48996,true,L-m-0 
job-972,3,6,6,48804,48804,48845,0,41,48852,true,L-s-0 L-m-0 L-m-0 L-l-0 L-l-0 L-l-0 
job-973,2,11,4,48860,48860,48937,0,77,49058,true,L-s-0 L-m-0 L-m-0 L-l-0 
job-975,2,12,2,48962,48962,49020,0,58,49106,true,L-m-0 L-m-0 
job-974,4,5,7,48906,48906,49063,0,157,49220,true,L-m-0 L-l-0 L-l-0 C-s-0 C-s-1 C-s-2 C-m-1 
job-977,2,9,5,49056,49056,49068,0,12,49176,true,L-m-0 L-m-0 L-l-0 L-l-0 C-m-2 
job-976,6,5,4,49001,49001,49071,0,70,49085,true,C-m-2 C-m-0 C-l-1 C-l-1 
job-979,6,6,3,49150,49150,49182,0,32,49265,true,L-l-0 C-m-2 C-m-0 
job-980,2,10,3,49193,49193,49219,0,26,49299,true,L-l-0 L-l-0 L-l-0 
job-978,2,12,4,49098,49098,49224,0,126,49270,true,L-s-0 L-m-0 L-m-0 L-l-0 
job-981,6,12,7,49243,49243,49346,0,103,49386,true,L-m-0 L-l-0 L-l-0 C-m-2 C-m-0 C-m-1 C-l-1 
job-982,6,11,7,49279,49346,49363,67,17,49523,true,L-m-0 L-l-0 L-l-0 C-m-2 C-m-0 C-m-1 C-l-1 
job-983,4,11,6,49327,49346,49428,19,82,49656,true,C-l-1 L-s-0 C-s-0 C-s-1 C-s-2 C-l-2 
job-984,1,10,1,49383,49383,49504,0,121,49678,true,C-l-1 
job-986,2,4,8,49489,49489,49544,0,55,49674,true,L-m-0 L-m-0 C-l-1 L-l-0 L-l-0 L-l-0 L-l-0 L-l-0 
job-985,3,5,5,49440,49440,49549,0,109,49630,true,C-l-1 C-l-1 C-l-1 L-s-0 L-m-0 
job-988,3,12,1,49586,49586,49623,0,37,49851,true,C-m-0 
job-987,4,6,6,49537,49537,49672,0,135,49886,true,C-s-0 C-s-1 C-s-2 C-m-2 C-m-2 C-m-0 
job-990,2,7,2,49690,49690,49721,0,31,49770,true,C-m-0 C-m-0 
job-989,3,8,2,49641,49641,49783,0,142,50000,true,C-m-0 L-s-0 
job-991,6,11,8,49744,49744,49796,0,52,49884,true,L-m-0 L-l-0 L-l-0 C-m-2 C-m-1 C-l-1 C-l-1 C-l-2 
job-992,2,10,6,49797,49797,49819,0,22,49847,true,L-s-0 L-m-0 L-m-0 L-m-0 L-l-0 L-l-0 
job-995,4,12,7,49947,49947,50013,0,66,50174,true,L-l-0 C-s-0 C-s-1 C-s-2 C-m-0 C-m-0 C-m-2 
job-994,1,11,5,49897,49897,50090,0,193,50202,true,L-m-0 L-s-0 L-l-0 L-l-0 L-l-0 
job-997,5,5,1,50043,50043,50097,0,54,50326,true,L-l-0 
job-998,3,9,8,50096,50096,50134,0,38,50178,true,L-m-0 L-l-0 L-l-0 C-m-2 C-m-1 L-s-0 C-s-0 C-s-1 
job-993,5,12,1,49840,49840,50182,0,342,50289,true,L-m-0 
job-999,1,7,5,50146,50146,50210,0,64,50358,true,L-m-0 L-m-0 C-m-2 C-m-2 C-m-2 
job-996,3,7,2,49997,49997,50218,0,221,50282,true,C-m-2 C-m-1 
job-1001,4,6,5,50256,50256,50302,0,46,50571,true,L-l-0 L-s-0 C-s-0 C-s-1 C-s-2 
job-1000,5,8,3,50203,50203,50373,0,170,50380,true,L-m-0 C-m-1 L-l-0 
job-1003,4,7,4,50352,50352,50385,0,33,50531,true,L-l-0 L-s-0 C-s-0 C-s-1 
job-1002,5,5,4,50300,50300,50429,0,129,50497,true,C-m-2 C-m-0 C-l-1 C-l-1 
job-1005,2,11,3,50464,50464,50508,0,44,50550,true,C-m-2 C-m-2 C-m-0 
job-1004,2,10,7,50407,50407,50526,0,119,50741,true,C-m-2 C-m-0 C-l-1 L-s-0 L-m-0 L-m-0 L-m-0 
job-1006,4,8,7,50514,50514,50639,0,125,50910,true,C-m-2 C-m-0 C-l-1 C-l-1 L-l-0 L-l-0 L-l-0 
job-1008,6,12,3,50613,50639,50685,26,46,50794,true,C-l-0 L-l-0 L-l-0 
job-1009,1,12,1,50665,50665,50689,0,24,50699,true,L-m-0 
job-1007,6,6,5,50567,50567,50690,0,123,50848,true,L-m-0 C-m-1 C-l-2 C-l-2 C-l-0 
job-1012,4,4,6,50820,50820,50838,0,18,51020,true,C-s-0 C-s-1 C-s-2 C-l-2 C-l-2 C-l-2 
job-1011,5,5,6,50769,50769,50857,0,88,50885,true,L-l-0 C-m-1 C-m-2 C-m-0 C-l-0 C-l-0 
job-1010,4,11,4,50714,50714,50859,0,145,50966,true,L-s-0 L-m-0 L-m-0 L-l-0 
job-1013,1,11,4,50872,50872,50937,0,65,51141,true,L-s-0 L-m-0 L-m-0 L-l-0 
job-1014,3,5,4,50924,50924,50975,0,51,51165,true,L-s-0 L-m-0 L-m-0 L-l-0 
job-1017,4,5,4,51073,51073,51092,0,19,51323,true,L-l-0 C-s-0 C-s-1 C-s-2 
job-1018,2,8,7,51119,51119,51135,0,16,51407,true,L-m-0 L-l-0 L-l-0 L-l-0 C-s-0 C-s-0 C-s-1 
job-1015,3,5,2,50978,50978,51167,0,189,51259,true,L-s-0 L-m-0 
job-1019,4,5,2,51168,51168,51268,0,100,51286,true,L-m-0 L-l-0 
job-1020,4,5,4,51218,51218,51305,0,87,51437,true,L-s-0 C-s-0 C-s-1 C-s-2 
job-1016,3,7,3,51023,51023,51337,0,314,51426,true,L-m-0 L-l-0 L-l-0 
job-1023,2,11,3,51361,51361,51388,0,27,51612,true,L-m-0 L-l-0 L-l-0 
job-1021,5,9,4,51263,51263,51426,0,163,51523,true,C-m-1 C-m-2 C-m-0 C-l-0 
job-1022,4,11,5,51316,51316,51449,0,133,51543,true,L-m-0 L-l-0 C-l-0 L-s-0 C-s-0 
job-1025,2,11,5,51475,51475,51501,0,26,51626,true,L-m-0 L-m-0 L-s-0 L-l-0 L-l-0 
job-1024,2,5,2,51420,51420,51510,0,90,51630,true,L-m-0 L-m-0 
job-1026,6,4,6,51530,51530,51552,0,22,51704,true,L-m-0 L-l-0 L-l-0 C-m-1 C-m-2 C-m-0 
job-1027,5,9,2,51575,51575,51604,0,29,51613,true,L-m-0 L-l-0 
job-1028,5,6,6,51619,51619,51686,0,67,51779,true,L-m-0 L-l-0 L-l-0 C-m-1 C-m-2 C-m-0 
job-1030,2,8,4,51733,51733,51751,0,18,52026,true,L-m-0 L-m-0 L-m-0 L-m-0 
job-1029,4,9,1,51678,51678,51849,0,171,52077,true,L-s-0 
job-1032,2,4,8,51823,51823,51932,0,109,52161,true,L-m-0 L-l-0 L-l-0 L-l-0 C-s-0 C-s-0 C-s-1 C-s-1 
job-1034,6,5,2,51924,51924,51936,0,12,51998,true,C-m-2 C-m-0 
job-1031,6,5,2,51779,51779,51976,0,197,52096,true,L-m-0 L-l-0 
job-1035,6,7,5,51976,51976,51994,0,18,52048,true,L-m-0 L-l-0 L-l-0 C-m-2 C-m-0 
job-1033,4,11,4,51876,51876,52012,0,136,52222,true,L-s-0 C-s-2 C-m-1 C-m-1 
job-1036,5,12,6,52022,52022,52124,0,102,52366,true,L-m-0 L-l-0 L-l-0 C-m-1 C-m-2 C-m-0 
job-1038,1,12,3,52116,52124,52181,8,57,52276,true,L-m-0 L-m-0 L-l-0 
job-1040,1,11,4,52217,52217,52251,0,34,52254,true,L-m-0 L-m-0 L-l-0 L-l-0 
job-1042,2,6,1,52287,52287,52337,0,50,52603,true,L-m-0 
job-1041,6,5,4,52247,52247,52368,0,121,52439,true,C-l-2 C-l-2 C-l-1 C-l-1 
job-1037,5,6,8,52067,52124,52415,57,291,52406,false,L-m-0 L-l-0 L-l-0 C-m-1 C-m-2 C-m-0 C-l-0 C-l-0 
job-1044,2,9,7,52390,52390,52450,0,60,52604,true,L-m-0 L-l-0 C-m-2 C-m-0 C-l-0 C-s-1 C-l-2 
job-1043,4,5,3,52333,52333,52450,0,117,52629,true,L-s-0 C-s-2 C-s-0 
job-1046,3,5,2,52472,52472,52632,0,160,52764,true,L-m-0 L-m-0 
job-1039,2,9,1,52160,52160,52634,0,474,52748,true,C-m-1 
job-1049,5,10,2,52597,52597,52654,0,57,52678,true,C-l-0 C-l-0 
job-1047,3,12,2,52513,52513,52688,0,175,52711,true,L-l-0 C-m-1 
job-1051,4,7,6,52695,52695,52719,0,24,52796,true,L-l-0 L-s-0 C-s-2 C-s-0 C-s-1 C-m-1 
job-1048,5,9,2,52554,52554,52758,0,204,52844,true,C-m-2 C-m-0 
job-1050,1,6,8,52646,52646,52764,0,118,53009,true,L-m-0 L-m-0 L-l-0 C-m-2 C-m-2 C-m-2 C-m-0 C-m-0 
job-1052,6,11,8,52738,52738,52801,0,63,53098,true,L-l-0 C-m-1 C-l-0 C-l-0 C-l-2 C-l-2 C-l-1 C-l-1 
job-1053,4,12,8,52781,52781,52976,0,195,53015,true,L-m-0 L-s-0 C-s-2 C-s-0 C-s-1 C-m-2 C-m-2 C-m-0 
job-1045,1,10,5,52425,52425,52990,0,565,53209,true,L-m-0 L-m-0 L-l-0 L-l-0 L-l-0 
job-1056,1,7,5,52925,52976,53034,51,58,53266,true,L-s-0 C-s-2 C-s-0 C-l-0 C-l-0 
job-1055,3,7,6,52883,52976,53071,93,95,52989,false,L-m-0 L-l-0 C-m-1 L-s-0 C-s-2 C-s-0 
job-1054,5,7,8,52829,52829,53118,0,289,53152,true,L-l-0 C-m-1 C-l-0 C-l-0 C-l-2 C-l-2 C-l-1 C-l-1 
job-1057,5,10,8,52971,53118,53137,147,19,53227,true,L-m-0 L-l-0 L-l-0 C-m-1 C-m-2 C-m-0 C-l-0 C-l-0 
job-1061,5,12,4,53154,53154,53167,0,13,53241,true,L-m-0 L-l-0 L-l-0 C-m-1 
job-1059,2,8,4,53065,53118,53214,53,96,53337,true,L-m-0 L-l-0 C-m-1 C-m-2 
job-1062,4,11,2,53194,53194,53217,0,23,53509,true,L-m-0 L-l-0 
job-1063,2,10,8,53251,53251,53299,0,48,53325,true,L-m-0 L-m-0 L-s-0 L-l-0 L-l-0 L-l-0 L-l-0 C-s-2 
job-1064,6,10,4,53288,53288,53300,0,12,53593,true,C-m-1 C-m-2 C-m-0 C-l-0 
job-1065,5,4,6,53336,53336,53348,0,12,53397,true,L-m-0 L-l-0 L-l-0 C-m-1 C-m-2 C-m-0 
job-1066,2,10,6,53398,53398,53442,0,44,53652,true,L-m-0 L-m-0 L-s-0 L-l-0 L-l-0 L-l-0 
job-1068,1,11,2,53471,53471,53499,0,28,53526,true,L-m-0 L-m-0 
job-1058,1,10,1,53017,53118,53510,101,392,53531,true,L-m-0 
job-1067,5,11,7,53435,53435,53536,0,101,53708,true,L-l-0 C-m-1 C-m-2 C-m-0 C-l-0 C-l-0 C-l-1 
job-1070,4,7,5,53563,53563,53574,0,11,53804,true,L-l-0 L-l-0 L-s-0 L-m-0 L-m-0 
job-1072,6,8,4,53672,53672,53682,0,10,53939,true,C-m-1 C-m-2 C-m-0 C-l-0 
job-1071,3,6,5,53612,53612,53699,0,87,53935,true,L-l-0 L-l-0 L-s-0 L-m-0 L-m-0 
job-1060,6,4,2,53103,53118,53762,15,644,53759,false,C-l-2 C-l-2 
job-1073,2,10,2,53743,53743,53834,0,91,54008,true,L-l-0 L-l-0 
job-1074,1,4,8,53800,53800,53872,0,72,54080,true,L-l-0 L-l-0 L-l-0 L-l-0 L-s-0 L-s-0 L-s-0 L-s-0 
job-1076,5,11,1,53900,53900,53913,0,13,54146,true,L-l-0 
job-1075,2,4,1,53839,53839,53988,0,149,54144,true,L-l-0 
job-1069,2,5,2,53510,53510,54026,0,516,54268,true,L-l-0 L-l-0 
job-1077,5,6,1,53950,53950,54037,0,87,54257,true,L-l-0 
job-1078,5,6,3,54005,54005,54070,0,65,54279,true,L-m-0 C-m-1 C-m-2 
job-1079,1,6,7,54064,54064,54091,0,27,54187,true,L-m-0 L-m-0 L-m-0 C-m-1 C-m-1 C-m-1 C-m-2 
job-1080,1,4,3,54115,54115,54145,0,30,54251,true,L-s-0 L-s-0 L-s-0 
job-1081,2,10,4,54176,54176,54191,0,15,54198,true,L-s-0 L-m-0 L-m-0 L-m-0 
job-1083,3,6,6,54272,54272,54334,0,62,54532,true,L-s-0 L-m-0 L-m-0 L-l-0 L-l-0 L-l-0 
job-1085,6,9,7,54365,54365,54401,0,36,54445,true,L-m-0 L-l-0 L-l-0 C-m-0 C-l-2 C-l-2 C-l-0 
job-1082,1,7,1,54238,54238,54408,0,170,54424,true,L-s-0 
job-1088,1,11,8,54509,54509,54525,0,16,54697,true,L-s-0 C-s-2 C-s-0 C-s-1 C-l-0 C-l-0 C-l-0 C-l-0 
job-1084,6,10,2,54316,54316,54597,0,281,54679,true,C-m-1 C-m-2 
job-1087,2,12,4,54465,54465,54618,0,153,54838,true,L-m-0 C-m-1 C-m-2 C-m-0 
job-1086,6,4,6,54412,54412,54832,0,420,55028,true,L-m-0 L-l-0 L-l-0 C-m-0 C-l-2 C-l-2 
job-1090,2,7,5,54620,54832,54987,212,155,54886,false,L-m-0 L-l-0 C-m-0 C-m-1 C-m-2 
job-1089,5,9,8,54571,54832,55031,261,199,54989,false,L-m-0 L-l-0 L-l-0 C-m-0 C-m-1 C-m-2 C-l-2 C-l-2 
job-1093,3,4,6,54758,55031,55084,273,53,54925,false,L-m-0 C-m-0 C-m-1 C-m-1 C-m-2 C-m-2 
job-1091,4,4,7,54661,54832,55101,171,269,55007,false,L-s-0 C-s-2 C-s-0 C-s-1 C-l-0 C-l-0 C-l-0 
job-1094,5,11,6,54814,55084,55182,270,98,54916,false,C-m-1 C-m-2 C-l-2 C-l-2 C-l-1 C-l-1 
job-1097,2,8,3,54976,55182,55256,206,74,55305,true,C-m-0 C-l-0 C-l-0 
job-1096,1,10,8,54923,55182,55265,259,83,55246,false,L-m-0 L-m-0 L-l-0 L-l-0 C-m-1 C-m-1 C-m-2 C-m-2 
job-1095,6,10,7,54867,55182,55267,315,85,55062,false,C-m-1 C-m-2 C-l-2 C-l-2 C-l-1 C-l-1 C-l-0 
job-1092,5,9,4,54707,55031,55291,324,260,55157,false,L-m-0 L-l-0 L-l-0 C-m-0 
job-1099,2,7,3,55066,55267,55300,201,33,55167,false,L-m-0 L-l-0 C-m-1 
job-1100,1,7,5,55123,55267,55322,144,55,55244,false,L-m-0 C-m-2 C-m-2 C-m-0 C-m-0 
job-1098,6,7,5,55024,55267,55341,243,74,55111,false,C-m-1 C-m-2 C-l-2 C-l-2 C-l-1 
job-1101,6,9,5,55185,55291,55394,106,103,55514,true,L-l-0 C-m-0 C-l-1 C-l-0 C-l-0 
job-1103,1,9,4,55286,55291,55410,5,119,55565,true,L-m-0 L-l-0 C-s-0 C-s-1 
job-1105,6,12,7,55389,55394,55419,5,25,55634,true,L-l-0 C-l-1 C-m-0 C-l-0 C-l-0 C-l-2 C-l-2 
job-1102,3,8,4,55235,55291,55454,56,163,55666,true,L-m-0 L-l-0 L-s-0 C-s-2 
job-1104,4,4,6,55339,55341,55477,2,136,55744,true,L-m-0 C-l-1 C-m-2 C-m-2 C-m-1 C-m-1 
job-1107,2,4,3,55491,55491,55527,0,36,55599,true,L-l-0 L-l-0 L-l-0 
job-1109,4,7,7,55595,55595,55622,0,27,55702,true,L-s-0 C-s-2 C-s-0 C-s-1 C-m-1 C-m-1 C-l-2 
job-1108,6,9,5,55546,55546,55670,0,124,55676,true,L-l-0 C-l-1 C-l-0 L-m-0 C-m-2 
job-1106,6,8,4,55429,55429,55729,0,300,55877,true,L-l-0 C-l-1 C-m-0 C-l-0 
job-1111,3,11,4,55709,55709,55786,0,77,55858,true,L-m-0 L-m-0 L-l-0 L-l-0 
job-1110,1,4,6,55653,55653,55786,0,133,55806,true,L-m-0 L-m-0 C-m-2 C-m-2 C-m-0 C-m-0 
job-1112,6,10,7,55758,55758,55877,0,119,56173,true,L-l-0 C-m-0 C-m-2 C-m-1 C-l-1 C-l-1 C-l-0 
job-1113,1,8,5,55806,55806,55896,0,90,56004,true,L-l-0 L-l-0 L-l-0 L-l-0 C-m-0 
job-1116,6,9,1,55930,55930,55989,0,59,56042,true,L-l-0 
job-1117,4,9,3,55970,55970,56051,0,81,56130,true,C-s-1 C-m-1 C-m-1 
job-1115,6,12,4,55891,55891,56052,0,161,56206,true,L-l-0 C-m-0 C-l-0 C-m-2 
job-1119,4,11,1,56059,56059,56079,0,20,56102,true,L-l-0 
job-1118,4,10,3,56021,56021,56112,0,91,56177,true,L-l-0 C-l-1 C-l-1 
job-1114,3,8,7,55852,55852,56134,0,282,56224,true,C-l-0 C-l-0 L-s-0 L-m-0 L-m-0 C-s-2 C-s-0 
job-1122,3,6,8,56201,56201,56226,0,25,56505,true,L-l-0 L-s-0 C-s-2 C-s-0 C-s-1 C-m-0 C-m-0 C-m-2 
job-1120,1,10,4,56099,56099,56232,0,133,56304,true,L-m-0 L-l-0 L-l-0 L-l-0 
job-1123,1,7,8,56256,56256,56286,0,30,56558,true,L-m-0 L-m-0 L-l-0 L-l-0 L-l-0 L-l-0 L-l-0 C-m-1 
job-1121,6,9,3,56150,56150,56382,0,232,56514,true,L-m-0 L-l-0 C-m-1 
job-1124,5,4,4,56300,56300,56415,0,115,56582,true,L-l-0 C-m-0 C-m-2 C-l-1 
job-1125,4,4,3,56355,56355,56449,0,94,56510,true,C-l-1 L-s-0 C-s-2 
job-1126,6,5,2,56403,56403,56465,0,62,56711,true,L-l-0 L-m-0 
job-1127,3,4,3,56447,56447,56519,0,72,56685,true,L-l-0 L-l-0 C-l-1 
job-1128,4,5,2,56488,56488,56546,0,58,56671,true,L-l-0 C-l-1 
job-1129,6,5,1,56529,56529,56575,0,46,56775,true,L-l-0 
job-1130,2,7,3,56573,56573,56644,0,71,56878,true,L-l-0 L-l-0 L-l-0 
job-1131,5,8,5,56640,56640,56684,0,44,56807,true,L-l-0 L-m-0 C-m-0 C-m-2 C-m-1 
job-1132,6,4,6,56677,56677,56730,0,53,56859,true,L-l-0 C-l-1 C-l-1 C-l-0 C-l-0 C-l-2 
job-1133,6,6,5,56732,56732,56795,0,63,56843,true,L-m-0 L-l-0 L-l-0 C-m-0 C-m-2 
job-1134,5,8,1,56775,56775,56864,0,89,57088,true,C-m-1 
job-1135,5,4,1,56820,56820,56883,0,63,57102,true,L-m-0 
job-1137,5,6,8,56937,56937,57071,0,134,57091,true,L-m-0 C-m-1 C-m-0 C-m-2 C-l-1 C-l-1 C-l-0 C-l-0 
job-1138,1,6,6,56995,56995,57103,0,108,57110,true,L-m-0 L-m-0 L-m-0 L-l-0 L-l-0 C-m-1 
job-1139,6,11,7,57048,57071,57162,23,91,57422,true,C-m-1 C-m-0 C-m-2 C-l-1 C-l-1 C-l-0 C-l-0 
job-1141,2,11,8,57143,57143,57178,0,35,57380,true,L-m-0 L-m-0 L-l-0 C-m-1 C-m-0 C-m-2 C-l-2 C-l-2 
job-1136,5,4,2,56871,56871,57197,0,326,57345,true,L-l-0 L-l-0 
job-1142,3,7,1,57191,57191,57207,0,16,57493,true,L-m-0 
job-1140,4,8,7,57100,57100,57207,0,107,57349,true,L-m-0 L-s-0 C-s-2 C-s-0 C-s-1 C-l-2 C-l-2 
job-1145,1,4,7,57321,57321,57372,0,51,57648,true,L-s-0 L-l-0 L-l-0 L-l-0 L-l-0 C-s-2 C-s-2 
job-1144,4,10,4,57274,57274,57448,0,174,57672,true,L-m-0 L-m-0 L-l-0 L-l-0 
job-1143,3,6,1,57232,57232,57527,0,295,57726,true,L-s-0 
job-1146,6,11,8,57376,57376,57659,0,283,57714,true,C-m-1 C-m-0 C-m-2 C-l-2 C-l-2 C-l-1 C-l-1 C-l-0 
job-1152,1,7,3,57650,57659,57670,9,11,57883,true,C-m-1 C-m-1 C-m-0 
job-1149,6,6,7,57509,57659,57682,150,23,57665,false,L-m-0 C-m-1 C-m-0 C-m-2 C-l-2 C-l-2 C-l-1 
job-1150,2,12,1,57546,57659,57699,113,40,57854,true,L-m-0 
job-1147,2,12,1,57426,57426,57704,0,278,57984,true,L-l-0 
job-1148,3,12,3,57468,57468,57706,0,238,57812,true,L-l-0 L-l-0 L-l-0 
job-1151,3,11,3,57606,57659,57748,53,89,57729,false,C-l-1 C-l-1 L-s-0 
job-1154,1,9,2,57742,57742,57765,0,23,57834,true,L-m-0 L-m-0 
job-1156,5,12,6,57845,57845,57887,0,42,57905,true,L-m-0 L-l-0 L-l-0 C-m-1 C-m-0 C-m-2 
job-1153,3,8,2,57700,57700,57902,0,202,57973,true,C-l-1 C-l-1 
job-1158,3,7,3,57922,57922,57936,0,14,57947,true,C-l-1 C-l-1 L-s-0 
job-1155,3,6,2,57798,57798,58004,0,206,58006,true,C-l-1 C-l-1 
job-1159,3,9,7,57971,57971,58041,0,70,58264,true,C-l-1 C-l-1 L-s-0 C-s-2 C-s-0 C-s-1 C-l-2 
job-1161,6,6,2,58076,58076,58089,0,13,58180,true,C-l-1 C-l-1 
job-1157,6,6,6,57882,57887,58092,5,205,58161,true,L-m-0 L-l-0 L-l-0 C-m-1 C-m-0 C-m-2 
job-1162,5,4,5,58122,58122,58158,0,36,58171,true,L-m-0 C-m-1 C-m-0 C-m-2 L-l-0 
job-1163,3,11,8,58175,58175,58199,0,24,58424,true,L-m-0 L-m-0 C-m-1 C-m-1 C-m-0 C-m-0 C-m-2 C-m-2 
job-1160,2,8,4,58015,58015,58209,0,194,58342,true,L-m-0 C-m-1 C-m-0 C-m-2 
job-1164,5,6,5,58237,58237,58290,0,53,58463,true,L-m-0 L-l-0 L-l-0 C-m-1 C-m-0 
job-1165,1,5,8,58279,58279,58349,0,70,58550,true,L-m-0 L-m-0 L-m-0 L-l-0 L-l-0 C-m-1 C-m-1 C-m-1 
job-1166,4,12,2,58344,58344,58377,0,33,58555,true,L-m-0 L-l-0 
job-1168,1,12,3,58459,58459,58479,0,20,58596,true,L-l-0 L-l-0 L-l-0 
job-1167,1,10,5,58403,58403,58493,0,90,58773,true,L-s-0 L-m-0 L-m-0 L-m-0 L-l-0 
job-1169,6,7,6,58511,58511,58586,0,75,58721,true,L-m-0 L-l-0 L-l-0 C-m-1 C-m-0 C-m-2 
job-1170,1,9,3,58562,58562,58617,0,55,58789,true,L-m-0 L-m-0 C-m-1 
job-1171,1,9,5,58615,58615,58722,0,107,58990,true,L-m-0 C-m-1 C-m-1 L-s-0 L-l-0 
job-1172,3,5,6,58667,58667,58837,0,170,58989,true,L-s-0 L-m-0 L-m-0 L-l-0 L-l-0 L-l-0 
job-1173,3,7,6,58723,58723,58852,0,129,59122,true,L-l-0 C-s-2 C-s-0 C-s-1 C-m-1 C-m-1 
job-1174,6,8,4,58779,58779,58857,0,78,58919,true,C-m-0 C-m-2 C-l-1 C-l-1 
job-1175,2,5,5,58840,58840,58874,0,34,58938,true,L-l-0 L-l-0 L-l-0 L-l-0 C-m-1 
job-1177,2,9,8,58948,58948,59026,0,78,59296,true,L-m-0 L-l-0 C-m-1 L-s-0 C-s-2 C-s-0 C-s-1 C-m-0 
job-1176,5,5,4,58900,58900,59034,0,134,59185,true,L-m-0 L-l-0 L-l-0 C-m-1 
job-1179,2,4,2,59044,59044,59056,0,12,59073,true,C-m-0 C-m-2 
job-1178,5,8,4,58996,58996,59099,0,103,59121,true,C-m-0 C-m-2 C-l-1 C-l-1 
job-1182,1,12,8,59199,59199,59227,0,28,59361,true,L-s-0 L-m-0 L-m-0 L-l-0 L-l-0 L-l-0 L-l-0 C-s-2 
job-1184,6,10,3,59286,59286,59298,0,12,59536,true,C-l-2 C-l-0 C-l-0 
job-1180,1,10,2,59094,59094,59301,0,207,59543,true,C-m-0 C-m-0 
job-1181,1,4,4,59148,59148,59336,0,188,59549,true,C-m-0 C-m-0 C-m-0 L-s-0 
job-1185,2,10,3,59340,59340,59408,0,68,59461,true,L-m-0 L-l-0 C-m-2 
job-1186,5,10,4,59390,59390,59475,0,85,59764,true,C-l-2 C-m-0 C-l-0 C-l-0 
job-1183,5,6,8,59241,59241,59482,0,241,59736,true,L-m-0 L-l-0 L-l-0 C-m-2 C-m-1 C-l-1 C-l-1 C-l-2 
job-1189,4,10,3,59547,59547,59574,0,27,59644,true,L-l-0 C-s-2 C-s-0 
job-1188,3,4,4,59489,59489,59637,0,148,59660,true,L-m-0 L-s-0 L-l-0 L-l-0 
job-1190,5,8,3,59593,59593,59700,0,107,59962,true,L-l-0 C-m-0 C-m-2 
job-1187,1,7,3,59445,59445,59706,0,261,59996,true,L-m-0 L-m-0 L-m-0 
job-1192,6,11,7,59674,59674,59709,0,35,59716,true,L-l-0 C-l-0 C-l-0 C-l-2 C-l-2 C-l-1 C-l-1 
job-1193,5,6,6,59705,59709,59795,4,86,60020,true,C-m-0 C-m-2 L-m-0 L-l-0 L-l-0 C-l-0 
job-1196,1,11,2,59847,59847,59903,0,56,60027,true,L-l-0 C-m-0 
job-1194,1,9,7,59756,59756,59927,0,171,59971,true,L-m-0 L-m-0 L-l-0 L-l-0 C-m-1 C-l-0 C-l-0 
job-1191,3,8,7,59635,59635,59952,0,317,60208,true,C-m-0 C-m-2 C-s-2 C-s-0 C-s-1 C-m-1 C-m-1 
job-1198,3,5,2,59960,59960,59972,0,12,60027,true,L-m-0 L-l-0 
job-1195,4,10,2,59800,59800,59976,0,176,59993,true,L-m-0 L-l-0 
job-1199,2,6,2,60006,60006,60020,0,14,60172,true,L-l-0 L-l-0 
job-1197,4,5,5,59913,59913,60127,0,214,60340,true,L-l-0 C-m-0 C-m-2 C-l-0 C-l-0 
job-1201,2,10,8,60096,60096,60169,0,73,60397,true,L-l-0 L-l-0 L-l-0 C-m-0 C-m-0 C-m-2 C-m-2 C-l-0 
job-1200,1,4,2,60045,60045,60175,0,130,60412,true,L-l-0 L-l-0 
job-1203,5,12,3,60196,60196,60274,0,78,60366,true,C-l-0 L-m-0 L-l-0 
job-1205,4,8,2,60292,60292,60316,0,24,60361,true,L-l-0 C-l-0 
job-1202,6,5,1,60152,60152,60317,0,165,60597,true,C-l-0 
job-1204,5,10,4,60242,60242,60362,0,120,60431,true,L-l-0 C-m-0 C-m-2 C-m-1 
job-1206,2,6,2,60341,60341,60378,0,37,60439,true,L-l-0 L-l-0 
job-1207,6,12,5,60390,60390,60425,0,35,60468,true,L-m-0 L-l-0 L-l-0 C-m-0 C-m-2 
job-1209,1,7,7,60489,60489,60515,0,26,60726,true,L-m-0 L-m-0 C-m-0 C-m-0 C-m-2 C-m-2 L-s-0 
job-1210,1,9,3,60541,60541,60631,0,90,60862,true,L-m-0 L-m-0 C-m-0 
job-1208,6,10,5,60446,60446,60726,0,280,60731,true,L-m-0 L-l-0 L-l-0 C-m-0 C-m-2 
job-1211,5,5,5,60595,60595,60745,0,150,60857,true,C-m-1 C-l-0 C-l-0 C-l-2 C-l-2 
job-1212,1,8,4,60644,60644,60748,0,104,60836,true,L-m-0 L-m-0 C-m-0 C-m-0 
job-1213,1,5,5,60706,60706,60836,0,130,61016,true,C-m-2 C-m-2 C-m-1 C-m-1 C-m-1 
job-1215,5,6,6,60820,60820,60881,0,61,60898,true,L-m-0 L-l-0 L-l-0 C-m-0 C-l-0 C-l-0 
job-1216,6,7,1,60869,60869,60916,0,47,61094,true,C-m-1 
job-1217,1,9,3,60918,60918,60943,0,25,61113,true,C-m-2 C-m-1 C-m-1 
job-1214,2,9,3,60759,60759,60958,0,199,60976,true,C-m-1 C-m-2 C-m-2 
job-1218,2,8,8,60947,60947,61002,0,55,61071,true,C-m-2 C-m-1 C-m-1 L-s-0 L-s-0 L-m-0 L-m-0 L-m-0 
job-1219,3,9,8,60993,60993,61087,0,94,61328,true,C-m-1 C-m-2 C-m-2 L-l-0 L-l-0 L-l-0 L-l-0 C-s-2 
job-1221,5,6,1,61094,61094,61127,0,33,61135,true,C-m-1 
job-1220,3,8,2,61041,61041,61209,0,168,61308,true,C-m-1 L-s-0 
job-1224,1,5,7,61225,61225,61327,0,102,61443,true,C-m-1 C-m-1 C-m-1 C-m-1 L-s-0 L-s-0 L-s-0 
job-1222,3,10,2,61142,61142,61386,0,244,61494,true,C-m-1 L-m-0 
job-1228,3,12,4,61407,61407,61438,0,31,61472,true,L-m-0 C-m-1 C-l-2 C-l-2 
job-1223,5,12,1,61179,61179,61490,0,311,61600,true,L-m-0 
job-1225,4,7,6,61263,61263,61501,0,238,61542,true,L-l-0 L-l-0 L-l-0 C-s-2 C-s-0 C-s-1 
job-1229,4,11,4,61455,61455,61504,0,49,61546,true,C-m-1 C-l-2 C-l-2 C-l-1 
job-1226,4,7,5,61309,61309,61544,0,235,61732,true,C-m-2 C-m-2 C-m-0 C-m-0 C-l-0 
job-1227,1,12,7,61358,61358,61576,0,218,61819,true,C-m-1 C-l-0 C-l-0 C-l-0 L-s-0 C-l-2 C-l-2 
job-1230,6,8,4,61498,61501,61604,3,103,61884,true,C-l-1 L-m-0 L-l-0 L-l-0 
job-1231,6,7,7,61551,61576,61685,25,109,61830,true,C-l-1 C-m-1 C-m-2 C-m-0 C-l-0 C-l-0 C-l-2 
job-1235,3,12,8,61728,61728,61779,0,51,61869,true,C-s-1 C-m-2 C-m-2 C-m-0 C-m-0 C-l-0 C-l-0 C-l-0 
job-1233,4,6,7,61636,61636,61811,0,175,61963,true,L-m-0 C-l-1 C-l-2 L-s-0 L-l-0 L-l-0 L-l-0 
job-1232,2,7,2,61588,61588,61819,0,231,62087,true,L-m-0 C-m-1 
job-1234,3,10,8,61679,61685,61827,6,142,61851,true,C-m-1 C-m-1 C-l-1 C-l-1 C-l-2 C-l-2 C-s-2 C-s-0 
job-1237,1,8,5,61820,61820,61860,0,40,62059,true,L-m-0 L-m-0 L-l-0 L-l-0 C-m-1 
job-1238,5,9,4,61880,61880,61936,0,56,62062,true,C-l-1 C-l-2 C-m-1 C-m-0 
job-1236,5,12,6,61781,61811,61938,30,127,62072,true,L-m-0 C-l-1 C-l-2 L-l-0 L-l-0 C-m-2 
job-1240,5,7,8,61967,61967,61990,0,23,62187,true,C-l-1 C-l-2 L-m-0 L-l-0 L-l-0 C-m-2 C-m-0 C-l-0 
job-1239,5,11,3,61924,61936,61993,12,57,62070,true,C-l-1 C-l-2 C-m-1 
job-1241,4,8,2,62016,62016,62103,0,87,62381,true,L-s-0 L-m-0 
job-1242,5,6,4,62073,62073,62118,0,45,62353,true,L-l-0 L-l-0 C-m-1 C-m-2 
job-1243,2,5,1,62124,62124,62207,0,83,62313,true,L-s-0 
job-1244,5,9,8,62180,62180,62291,0,111,62452,true,L-m-0 L-l-0 L-l-0 C-m-1 C-m-2 C-m-0 C-l-1 C-l-1 
job-1246,4,5,5,62274,62274,62319,0,45,62392,true,L-s-0 C-s-2 C-s-0 C-s-1 C-l-2 
job-1245,3,9,2,62233,62233,62367,0,134,62620,true,L-m-0 C-m-1 
job-1247,6,6,5,62336,62336,62383,0,47,62518,true,L-l-0 L-l-0 C-m-2 C-m-0 C-l-1 
job-1248,2,7,6,62390,62390,62423,0,33,62534,true,L-s-0 L-s-0 L-m-0 L-m-0 L-m-0 L-m-0 
job-1250,1,4,5,62502,62502,62516,0,14,62806,true,L-m-0 L-m-0 L-m-0 L-l-0 L-l-0 
job-1252,4,9,4,62614,62614,62783,0,169,63033,true,L-s-0 C-s-2 C-s-0 C-s-1 
job-1253,6,8,1,62668,62668,62794,0,126,62935,true,C-l-2 
job-1254,6,5,2,62710,62710,62798,0,88,62815,true,C-l-2 C-l-0 
job-1251,5,9,6,62563,62563,62801,0,238,63076,true,L-l-0 C-m-1 C-m-2 C-m-0 C-l-1 C-l-1 
job-1255,6,11,8,62772,62801,62924,29,123,63110,true,L-l-0 C-m-1 C-m-2 C-m-0 C-l-1 C-l-1 C-l-2 C-l-2 
job-1257,1,11,5,62864,62864,62943,0,79,63034,true,L-m-0 L-l-0 C-m-1 C-m-2 C-m-0 
job-1256,6,9,1,62812,62812,62950,0,138,63065,true,C-l-0 
job-1249,5,11,2,62446,62446,62969,0,523,62998,true,L-m-0 L-l-0 
job-1258,1,5,7,62914,62914,62999,0,85,63298,true,L-m-0 L-m-0 C-m-1 C-m-2 C-m-0 C-l-0 C-l-0 
job-1261,2,6,5,63078,63078,63186,0,108,63465,true,L-l-0 L-l-0 L-l-0 L-l-0 L-l-0 
job-1264,5,7,2,63227,63227,63241,0,14,63242,true,L-l-0 L-l-0 
job-1263,2,5,5,63179,63179,63248,0,69,63443,true,C-m-0 C-m-0 C-m-0 C-m-0 C-l-0 
job-1259,2,7,2,62972,62972,63260,0,288,63504,true,L-m-0 L-m-0 
job-1260,2,6,5,63027,63027,63307,0,280,63421,true,L-m-0 L-m-0 L-s-0 L-s-0 L-l-0 
job-1262,4,4,7,63122,63122,63312,0,190,63441,true,C-s-2 C-s-0 C-s-1 C-m-1 C-m-1 C-m-2 C-m-2 
job-1265,5,10,6,63287,63287,63390,0,103,63596,true,L-l-0 L-l-0 C-m-0 C-l-0 C-l-0 C-l-1 
job-1267,6,8,3,63405,63405,63415,0,10,63686,true,C-l-1 L-l-0 L-l-0 
job-1268,3,10,1,63450,63450,63503,0,53,63716,true,L-m-0 
job-1266,5,10,4,63349,63349,63511,0,162,63762,true,C-l-1 L-m-0 C-m-1 C-m-2 
job-1270,6,7,4,63563,63563,63579,0,16,63628,true,C-l-1 L-m-0 L-l-0 L-l-0 
job-1272,4,9,6,63660,63660,63696,0,36,63735,true,L-l-0 C-s-2 C-s-0 C-s-1 C-m-1 C-m-1 
job-1271,4,9,6,63614,63614,63745,0,131,64023,true,C-l-1 L-s-0 L-m-0 L-m-0 L-l-0 L-l-0 
job-1269,6,4,1,63509,63509,63784,0,275,63855,true,C-l-1 
job-1273,2,11,4,63700,63700,63789,0,89,63889,true,L-l-0 L-l-0 C-l-1 C-s-2 
job-1274,4,6,4,63754,63754,63846,0,92,64056,true,L-l-0 L-l-0 C-l-1 L-s-0 
job-1275,2,12,5,63796,63796,63904,0,108,64034,true,L-l-0 L-l-0 C-l-1 C-l-1 C-l-1 
job-1277,1,12,2,63910,63910,63941,0,31,64094,true,L-l-0 L-l-0 
job-1279,3,9,4,64018,64018,64033,0,15,64076,true,C-l-1 C-l-1 C-l-1 L-s-0 
job-1278,4,9,2,63962,63962,64055,0,93,64321,true,L-l-0 L-l-0 
job-1281,4,8,2,64098,64098,64118,0,20,64268,true,C-l-1 C-l-1 
job-1280,1,8,3,64060,64060,64137,0,77,64284,true,L-l-0 L-l-0 L-l-0 
job-1282,1,9,5,64147,64147,64160,0,13,64214,true,L-l-0 L-l-0 C-l-1 C-l-1 C-l-1 
job-1283,2,7,8,64193,64193,64209,0,16,64287,true,L-l-0 L-l-0 L-l-0 C-l-1 C-l-1 C-l-1 C-l-1 C-l-1 
job-1276,2,12,3,63856,63856,64240,0,384,64428,true,L-l-0 L-l-0 C-l-1 
job-1286,1,6,7,64338,64338,64354,0,16,64650,true,L-m-0 L-m-0 L-l-0 C-m-1 C-m-1 C-m-2 C-m-2 
job-1285,5,10,1,64284,64284,64381,0,97,64441,true,L-l-0 
job-1284,6,9,7,64236,64236,64459,0,223,64666,true,L-l-0 C-l-1 L-m-0 C-m-1 C-m-2 C-m-0 C-l-0 
job-1287,3,11,2,64395,64395,64464,0,69,64739,true,L-l-0 L-l-0 
job-1288,6,11,2,64442,64442,64538,0,96,64771,true,C-l-1 C-l-0 
job-1290,6,6,1,64562,64562,64631,0,69,64776,true,C-l-1 
job-1289,4,4,8,64509,64509,64644,0,135,64757,true,C-l-1 C-l-0 L-s-0 L-m-0 L-m-0 L-l-0 L-l-0 L-l-0 
job-1291,6,9,8,64609,64644,64658,35,14,64719,true,L-m-0 L-l-0 L-l-0 C-m-1 C-m-2 C-m-0 C-l-1 C-l-1 
job-1292,3,10,3,64660,64660,64693,0,33,64838,true,L-s-0 L-m-0 L-m-0 
job-1295,2,6,6,64822,64822,64846,0,24,65108,true,C-m-1 C-m-2 C-m-0 C-s-2 C-s-2 C-s-0 
job-1294,5,4,6,64768,64768,64852,0,84,64857,true,L-m-0 L-l-0 L-l-0 C-m-1 C-m-2 C-m-0 
job-1293,1,12,5,64713,64713,64873,0,160,65107,true,L-s-0 L-m-0 L-m-0 L-l-0 L-l-0 
job-1296,2,9,5,64867,64867,64917,0,50,64981,true,L-l-0 L-l-0 C-s-2 C-s-0 C-s-1 
job-1297,6,7,3,64917,64917,64934,0,17,65005,true,L-m-0 L-l-0 L-l-0 
job-1298,5,7,7,64964,64964,64992,0,28,65223,true,L-m-0 L-l-0 L-l-0 C-m-1 C-m-2 C-m-0 C-l-1 
job-1299,5,8,1,65003,65003,65060,0,57,65062,true,L-m-0 
job-1302,4,9,5,65153,65153,65196,0,43,65387,true,L-l-0 C-s-2 C-s-0 C-s-1 C-m-1 
job-1303,4,10,2,65217,65217,65234,0,17,65390,true,L-l-0 C-s-2 
job-1300,1,4,7,65060,65060,65242,0,182,65320,true,L-s-0 L-s-0 L-s-0 L-s-0 L-m-0 L-m-0 L-m-0 
job-1304,4,8,8,65263,65263,65283,0,20,65407,true,L-m-0 L-l-0 L-s-0 C-s-2 C-s-0 C-s-1 C-m-1 C-m-1 
job-1301,2,5,5,65117,65117,65296,0,179,65509,true,L-m-0 L-m-0 L-l-0 L-l-0 L-l-0 
job-1305,6,8,4,65316,65316,65398,0,82,65599,true,L-m-0 L-l-0 L-l-0 C-m-1 
job-1306,1,11,3,65379,65379,65491,0,112,65565,true,L-m-0 L-m-0 C-m-1 
job-1307,2,12,3,65426,65426,65509,0,83,65622,true,C-m-1 L-s-0 L-l-0 
job-1309,2,10,3,65518,65518,65571,0,53,65714,true,L-m-0 L-m-0 L-l-0 
job-1310,1,9,5,65564,65564,65585,0,21,65687,true,L-l-0 L-l-0 L-s-0 C-s-2 C-s-0 
job-1308,4,5,3,65475,65475,65619,0,144,65805,true,L-m-0 L-l-0 L-l-0 
job-1311,5,8,7,65614,65614,65679,0,65,65828,true,C-m-1 C-m-2 C-m-0 C-l-1 C-l-1 C-l-0 C-l-0 
job-1312,4,11,8,65670,65670,65688,0,18,65838,true,L-s-0 L-m-0 L-m-0 L-l-0 L-l-0 L-l-0 C-s-2 C-s-0 
job-1313,2,7,5,65721,65721,65872,0,151,65934,true,L-s-0 L-s-0 L-m-0 L-m-0 L-m-0 
job-1316,5,8,4,65889,65889,65997,0,108,66231,true,L-m-0 C-l-0 C-l-0 C-l-2 
job-1314,5,12,7,65782,65782,66018,0,236,66067,true,L-l-0 L-l-0 C-m-1 C-m-2 C-m-0 C-l-1 C-l-1 
job-1315,1,6,2,65838,65838,66111,0,273,66116,true,L-m-0 L-l-0 
job-1319,3,10,3,66042,66042,66149,0,107,66202,true,L-m-0 L-l-0 L-l-0 
job-1321,2,11,5,66150,66150,66160,0,10,66416,true,L-m-0 L-m-0 L-l-0 L-l-0 L-l-0 
job-1317,2,4,8,65942,65942,66170,0,228,66252,true,L-m-0 C-m-1 C-m-2 C-m-0 C-l-1 C-l-0 C-l-2 C-l-2 
job-1318,3,12,4,65995,65995,66291,0,296,66544,true,C-l-2 L-s-0 C-s-2 C-s-0 
job-1322,3,6,8,66203,66203,66294,0,91,66467,true,L-m-0 L-m-0 L-l-0 L-l-0 C-m-2 C-m-2 C-l-2 C-l-2 
job-1320,2,5,7,66095,66095,66324,0,229,66453,true,L-m-0 L-l-0 L-l-0 C-m-1 C-m-1 C-m-1 C-m-2 
job-1324,1,8,5,66308,66308,66436,0,128,66490,true,L-m-0 L-m-0 L-m-0 L-l-0 L-l-0 
job-1326,2,7,2,66408,66408,66444,0,36,66444,false,L-l-0 C-m-0 
job-1323,5,11,3,66253,66253,66471,0,218,66637,true,C-m-0 C-l-1 C-l-1 
job-1325,2,6,5,66363,66363,66496,0,133,66735,true,L-m-0 L-l-0 L-l-0 L-l-0 L-l-0 
job-1328,1,8,6,66489,66489,66523,0,34,66729,true,C-m-0 C-m-0 C-l-1 C-l-1 C-l-1 C-l-1 
job-1327,2,12,7,66461,66461,66551,0,90,66823,true,L-m-0 L-m-0 L-l-0 L-l-0 C-m-0 C-l-1 L-s-0 
job-1329,6,7,7,66546,66546,66687,0,141,66693,true,L-l-0 C-m-0 C-l-1 C-m-1 C-m-2 C-l-2 C-l-2 
job-1330,5,8,6,66606,66687,66729,81,42,66876,true,L-m-0 L-l-0 L-l-0 C-m-0 C-m-1 C-m-2 
job-1331,6,4,6,66645,66687,66745,42,58,66918,true,C-l-2 C-l-2 C-l-1 C-l-1 C-l-0 C-l-0 
job-1334,6,6,8,66777,66777,66788,0,11,66892,true,L-l-0 L-l-0 C-m-0 C-m-1 C-m-2 C-l-2 C-l-2 C-l-1 
job-1332,2,4,1,66690,66690,66833,0,143,66945,true,L-m-0 
job-1333,2,6,5,66736,66736,66852,0,116,67130,true,L-m-0 L-m-0 L-m-0 L-s-0 L-s-0 
job-1335,4,6,1,66820,66820,66933,0,113,66971,true,L-l-0 
job-1336,1,5,5,66876,66876,66946,0,70,67086,true,L-l-0 L-l-0 L-l-0 L-l-0 L-l-0 
job-1338,1,10,8,66990,66990,67022,0,32,67096,true,L-m-0 L-m-0 L-l-0 L-l-0 L-l-0 L-l-0 C-s-2 C-s-0 
job-1337,3,7,3,66930,66930,67048,0,118,67143,true,L-l-0 L-s-0 L-m-0 
job-1339,1,6,8,67043,67043,67187,0,144,67345,true,L-s-0 L-m-0 L-m-0 L-m-0 L-m-0 L-l-0 L-l-0 L-l-0 
job-1340,6,11,6,67089,67089,67213,0,124,67288,true,L-l-0 C-m-0 C-m-1 C-m-2 C-l-2 C-l-2 
job-1341,2,12,8,67138,67138,67267,0,129,67346,true,L-l-0 C-m-0 C-m-1 C-m-2 C-s-2 C-s-0 C-s-1 C-l-1 
job-1343,3,5,5,67247,67247,67290,0,43,67509,true,L-l-0 L-l-0 L-l-0 C-m-0 C-m-0 
job-1342,6,5,3,67197,67197,67294,0,97,67486,true,C-l-1 L-m-0 C-l-0 
job-1344,5,7,8,67282,67290,67301,8,11,67496,true,C-l-1 C-l-0 L-l-0 L-l-0 C-m-0 C-m-1 C-m-2 C-l-2 
job-1345,4,5,3,67333,67333,67359,0,26,67552,true,L-s-0 L-m-0 L-m-0 
job-1346,6,12,2,67379,67379,67395,0,16,67565,true,L-m-0 L-l-0 
job-1347,3,11,5,67427,67427,67459,0,32,67721,true,L-s-0 L-m-0 L-m-0 L-l-0 L-l-0 
job-1348,6,7,7,67483,67483,67505,0,22,67765,true,L-m-0 L-l-0 L-l-0 C-m-0 C-m-1 C-m-2 C-l-1 
job-1349,2,9,1,67538,67538,67692,0,154,67802,true,L-s-0 
job-1352,5,8,6,67690,67690,67747,0,57,68019,true,C-m-0 C-m-1 C-m-2 C-l-1 C-l-1 C-l-0 
job-1350,2,12,3,67598,67598,67841,0,243,68014,true,L-m-0 L-m-0 L-l-0 
job-1354,1,12,8,67777,67777,67844,0,67,68072,true,L-l-0 C-m-0 C-m-0 C-m-1 C-m-1 C-m-2 C-m-2 L-s-0 
job-1357,4,6,3,67931,67931,67970,0,39,68105,true,C-m-1 C-m-2 L-s-0 
job-1351,4,8,4,67652,67652,67979,0,327,68213,true,L-m-0 L-l-0 L-l-0 C-s-2 
job-1356,1,7,7,67891,67891,68012,0,121,68145,true,L-l-0 L-l-0 L-l-0 L-l-0 C-m-0 C-m-0 C-m-0 
job-1358,1,11,7,67974,67974,68104,0,130,68146,true,C-m-1 C-m-1 C-m-2 C-m-2 L-s-0 C-s-0 C-s-1 
job-1353,3,8,3,67738,67738,68173,0,435,68263,true,C-m-0 C-m-1 C-m-2 
job-1360,1,4,3,68099,68099,68178,0,79,68340,true,L-s-0 L-m-0 L-m-0 
job-1359,5,12,7,68046,68046,68196,0,150,68381,true,C-m-0 L-l-0 L-l-0 C-l-1 C-l-1 C-l-0 C-l-0 
job-1355,4,9,1,67844,67844,68231,0,387,68381,true,L-m-0 
job-1362,2,9,6,68185,68196,68237,11,41,68523,true,L-m-0 L-m-0 L-l-0 C-m-0 C-m-1 C-m-2 
job-1363,3,5,6,68219,68219,68255,0,36,68299,true,C-l-0 C-l-0 L-s-0 C-s-0 C-s-1 C-s-2 
job-1361,5,6,8,68146,68196,68284,50,88,68434,true,L-l-0 L-l-0 C-m-0 C-m-1 C-m-2 C-l-1 C-l-1 C-l-0 
job-1364,1,8,8,68265,68265,68295,0,30,68337,true,L-l-0 L-l-0 C-m-0 C-m-0 C-m-0 C-m-1 C-m-1 C-m-1 
job-1365,5,4,1,68312,68312,68349,0,37,68371,true,L-m-0 
job-1367,3,5,5,68394,68394,68535,0,141,68633,true,L-m-0 C-m-0 L-s-0 C-s-0 C-s-1 
job-1369,3,7,1,68492,68492,68562,0,70,68851,true,C-l-0 
job-1366,5,10,4,68358,68358,68564,0,206,68707,true,L-m-0 L-l-0 L-l-0 C-m-0 
job-1368,6,11,5,68448,68448,68583,0,135,68817,true,C-m-1 C-m-2 C-l-1 C-l-1 C-l-0 
job-1372,4,6,1,68643,68643,68662,0,19,68907,true,C-l-0 
job-1371,6,9,6,68582,68582,68664,0,82,68766,true,L-m-0 C-l-0 L-l-0 L-l-0 C-m-0 C-l-2 
job-1370,1,4,2,68539,68539,68732,0,193,68812,true,L-m-0 L-m-0 
job-1374,2,5,5,68741,68741,68828,0,87,68901,true,L-m-0 L-s-0 L-s-0 L-l-0 L-l-0 
job-1375,4,6,6,68786,68786,68872,0,86,68906,true,L-l-0 L-l-0 C-s-0 C-s-1 C-s-2 C-m-0 
job-1373,6,9,1,68692,68692,68875,0,183,69134,true,L-m-0 
job-1376,3,10,5,68843,68843,68888,0,45,68983,true,L-l-0 C-m-0 L-s-0 C-m-1 C-m-1 
job-1377,4,5,2,68891,68891,68951,0,60,69177,true,L-s-0 L-m-0 
job-1380,6,6,1,69016,69016,69030,0,14,69319,true,C-m-0 
job-1379,1,11,7,68972,68972,69052,0,80,69209,true,L-m-0 L-s-0 L-l-0 L-l-0 L-l-0 L-l-0 C-s-0 
job-1378,3,11,1,68928,68928,69099,0,171,69200,true,L-m-0 
job-1381,5,10,7,69068,69068,69134,0,66,69295,true,L-m-0 L-l-0 L-l-0 C-m-0 C-m-1 C-m-2 C-l-0 
job-1382,3,5,8,69140,69140,69169,0,29,69200,true,L-s-0 L-m-0 L-m-0 L-l-0 L-l-0 L-l-0 L-l-0 C-s-0 
job-1383,3,8,5,69188,69188,69216,0,28,69473,true,L-s-0 L-m-0 L-m-0 L-l-0 L-l-0 
job-1386,6,4,3,69323,69323,69337,0,14,69374,true,C-l-0 C-l-2 C-l-2 
job-1384,6,6,4,69233,69233,69342,0,109,69591,true,L-m-0 L-l-0 L-l-0 C-m-0 
job-1388,6,9,6,69427,69427,69449,0,22,69504,true,C-l-0 L-m-0 L-l-0 L-l-0 C-m-0 C-l-2 
job-1387,1,10,3,69376,69376,69469,0,93,69742,true,C-m-1 C-m-1 C-m-2 
job-1389,2,11,7,69480,69480,69533,0,53,69611,true,C-m-1 C-m-2 C-l-0 C-l-0 C-l-0 L-s-0 L-m-0 
job-1385,5,6,3,69279,69279,69611,0,332,69750,true,C-m-1 C-m-2 C-l-0 
job-1391,1,6,2,69570,69570,69659,0,89,69678,true,L-m-0 L-m-0 
job-1392,5,8,6,69626,69626,69662,0,36,69679,true,L-m-0 L-l-0 L-l-0 C-m-1 C-m-2 C-m-0 
job-1390,1,12,5,69524,69524,69728,0,204,69998,true,L-m-0 C-m-1 C-m-2 L-l-0 L-l-0 
job-1393,5,10,4,69679,69679,69728,0,49,69936,true,L-m-0 L-l-0 L-l-0 C-m-1 
job-1395,1,6,7,69778,69778,69796,0,18,70070,true,C-m-2 C-m-2 C-m-2 L-m-0 L-m-0 L-m-0 L-m-0 
job-1394,4,11,4,69717,69717,69847,0,130,70107,true,C-m-2 L-s-0 C-s-0 C-s-1 
job-1398,2,8,1,69932,69932,69956,0,24,70009,true,L-l-0 
job-1397,3,9,8,69878,69878,70026,0,148,70218,true,L-m-0 C-m-1 C-m-0 L-s-0 C-s-0 C-s-1 C-s-2 C-m-2 
job-1396,5,11,7,69838,69838,70042,0,204,70323,true,L-m-0 L-l-0 L-l-0 C-m-1 C-m-0 C-l-0 C-l-0 
job-1400,3,4,4,70032,70032,70047,0,15,70141,true,L-m-0 C-m-1 C-m-0 C-m-2 
job-1402,2,12,5,70127,70127,70171,0,44,70251,true,L-m-0 C-l-1 L-l-0 L-l-0 L-l-0 
job-1404,5,12,6,70227,70227,70246,0,19,70433,true,L-l-0 L-l-0 C-m-1 C-m-0 C-l-0 C-l-0 
job-1401,3,12,5,70091,70091,70265,0,174,70334,true,C-m-2 C-l-1 C-l-1 L-s-0 L-m-0 
job-1399,4,12,5,69980,69980,70326,0,346,70390,true,C-m-2 C-l-2 C-l-2 C-l-2 C-l-1 
job-1403,5,7,1,70178,70178,70335,0,157,70539,true,L-m-0 
job-1407,5,11,5,70362,70362,70397,0,35,70621,true,L-m-0 C-m-2 C-m-1 C-m-0 C-l-2 
job-1405,6,4,3,70276,70276,70418,0,142,70466,true,C-l-1 L-l-0 L-l-0 
job-1408,6,10,5,70421,70421,70447,0,26,70516,true,C-l-1 L-m-0 L-l-0 L-l-0 C-m-2 
job-1409,3,4,1,70472,70472,70518,0,46,70599,true,C-l-1 
job-1406,4,9,3,70326,70326,70566,0,240,70850,true,C-l-1 L-s-0 C-s-0 
job-1411,2,8,6,70561,70561,70613,0,52,70616,true,L-m-0 C-l-1 C-s-1 C-s-1 C-s-2 C-s-2 
job-1413,5,12,2,70654,70654,70689,0,35,70867,true,C-m-0 C-l-2 
job-1412,4,12,7,70612,70612,70776,0,164,71052,true,C-l-1 L-s-0 C-s-0 C-m-2 C-m-2 C-m-1 C-m-1 
job-1410,3,11,8,70522,70522,70778,0,256,70793,true,C-l-1 C-l-1 L-m-0 L-m-0 L-l-0 L-l-0 L-l-0 L-l-0 
job-1414,6,6,3,70699,70699,70860,0,161,70884,true,C-m-0 C-l-2 C-l-2 
job-1416,5,5,2,70796,70796,70919,0,123,70920,true,L-m-0 L-l-0 
job-1418,1,8,8,70907,70907,70931,0,24,71144,true,L-l-0 C-s-0 C-s-0 C-m-0 C-m-0 C-m-0 C-m-0 C-m-2 
job-1420,1,9,7,71014,71014,71050,0,36,71154,true,L-m-0 L-m-0 C-s-0 C-m-0 C-m-0 C-m-0 C-m-2 
job-1415,4,7,5,70746,70746,71081,0,335,71344,true,C-s-1 C-s-2 C-l-0 C-l-0 C-l-0 
job-1419,3,4,3,70959,70959,71119,0,160,71350,true,L-m-0 L-l-0 L-l-0 
job-1417,3,10,4,70856,70856,71144,0,288,71330,true,L-m-0 L-l-0 L-l-0 L-s-0 
job-1421,5,11,8,71062,71081,71265,19,184,71317,true,C-m-0 C-m-2 C-m-1 C-l-0 C-l-0 C-l-2 C-l-2 C-l-1 
job-1423,4,6,2,71159,71265,71278,106,13,71173,false,L-s-0 C-s-1 
job-1424,2,6,5,71212,71265,71320,53,55,71358,true,L-m-0 C-m-0 C-m-2 C-m-1 C-s-2 
job-1425,3,4,5,71260,71265,71339,5,74,71541,true,C-s-0 C-l-2 C-l-2 C-l-2 C-l-2 
job-1426,6,8,3,71313,71339,71357,26,18,71548,true,C-l-2 C-l-2 C-l-1 
job-1422,6,9,8,71109,71265,71394,156,129,71498,true,L-m-0 L-l-0 L-l-0 C-m-0 C-m-2 C-m-1 C-l-0 C-l-0 
job-1427,6,7,6,71373,71394,71423,21,29,71689,true,L-m-0 L-l-0 L-l-0 C-m-0 C-m-2 C-m-1 
job-1428,5,5,1,71421,71421,71485,0,64,71541,true,C-l-0 
job-1429,2,6,2,71467,71467,71537,0,70,71718,true,C-l-0 C-l-0 
job-1430,3,6,3,71512,71512,71627,0,115,71696,true,C-l-0 C-l-0 L-s-0 
job-1431,1,6,6,71565,71565,71705,0,140,71822,true,L-s-0 C-l-0 C-l-0 C-l-0 C-l-0 C-l-0 
job-1433,5,8,3,71675,71675,71798,0,123,71993,true,C-l-0 C-m-0 C-m-2 
job-1434,3,6,6,71720,71720,71832,0,112,71967,true,L-l-0 C-m-0 C-m-2 C-l-0 C-l-0 L-s-0 
job-1432,3,4,5,71620,71620,71841,0,221,71906,true,L-m-0 L-m-0 L-l-0 L-l-0 L-l-0 
job-1437,1,12,2,71901,71901,71989,0,88,72093,true,C-m-0 C-m-0 
job-1435,4,12,1,71768,71768,71992,0,224,72033,true,C-s-0 
job-1436,6,7,7,71836,71836,72002,0,166,72253,true,C-m-0 C-m-2 C-m-1 C-l-0 C-l-0 C-l-2 C-l-2 
job-1439,4,11,8,71992,71992,72059,0,67,72336,true,L-m-0 L-l-0 L-l-0 L-l-0 C-s-0 C-s-2 C-s-1 C-l-1 
job-1438,1,12,6,71945,71945,72091,0,146,72369,true,C-m-2 C-m-2 C-m-1 C-m-1 L-s-0 L-m-0 
job-1441,3,11,8,72093,72093,72164,0,71,72235,true,L-m-0 C-m-2 C-m-1 C-l-1 C-l-1 C-l-1 L-s-0 L-l-0 
job-1440,3,8,4,72042,72042,72228,0,186,72446,true,L-m-0 C-m-2 C-m-1 C-l-1 
job-1443,5,4,5,72199,72199,72268,0,69,72367,true,L-m-0 L-l-0 C-m-2 C-m-1 C-l-2 
job-1442,6,9,5,72153,72153,72269,0,116,72285,true,L-l-0 C-m-0 C-l-0 C-l-0 C-l-2 
job-1444,6,10,7,72249,72268,72290,19,22,72316,true,L-l-0 C-l-2 L-m-0 C-m-2 C-m-1 C-l-1 C-l-1 
job-1445,5,12,6,72294,72294,72365,0,71,72427,true,L-m-0 L-l-0 L-l-0 C-m-0 C-m-2 C-m-1 
job-1447,4,4,1,72392,72392,72480,0,88,72527,true,L-m-0 
job-1448,2,10,5,72442,72442,72514,0,72,72745,true,L-m-0 L-m-0 L-l-0 L-l-0 L-l-0 
job-1446,4,10,2,72345,72345,72571,0,226,72651,true,L-s-0 C-s-0 
job-1449,2,5,5,72484,72484,72603,0,119,72715,true,L-m-0 L-m-0 L-l-0 L-l-0 L-l-0 
job-1451,2,11,2,72567,72567,72609,0,42,72740,true,L-m-0 L-m-0 
job-1452,5,11,4,72616,72616,72694,0,78,72925,true,L-l-0 L-m-0 C-l-2 C-l-2 
job-1450,6,5,6,72528,72528,72719,0,191,72798,true,L-l-0 C-m-0 C-m-2 C-m-1 C-l-0 C-l-0 
job-1454,3,11,5,72702,72702,72785,0,83,72926,true,L-l-0 L-l-0 L-s-0 L-m-0 L-m-0 
job-1453,6,8,2,72653,72653,72797,0,144,72971,true,C-l-1 C-l-1 
job-1455,1,4,4,72751,72751,72810,0,59,73003,true,L-s-0 L-m-0 L-m-0 L-l-0 
job-1456,5,7,3,72803,72803,72818,0,15,73060,true,L-m-0 L-l-0 L-l-0 
job-1457,6,4,5,72862,72862,72889,0,27,73021,true,L-m-0 L-l-0 L-l-0 C-m-0 C-m-2 
job-1460,4,4,6,73009,73009,73035,0,26,73307,true,L-m-0 C-l-0 C-s-0 C-s-2 C-s-1 C-l-2 
job-1458,4,11,2,72918,72918,73038,0,120,73171,true,L-s-0 L-m-0 
job-1461,5,12,4,73054,73054,73160,0,106,73272,true,C-l-0 L-m-0 C-l-2 C-l-2 
job-1459,6,6,8,72971,72971,73195,0,224,73402,true,L-l-0 L-l-0 C-m-0 C-m-2 C-m-1 C-l-1 C-l-1 C-l-0 
job-1464,5,8,3,73197,73197,73231,0,34,73250,true,C-m-0 C-m-2 C-l-0 
job-1465,4,10,1,73238,73238,73272,0,34,73276,true,C-m-0 
job-1466,3,8,6,73294,73294,73356,0,62,73361,true,C-m-0 C-m-0 C-m-2 C-m-2 C-l-0 C-l-0 
job-1462,6,6,3,73105,73160,73379,55,219,73428,true,C-l-0 L-m-0 C-l-2 
job-1467,2,12,5,73338,73338,73408,0,70,73620,true,C-l-2 C-l-2 C-l-2 L-s-0 L-l-0 
job-1468,2,6,3,73379,73379,73437,0,58,73662,true,L-m-0 L-m-0 L-m-0 
job-1469,1,9,8,73430,73430,73461,0,31,73512,true,C-m-0 C-m-0 C-m-2 C-m-2 L-s-0 L-l-0 L-l-0 L-l-0 
job-1463,2,9,3,73152,73160,73530,8,370,73759,true,L-m-0 C-m-0 C-m-2 
job-1470,6,12,4,73480,73480,73686,0,206,73832,true,L-m-0 C-m-0 C-m-2 L-l-0 
job-1472,6,11,6,73581,73686,73698,105,12,73822,true,L-l-0 C-l-2 L-m-0 C-m-0 C-m-2 C-l-0 
job-1473,5,12,1,73633,73686,73707,53,21,73746,true,C-l-0 
job-1474,6,12,6,73679,73698,73715,19,17,73935,true,L-l-0 C-l-0 C-l-2 L-m-0 C-m-0 C-m-2 
job-1475,1,4,8,73735,73735,73768,0,33,74006,true,L-l-0 L-l-0 L-l-0 L-l-0 L-l-0 L-l-0 L-l-0 C-m-1 
job-1471,5,10,3,73533,73533,73829,0,296,73949,true,L-l-0 C-m-1 C-l-2 
job-1477,6,10,3,73822,73822,73876,0,54,73949,true,C-l-2 L-m-0 C-m-0 
job-1478,6,12,7,73868,73868,73882,0,14,74163,true,L-l-0 C-m-1 C-l-2 C-m-2 C-l-0 C-l-0 C-l-1 
job-1476,1,10,4,73786,73786,73883,0,97,73896,true,L-l-0 L-l-0 L-l-0 C-m-1 
job-1480,4,4,3,73954,73954,74033,0,79,74165,true,L-s-0 C-s-0 C-s-2 
job-1479,6,4,8,73915,73915,74076,0,161,74222,true,L-m-0 L-l-0 L-l-0 C-m-0 C-m-1 C-m-2 C-l-2 C-l-2 
job-1483,2,8,6,74115,74115,74159,0,44,74260,true,L-m-0 L-l-0 C-m-0 C-m-1 C-l-2 C-l-2 
job-1482,4,12,6,74053,74076,74207,23,131,74236,true,L-s-0 C-s-0 C-s-2 C-s-1 C-m-2 C-m-2 
job-1484,3,7,5,74157,74157,74247,0,90,74388,true,C-l-2 C-l-2 C-l-0 C-l-0 C-l-0 
job-1485,6,12,3,74206,74206,74368,0,162,74404,true,C-l-2 C-l-1 C-l-1 
job-1486,2,6,3,74256,74256,74391,0,135,74600,true,L-m-0 L-l-0 C-m-0 
job-1487,6,10,7,74306,74368,74398,62,30,74599,true,C-m-2 C-l-1 C-l-1 C-l-2 C-l-2 C-l-0 C-l-0 
job-1481,5,4,5,74002,74076,74456,74,380,74626,true,L-m-0 L-l-0 L-l-0 C-m-0 C-m-1 
job-1488,5,10,1,74357,74398,74466,41,68,74474,true,C-m-2 
job-1489,5,8,8,74416,74456,74502,40,46,74638,true,L-m-0 L-l-0 L-l-0 C-m-0 C-m-1 C-l-1 C-l-1 C-l-2 
job-1491,6,11,3,74489,74489,74527,0,38,74764,true,C-l-2 C-m-2 C-l-0 
job-1490,2,9,1,74460,74460,74596,0,136,74739,true,L-m-0 
job-1495,4,7,4,74691,74691,74702,0,11,74893,true,C-m-0 C-m-0 C-m-1 C-m-1 
job-1494,4,7,4,74644,74644,74727,0,83,74884,true,L-l-0 C-s-0 C-s-2 C-s-1 
job-1496,6,11,2,74733,74733,74824,0,91,74943,true,L-l-0 C-m-0 
job-1497,6,5,6,74772,74772,74847,0,75,74902,true,C-m-1 C-m-2 C-l-1 C-l-1 C-l-2 C-l-2 
job-1493,2,9,5,74588,74588,74854,0,266,75147,true,L-m-0 L-s-0 L-l-0 L-l-0 L-l-0 
job-1498,1,11,4,74816,74816,74882,0,66,75003,true,L-m-0 C-m-0 C-m-1 C-m-1 
job-1492,2,5,2,74536,74536,74887,0,351,74923,true,L-m-0 L-m-0 
job-1501,1,12,2,74984,74984,75017,0,33,75193,true,L-m-0 L-l-0 
job-1499,2,5,2,74872,74872,75020,0,148,75238,true,L-m-0 C-m-1 
job-1500,5,11,5,74917,74917,75101,0,184,75107,true,L-m-0 C-m-1 L-l-0 L-l-0 C-m-0 
job-1502,6,7,4,75025,75025,75174,0,149,75267,true,C-m-2 C-l-1 C-l-1 C-l-2 
job-1504,2,8,7,75130,75130,75228,0,98,75351,true,L-m-0 L-m-0 C-m-2 C-m-1 C-m-1 C-m-0 C-m-0 
job-1506,4,5,4,75236,75236,75255,0,19,75344,true,L-m-0 C-m-2 C-m-1 C-m-0 
job-1505,2,8,2,75179,75179,75278,0,99,75397,true,C-m-2 C-m-2 
job-1507,6,4,4,75286,75286,75346,0,60,75390,true,C-l-2 L-l-0 L-l-0 C-m-2 
job-1508,5,5,2,75334,75334,75353,0,19,75413,true,L-m-0 C-m-1 
job-1510,5,8,2,75420,75420,75435,0,15,75477,true,C-m-1 C-m-0 
job-1503,3,8,4,75089,75089,75440,0,351,75561,true,L-m-0 C-m-1 C-m-0 C-l-2 
job-1509,1,11,2,75383,75383,75458,0,75,75635,true,L-m-0 L-m-0 
job-1512,1,11,1,75510,75510,75555,0,45,75854,true,L-m-0 
job-1511,5,8,8,75467,75467,75617,0,150,75900,true,L-m-0 L-l-0 L-l-0 C-m-1 C-m-0 C-m-2 C-l-2 C-l-2 
job-1514,1,6,2,75620,75620,75668,0,48,75711,true,L-m-0 L-s-0 
job-1513,1,12,2,75563,75563,75834,0,271,76084,true,L-m-0 L-m-0 
job-1515,4,9,8,75678,75678,75886,0,208,76060,true,L-s-0 L-l-0 L-l-0 L-l-0 C-s-0 C-s-2 C-s-1 C-m-1 
job-1516,4,9,3,75725,75725,75887,0,162,76136,true,C-m-1 C-m-0 C-m-0 
job-1520,1,5,3,75934,75934,75977,0,43,76155,true,L-m-0 L-m-0 L-m-0 
job-1518,2,6,7,75832,75832,75982,0,150,76093,true,C-l-2 C-l-2 C-l-1 C-l-1 C-l-1 C-l-1 C-l-1 
job-1519,6,7,2,75880,75880,76003,0,123,76115,true,C-l-0 C-l-0 
job-1521,4,8,1,75988,75988,76014,0,26,76044,true,L-m-0 
job-1517,4,6,5,75780,75780,76017,0,237,76069,true,L-m-0 C-m-2 C-m-2 C-l-2 C-l-2 
job-1522,5,12,1,76050,76050,76138,0,88,76166,true,L-m-0 
job-1525,5,10,2,76196,76196,76225,0,29,76386,true,L-m-0 C-l-1 
job-1523,5,5,8,76093,76093,76270,0,177,76292,true,L-l-0 L-l-0 C-m-2 C-m-1 C-m-0 C-l-0 C-l-0 C-l-2 
job-1526,5,7,8,76242,76270,76283,28,13,76551,true,C-l-2 L-m-0 L-l-0 L-l-0 C-m-2 C-m-1 C-m-0 C-l-0 
job-1527,1,6,2,76302,76302,76343,0,41,76478,true,C-l-2 C-l-2 
job-1528,6,11,4,76349,76349,76366,0,17,76568,true,C-l-2 L-m-0 L-l-0 L-l-0 
job-1524,6,7,1,76146,76146,76378,0,232,76603,true,C-l-2 
job-1531,3,7,3,76509,76509,76549,0,40,76715,true,C-s-1 C-m-2 C-m-2 
job-1532,6,11,7,76557,76557,76591,0,34,76600,true,C-m-2 C-m-1 C-m-0 C-l-2 C-l-2 C-l-0 C-l-0 
job-1530,3,10,8,76457,76457,76632,0,175,76727,true,L-m-0 L-s-0 L-l-0 L-l-0 L-l-0 L-l-0 C-s-0 C-s-2 
job-1533,5,7,4,76606,76606,76638,0,32,76922,true,C-m-2 C-m-1 C-m-0 C-l-2 
job-1529,5,9,1,76402,76402,76644,0,242,76705,true,L-m-0 
job-1534,6,11,3,76653,76653,76671,0,18,76813,true,L-m-0 L-l-0 L-l-0 
job-1535,3,10,4,76708,76708,76744,0,36,76986,true,L-s-0 L-m-0 L-m-0 L-l-0 
job-1536,5,4,2,76755,76755,76772,0,17,76939,true,L-m-0 L-l-0 
job-1537,3,12,3,76806,76806,76817,0,11,76869,true,L-s-0 L-m-0 L-m-0 
job-1538,2,4,5,76845,76845,76864,0,19,77157,true,L-s-0 L-s-0 L-m-0 L-m-0 L-m-0 
job-1539,5,5,1,76903,76903,76948,0,45,77068,true,L-m-0 
job-1540,3,9,7,76943,76943,77074,0,131,77211,true,L-m-0 L-s-0 L-l-0 L-l-0 L-l-0 L-l-0 C-s-0 
job-1541,4,7,1,76994,76994,77075,0,81,77364,true,L-m-0 
job-1542,1,11,6,77059,77059,77174,0,115,77343,true,L-m-0 C-s-2 C-s-1 C-m-2 C-m-2 C-m-1 
job-1543,5,4,4,77113,77113,77209,0,96,77480,true,L-m-0 C-m-2 C-m-1 L-l-0 
job-1544,1,12,4,77151,77151,77282,0,131,77543,true,L-m-0 L-l-0 L-l-0 L-l-0 
job-1546,4,10,4,77266,77266,77307,0,41,77400,true,C-m-2 C-m-2 C-m-1 C-m-1 
job-1547,4,6,5,77302,77302,77325,0,23,77611,true,L-l-0 L-l-0 C-m-0 C-m-0 C-l-2 
job-1545,3,9,7,77210,77210,77364,0,154,77599,true,L-m-0 L-m-0 L-l-0 L-s-0 C-s-2 C-s-1 C-s-0 
job-1548,5,6,8,77341,77341,77384,0,43,77639,true,L-l-0 C-m-2 C-m-1 C-m-0 C-l-2 C-l-2 C-l-0 C-l-0 
job-1550,3,5,2,77434,77434,77444,0,10,77447,true,L-l-0 L-l-0 
job-1549,3,11,6,77379,77379,77511,0,132,77758,true,L-l-0 L-l-0 C-m-2 C-m-1 C-m-0 L-s-0 
job-1551,5,5,1,77491,77491,77539,0,48,77710,true,L-l-0 
job-1554,1,5,2,77627,77627,77639,0,12,77926,true,L-m-0 L-l-0 
job-1553,1,12,8,77578,77578,77676,0,98,77867,true,L-m-0 L-l-0 L-l-0 C-s-2 C-s-1 C-s-0 C-m-2 C-m-2 
job-1556,4,9,3,77712,77712,77763,0,51,77968,true,L-m-0 C-s-2 C-s-1 
job-1552,2,6,7,77535,77535,77798,0,263,77899,true,L-l-0 L-l-0 L-l-0 L-s-0 L-s-0 L-m-0 L-m-0 
job-1555,4,6,1,77669,77669,77824,0,155,78049,true,L-l-0 
job-1557,3,9,3,77788,77788,77903,0,115,78023,true,L-m-0 C-s-2 C-s-1 
job-1559,3,5,7,77889,77889,77922,0,33,78132,true,C-m-2 C-m-2 C-m-1 C-m-1 C-m-0 C-m-0 C-l-2 
job-1558,3,7,7,77832,77832,77964,0,132,78175,true,L-m-0 L-s-0 L-l-0 L-l-0 L-l-0 L-l-0 C-s-0 
job-1561,6,9,6,77976,77976,78046,0,70,78195,true,L-l-0 L-l-0 C-m-2 C-m-1 C-m-0 C-l-2 
job-1562,1,12,7,78034,78034,78062,0,28,78222,true,L-m-0 C-m-2 C-m-1 C-m-0 C-l-2 C-l-2 C-l-2 
job-1564,1,10,8,78123,78123,78160,0,37,78215,true,C-s-2 C-s-0 C-s-1 C-m-2 C-m-2 C-m-2 C-m-1 C-m-1 
job-1563,4,8,5,78081,78081,78188,0,107,78361,true,L-m-0 L-s-0 L-l-0 L-l-0 L-l-0 
job-1565,2,7,4,78176,78176,78220,0,44,78410,true,C-s-2 C-s-0 C-s-0 C-s-1 
job-1560,2,5,3,77934,77934,78352,0,418,78539,true,L-m-0 L-m-0 C-s-2 
job-1568,2,4,7,78325,78325,78388,0,63,78633,true,L-l-0 L-l-0 L-l-0 C-s-0 C-s-0 C-s-1 C-s-1 
job-1569,2,9,2,78380,78380,78394,0,14,78606,true,L-m-0 L-m-0 
job-1566,1,10,1,78219,78219,78421,0,202,78499,true,L-m-0 
job-1567,2,4,7,78270,78270,78439,0,169,78551,true,L-m-0 C-s-2 L-s-0 L-s-0 L-l-0 L-l-0 L-l-0 
job-1571,4,5,7,78485,78485,78522,0,37,78616,true,L-m-0 L-l-0 L-l-0 L-s-0 C-s-2 C-m-0 C-m-0 
job-1573,5,9,6,78571,78571,78595,0,24,78713,true,L-l-0 C-l-2 C-l-2 C-m-0 C-l-0 C-l-0 
job-1574,2,11,7,78608,78608,78668,0,60,78802,true,L-m-0 L-m-0 L-l-0 L-l-0 L-l-0 C-l-2 C-l-2 
job-1570,4,7,8,78433,78433,78670,0,237,78957,true,L-m-0 L-l-0 C-s-0 C-s-1 C-m-2 C-m-2 C-m-1 C-m-1 
job-1575,3,9,6,78648,78648,78783,0,135,78936,true,C-l-2 C-l-2 L-s-0 C-s-2 C-m-0 C-m-0 
job-1572,2,5,1,78521,78521,78947,0,426,79155,true,C-l-2 
job-1578,3,9,7,78803,78803,78977,0,174,79106,true,L-l-0 C-l-1 C-l-1 L-s-0 C-s-2 C-s-0 C-s-1 
job-1576,3,9,4,78702,78702,78995,0,293,79033,true,C-l-2 L-m-0 L-m-0 L-l-0 
job-1577,6,9,8,78759,78783,79090,24,307,79101,true,L-l-0 C-l-2 C-m-0 C-m-2 C-m-1 C-l-0 C-l-0 C-l-1 
job-1579,6,10,7,78855,79090,79104,235,14,78989,false,L-m-0 L-l-0 L-l-0 C-m-0 C-m-2 C-m-1 C-l-0 
job-1580,3,8,4,78905,79090,79141,185,51,78980,false,C-l-0 C-l-0 L-s-0 C-s-2 
job-1583,4,7,5,79042,79104,79160,62,56,79355,true,C-l-0 L-m-0 L-m-0 L-l-0 L-l-0 
job-1581,4,8,6,78960,79090,79188,130,98,79291,true,C-s-0 C-s-1 C-l-2 C-l-2 C-l-2 C-l-1 
job-1582,4,6,2,78999,79090,79200,91,110,79287,true,C-l-1 C-l-1 
job-1585,5,7,6,79144,79160,79204,16,44,79230,true,L-m-0 L-l-0 L-l-0 C-m-2 C-m-1 C-l-0 
job-1584,5,12,1,79087,79104,79241,17,137,79295,true,C-m-0 
job-1587,3,4,6,79267,79267,79310,0,43,79597,true,C-l-1 C-l-1 L-s-0 C-s-0 C-s-1 C-s-2 
job-1589,3,5,4,79353,79353,79400,0,47,79493,true,C-s-0 C-s-1 C-s-2 C-m-0 
job-1588,3,5,3,79311,79311,79439,0,128,79499,true,C-l-1 C-l-1 L-s-0 
job-1586,6,11,8,79206,79206,79454,0,248,79463,true,L-m-0 L-l-0 L-l-0 C-m-2 C-m-1 C-l-2 C-l-2 C-l-1 
job-1590,5,5,8,79418,79454,79522,36,68,79585,true,L-m-0 L-l-0 L-l-0 C-m-2 C-m-1 C-m-0 C-l-2 C-l-2 
job-1592,2,11,1,79525,79525,79567,0,42,79573,true,L-m-0 
job-1594,2,11,2,79627,79627,79642,0,15,79761,true,L-l-0 C-s-0 
job-1593,3,7,4,79582,79582,79686,0,104,79690,true,L-m-0 C-m-2 C-m-1 L-s-0 
job-1595,4,11,6,79686,79686,79733,0,47,79823,true,L-s-0 C-s-0 C-s-1 C-s-2 C-m-0 C-m-0 
job-1596,1,7,6,79741,79741,79795,0,54,80070,true,L-m-0 L-m-0 L-m-0 L-l-0 L-l-0 C-m-2 
job-1591,5,9,5,79475,79522,79805,47,283,79842,true,L-m-0 L-l-0 L-l-0 C-m-2 C-m-1 
job-1597,2,12,7,79781,79781,79929,0,148,80188,true,C-m-2 C-m-1 L-s-0 C-s-0 C-s-1 C-s-2 C-m-0 
job-1598,4,10,8,79831,79831,79962,0,131,80210,true,C-m-2 C-m-1 C-m-0 L-m-0 L-m-0 L-l-0 L-l-0 L-l-0 
job-1599,5,8,4,79879,79879,79977,0,98,79978,true,C-l-2 C-l-2 C-l-1 C-l-1 
job-1601,2,10,2,79970,79970,80017,0,47,80104,true,C-m-2 C-m-2 
job-1600,4,4,8,79921,79929,80030,8,101,80253,true,C-m-2 C-m-1 C-m-0 L-s-0 C-s-0 C-s-1 C-s-2 C-l-0 
job-1602,3,6,4,80023,80023,80093,0,70,80221,true,C-m-2 C-m-1 C-m-0 C-l-0 
job-1604,3,4,2,80125,80125,80143,0,18,80245,true,C-m-2 C-m-1 
job-1603,2,8,5,80074,80074,80183,0,109,80250,true,C-m-2 C-m-2 C-m-1 C-m-1 C-m-0 
job-1605,3,7,8,80166,80166,80186,0,20,80449,true,C-m-2 C-m-1 C-m-0 C-m-0 L-s-0 L-m-0 L-m-0 L-l-0 
job-1608,4,5,2,80315,80315,80398,0,83,80570,true,C-s-1 C-s-2 
job-1609,5,8,2,80369,80369,80436,0,67,80697,true,C-m-2 C-m-1 
job-1606,3,8,8,80221,80221,80439,0,218,80489,true,L-s-0 L-m-0 L-m-0 L-l-0 L-l-0 L-l-0 L-l-0 C-s-0 
job-1607,1,6,3,80263,80263,80456,0,193,80650,true,L-s-0 L-m-0 L-m-0 
job-1610,3,4,3,80433,80433,80462,0,29,80566,true,C-m-2 C-m-1 C-s-1 
job-1611,1,10,1,80494,80494,80591,0,97,80691,true,L-s-0 
job-1612,1,11,7,80538,80538,80593,0,55,80681,true,L-m-0 L-m-0 L-l-0 L-l-0 L-l-0 L-l-0 C-s-0 
job-1613,6,6,5,80593,80593,80604,0,11,80845,true,L-m-0 L-l-0 L-l-0 C-m-2 C-m-1 
job-1614,1,11,4,80637,80637,80688,0,51,80872,true,L-s-0 L-m-0 L-m-0 L-l-0 
job-1615,5,11,3,80691,80691,80826,0,135,80983,true,L-m-0 L-l-0 L-l-0 
job-1616,1,9,6,80749,80749,80834,0,85,80970,true,L-m-0 L-m-0 L-l-0 L-l-0 L-s-0 C-s-0 
job-1618,3,4,3,80866,80866,80913,0,47,80946,true,C-m-2 C-m-1 L-s-0 
job-1617,5,5,2,80804,80804,80917,0,113,80925,true,C-m-2 C-m-1 
job-1619,1,12,4,80910,80910,80920,0,10,80935,true,L-s-0 L-m-0 L-m-0 L-l-0 
job-1620,4,9,3,80956,80956,80971,0,15,81168,true,L-s-0 L-m-0 L-m-0 
job-1621,6,12,2,81002,81002,81012,0,10,81228,true,L-m-0 L-l-0 
job-1624,3,6,3,81153,81153,81206,0,53,81274,true,L-l-0 L-l-0 L-l-0 
job-1623,2,11,1,81102,81102,81268,0,166,81564,true,L-l-0 
job-1626,1,9,3,81264,81264,81319,0,55,81496,true,L-l-0 L-l-0 L-l-0 
job-1625,4,8,7,81202,81202,81383,0,181,81437,true,C-s-0 C-s-1 C-s-2 C-m-2 C-m-2 C-m-1 C-m-1 
job-1622,4,10,3,81053,81053,81391,0,338,81669,true,L-s-0 L-m-0 L-m-0 
job-1629,4,10,6,81411,81411,81430,0,19,81436,true,L-s-0 L-m-0 L-m-0 C-s-0 C-s-1 C-s-2 
job-1627,4,12,5,81326,81326,81431,0,105,81497,true,L-l-0 L-l-0 L-l-0 C-m-0 C-m-0 
job-1628,4,4,3,81368,81368,81449,0,81,81487,true,C-l-0 C-l-0 C-l-0 
job-1630,2,6,5,81458,81458,81533,0,75,81670,true,L-s-0 L-s-0 L-m-0 L-m-0 L-m-0 
job-1632,2,9,8,81563,81563,81638,0,75,81640,true,L-m-0 L-m-0 L-s-0 C-m-0 C-m-0 C-m-0 C-m-2 C-m-2 
job-1634,2,9,7,81664,81664,81707,0,43,81971,true,L-m-0 L-m-0 C-m-1 C-l-0 C-l-2 C-l-1 C-l-1 
job-1631,1,11,8,81513,81513,81715,0,202,81760,true,L-m-0 L-l-0 L-l-0 L-l-0 L-l-0 C-s-0 C-s-1 C-s-2 
job-1633,5,6,6,81619,81619,81733,0,114,81853,true,C-m-1 C-l-0 C-l-0 C-l-2 C-l-2 C-l-1 
job-1637,6,9,3,81827,81827,81845,0,18,82103,true,L-m-0 L-l-0 L-l-0 
job-1636,6,11,3,81771,81771,81959,0,188,82101,true,C-m-1 C-l-0 C-l-2 
job-1639,6,11,4,81938,81938,82014,0,76,82095,true,L-l-0 L-l-0 C-m-0 C-m-2 
job-1635,2,11,3,81716,81716,82033,0,317,82135,true,C-m-1 C-l-0 C-l-2 
job-1640,1,11,1,81993,81993,82036,0,43,82082,true,C-m-0 
job-1641,3,8,3,82036,82036,82046,0,10,82196,true,L-m-0 C-l-0 C-l-0 
job-1642,3,11,2,82083,82083,82157,0,74,82354,true,C-l-0 C-l-0 
job-1644,6,12,8,82193,82193,82262,0,69,82544,true,C-l-2 C-l-0 L-l-0 L-l-0 C-m-0 C-m-2 C-m-1 C-l-1 
job-1638,2,11,7,81891,81891,82290,0,399,82574,true,C-l-0 C-l-0 C-l-2 C-l-2 L-s-0 L-m-0 L-m-0 
job-1646,5,6,6,82288,82288,82331,0,43,82623,true,L-l-0 L-l-0 C-m-0 C-m-2 C-m-1 C-l-1 
job-1647,5,10,6,82338,82338,82378,0,40,82558,true,C-l-2 C-l-0 L-m-0 L-l-0 L-l-0 C-m-0 
job-1643,1,11,1,82141,82141,82429,0,288,82528,true,C-l-2 
job-1648,1,6,2,82393,82393,82449,0,56,82659,true,C-l-2 C-l-2 
job-1645,6,5,2,82240,82262,82458,22,196,82515,true,C-l-2 C-l-0 
job-1649,2,4,5,82449,82449,82563,0,114,82707,true,C-l-2 C-l-2 C-l-2 C-l-0 C-l-0 
job-1651,6,12,5,82553,82553,82617,0,64,82894,true,C-l-0 L-m-0 L-l-0 L-l-0 C-m-0 
job-1650,2,11,4,82500,82500,82688,0,188,82920,true,C-l-2 C-l-2 C-l-2 C-l-0 
job-1654,5,10,1,82709,82709,82719,0,10,82979,true,C-l-2 
job-1652,2,4,7,82590,82590,82761,0,171,83046,true,L-m-0 C-m-0 C-l-2 C-l-2 C-l-2 C-l-0 C-l-0 
job-1655,5,11,7,82758,82758,82887,0,129,82993,true,C-l-2 C-l-0 L-l-0 L-l-0 C-m-2 C-m-1 C-l-1 
job-1656,6,4,6,82807,82887,82899,80,12,82844,false,L-l-0 L-l-0 C-m-2 C-m-1 C-l-2 C-l-2 
job-1658,1,9,7,82902,82902,82920,0,18,83134,true,C-m-2 C-m-2 C-m-1 C-m-1 L-l-0 L-l-0 L-l-0 
job-1657,2,6,8,82855,82887,82926,32,39,83020,true,L-m-0 C-m-0 C-m-2 C-m-1 L-s-0 L-s-0 C-s-0 C-s-0 
job-1653,2,5,6,82644,82644,82956,0,312,83142,true,L-m-0 L-m-0 L-m-0 C-m-0 C-m-0 C-m-0 
job-1661,4,6,1,83041,83041,83060,0,19,83248,true,C-s-0 
job-1659,1,11,5,82960,82960,83116,0,156,83152,true,L-s-0 L-m-0 L-m-0 L-l-0 L-l-0 
job-1660,5,7,4,82999,82999,83152,0,153,83324,true,L-m-0 L-l-0 L-l-0 C-m-0 
job-1664,2,11,2,83174,83174,83188,0,14,83308,true,L-m-0 L-l-0 
job-1662,4,7,8,83090,83090,83205,0,115,83349,true,C-s-0 C-s-1 C-s-2 C-m-2 C-m-2 C-m-1 C-m-1 C-l-2 
job-1663,5,12,7,83136,83152,83269,16,117,83448,true,C-l-2 L-m-0 L-l-0 L-l-0 C-m-0 C-l-0 C-l-0 
job-1666,4,5,3,83276,83276,83314,0,38,83316,true,L-m-0 L-l-0 L-l-0 
job-1667,3,12,3,83334,83334,83395,0,61,83415,true,L-m-0 L-m-0 L-l-0 
job-1668,5,6,2,83365,83365,83425,0,60,83538,true,L-l-0 C-m-0 
job-1670,5,10,6,83478,83478,83532,0,54,83565,true,L-l-0 L-l-0 C-m-0 C-l-2 C-l-0 C-l-0 
job-1669,2,12,1,83424,83424,83534,0,110,83653,true,L-m-0 
job-1665,2,5,6,83219,83219,83547,0,328,83614,true,L-m-0 L-l-0 C-m-0 C-l-0 C-l-2 C-l-2 
job-1671,3,11,8,83539,83539,83587,0,48,83806,true,L-m-0 L-m-0 L-l-0 L-l-0 L-l-0 C-m-0 C-m-0 C-l-2 
job-1672,5,12,4,83591,83591,83608,0,17,83849,true,L-m-0 L-l-0 L-l-0 C-m-0 
job-1673,1,10,6,83646,83646,83670,0,24,83775,true,L-s-0 L-m-0 L-m-0 L-m-0 L-l-0 L-l-0 
job-1676,5,8,6,83804,83804,83838,0,34,83945,true,L-l-0 C-m-0 C-m-2 C-m-1 C-l-2 C-l-2 
job-1674,4,12,4,83691,83691,83850,0,159,83994,true,L-s-0 L-m-0 L-m-0 L-l-0 
job-1675,3,5,1,83752,83752,83884,0,132,83949,true,L-l-0 
job-1678,4,11,4,83898,83898,83923,0,25,83941,true,L-l-0 L-l-0 L-s-0 L-m-0 
job-1677,3,4,8,83847,83847,83926,0,79,83946,true,L-l-0 C-s-0 C-s-1 C-s-2 C-m-0 C-m-0 C-m-2 C-m-2 
job-1680,4,7,2,84010,84010,84040,0,30,84244,true,L-s-0 C-s-0 
job-1679,6,12,3,83954,83954,84087,0,133,84184,true,L-m-0 L-l-0 L-l-0 
job-1681,1,7,4,84051,84051,84183,0,132,84217,true,L-m-0 L-m-0 L-s-0 L-s-0 
job-1682,1,9,3,84101,84101,84284,0,183,84557,true,L-m-0 L-m-0 L-l-0 
job-1684,2,12,4,84194,84194,84294,0,100,84349,true,L-m-0 C-m-0 C-m-2 C-m-1 
job-1685,1,4,2,84244,84244,84304,0,60,84399,true,L-l-0 C-m-0 
job-1686,5,7,3,84288,84288,84360,0,72,84580,true,L-m-0 C-l-0 C-l-0 
job-1683,5,8,7,84148,84148,84383,0,235,84386,true,L-l-0 L-l-0 C-m-0 C-m-2 C-m-1 C-l-2 C-l-2 
job-1689,5,7,8,84449,84449,84587,0,138,84819,true,L-l-0 C-m-2 C-m-1 C-l-2 C-l-2 C-l-0 C-l-0 C-l-1 
job-1687,3,12,2,84343,84343,84590,0,247,84877,true,L-m-0 C-m-0 
job-1690,5,5,6,84491,84587,84677,96,90,84870,true,L-l-0 C-m-2 C-m-1 C-l-2 C-l-2 C-l-0 
job-1693,3,7,5,84641,84677,84710,36,33,84930,true,L-l-0 C-m-2 C-m-1 C-l-0 C-l-1 
job-1691,5,6,6,84551,84677,84726,126,49,84717,false,L-l-0 C-m-2 C-m-1 C-l-2 C-l-2 C-l-0 
job-1694,5,7,2,84706,84710,84773,4,63,85019,true,C-l-1 C-l-1 
job-1695,6,9,2,84754,84754,84786,0,32,85005,true,L-l-0 C-l-0 
job-1692,4,6,6,84603,84677,84796,74,119,84901,true,L-m-0 C-m-0 C-l-0 C-s-0 C-s-1 C-s-2 
job-1688,4,10,4,84398,84398,84876,0,478,84932,true,L-m-0 C-m-0 L-s-0 L-l-0 
job-1696,3,5,7,84813,84813,84976,0,163,85269,true,L-m-0 L-l-0 L-l-0 C-m-0 C-s-0 C-s-1 C-s-2 
job-1697,5,10,4,84856,84856,84988,0,132,85069,true,C-m-2 C-m-1 C-l-1 C-l-1 
job-1699,2,11,3,84942,84942,85026,0,84,85231,true,L-l-0 C-m-2 C-m-1 
job-1701,6,11,2,85042,85042,85099,0,57,85182,true,C-m-2 C-m-1 
job-1698,4,7,4,84900,84900,85104,0,204,85243,true,L-m-0 L-l-0 C-m-0 L-s-0 
job-1703,3,8,8,85130,85130,85273,0,143,85448,true,L-m-0 L-l-0 L-l-0 L-s-0 C-s-0 C-s-1 C-s-2 C-m-2 
job-1704,5,7,1,85178,85178,85293,0,115,85473,true,C-m-2 
job-1700,5,11,3,84986,84986,85358,0,372,85641,true,L-l-0 C-l-0 C-l-0 
job-1707,1,9,2,85344,85344,85362,0,18,85539,true,L-m-0 L-m-0 
job-1702,3,5,1,85087,85087,85373,0,286,85466,true,L-m-0 
job-1705,2,9,7,85229,85229,85468,0,239,85655,true,L-m-0 C-l-0 C-m-1 C-m-1 C-m-1 C-m-0 C-m-0 
job-1709,2,6,7,85433,85433,85524,0,91,85775,true,L-l-0 L-l-0 L-l-0 C-m-0 C-m-0 C-l-2 C-l-2 
job-1708,5,8,1,85398,85398,85549,0,151,85599,true,L-m-0 
job-1710,1,9,5,85487,85487,85603,0,116,85898,true,L-m-0 L-m-0 C-m-0 C-m-0 C-l-2 
job-1712,3,4,7,85602,85602,85636,0,34,85816,true,L-m-0 L-m-0 L-l-0 C-m-0 C-m-0 C-l-2 L-s-0 
job-1711,1,8,1,85548,85548,85641,0,93,85934,true,L-l-0 
job-1713,3,4,3,85649,85649,85695,0,46,85987,true,L-l-0 L-l-0 C-l-2 
job-1714,5,5,8,85686,85695,85738,9,43,86022,true,L-l-0 C-l-2 L-m-0 C-m-0 C-m-1 C-m-2 C-l-0 C-l-0 
job-1716,5,6,1,85786,85786,85804,0,18,85844,true,L-m-0 
job-1706,6,5,4,85274,85274,85841,0,567,86052,true,L-l-0 C-l-1 C-l-1 C-l-2 
job-1715,1,11,7,85732,85732,85910,0,178,86080,true,L-m-0 L-m-0 L-l-0 C-m-0 C-m-0 C-m-1 C-m-1 
job-1718,1,11,1,85884,85884,85964,0,80,86175,true,L-l-0 
job-1719,1,9,4,85949,85949,86028,0,79,86046,true,L-m-0 L-m-0 L-m-0 L-l-0 
job-1717,4,4,1,85839,85839,86104,0,265,86298,true,L-m-0 
job-1722,6,9,7,86088,86088,86107,0,19,86193,true,C-m-2 C-l-1 C-l-1 C-l-2 C-l-2 C-l-0 C-l-0 
job-1723,6,12,1,86139,86139,86154,0,15,86354,true,C-m-2 
job-1721,4,5,4,86044,86044,86237,0,193,86362,true,L-m-0 L-s-0 C-s-0 C-s-1 
job-1724,2,10,6,86197,86197,86254,0,57,86368,true,L-m-0 L-m-0 L-l-0 C-m-0 C-m-1 C-s-2 
job-1725,5,10,4,86244,86244,86293,0,49,86336,true,C-m-2 C-l-1 C-l-1 C-l-2 
job-1727,1,7,2,86344,86344,86380,0,36,86671,true,L-m-0 L-m-0 
job-1720,5,12,4,85992,85992,86388,0,396,86509,true,L-l-0 L-l-0 C-m-0 C-m-1 
job-1728,3,10,3,86388,86388,86462,0,74,86706,true,L-m-0 L-l-0 L-l-0 
job-1729,6,9,6,86432,86432,86469,0,37,86683,true,L-l-0 C-m-0 C-m-1 C-m-2 C-l-1 C-l-1 
job-1726,4,7,2,86296,86296,86498,0,202,86780,true,L-s-0 L-m-0 
job-1730,3,8,1,86490,86490,86611,0,121,86681,true,L-m-0 
job-1731,4,8,8,86554,86554,86637,0,83,86872,true,L-m-0 L-s-0 L-l-0 L-l-0 L-l-0 C-s-2 C-s-0 C-s-1 
job-1732,2,9,6,86608,86608,86709,0,101,86932,true,C-m-0 C-m-0 C-m-0 C-m-1 C-m-1 C-m-1 
job-1734,5,8,1,86707,86707,86737,0,30,87007,true,L-l-0 
job-1733,3,10,5,86644,86644,86778,0,134,86795,true,L-s-0 L-m-0 L-m-0 L-l-0 L-l-0 
job-1735,2,6,5,86745,86745,86782,0,37,86952,true,L-m-0 L-l-0 L-l-0 L-l-0 C-s-2 
job-1738,4,9,1,86892,86892,86908,0,16,87163,true,C-s-1 
job-1737,1,9,7,86855,86855,86925,0,70,86996,true,L-m-0 L-m-0 C-m-0 C-m-0 L-s-0 C-s-2 C-s-0 
job-1736,6,4,4,86804,86804,87014,0,210,87290,true,L-m-0 L-l-0 L-l-0 C-m-0 
job-1740,5,4,5,86987,86987,87023,0,36,87182,true,C-m-1 C-m-2 C-l-1 C-l-1 C-l-2 
job-1739,2,4,7,86947,86947,87099,0,152,87242,true,L-m-0 C-m-0 L-s-0 L-s-0 C-s-2 C-s-2 C-s-0 
job-1743,2,10,7,87119,87119,87133,0,14,87241,true,L-m-0 L-m-0 L-l-0 L-l-0 C-m-1 C-m-2 C-m-0 
job-1741,4,8,4,87035,87035,87201,0,166,87414,true,L-m-0 C-m-0 L-l-0 L-l-0 
job-1744,5,11,3,87166,87166,87208,0,42,87390,true,C-l-1 C-l-2 C-l-2 
job-1745,3,11,3,87219,87219,87237,0,18,87380,true,C-l-1 C-l-1 L-s-0 
job-1742,6,9,3,87083,87083,87276,0,193,87519,true,C-m-1 C-m-2 C-l-1 
job-1746,4,6,4,87269,87269,87319,0,50,87387,true,C-l-1 L-s-0 L-m-0 L-m-0 
job-1747,5,8,1,87316,87316,87339,0,23,87499,true,C-l-1 
job-1748,5,9,6,87370,87370,87428,0,58,87559,true,L-m-0 L-l-0 L-l-0 C-m-1 C-m-2 C-m-0 
job-1750,5,8,4,87473,87473,87561,0,88,87857,true,L-m-0 L-l-0 L-l-0 C-m-1 
job-1751,2,8,7,87522,87522,87614,0,92,87854,true,L-m-0 L-l-0 C-m-1 C-l-1 L-s-0 L-s-0 C-s-2 
job-1752,2,8,8,87576,87576,87631,0,55,87728,true,L-m-0 L-m-0 L-m-0 L-l-0 L-l-0 L-l-0 L-l-0 L-l-0 
job-1753,1,5,7,87628,87628,87656,0,28,87892,true,L-m-0 L-l-0 C-l-1 C-l-1 L-s-0 L-s-0 L-s-0 
job-1749,5,10,2,87420,87420,87695,0,275,87863,true,C-l-1 C-l-1 
job-1755,5,11,8,87727,87727,87753,0,26,87759,true,L-l-0 C-m-1 C-m-2 C-m-0 C-l-1 C-l-1 C-l-2 C-l-2 
job-1754,4,6,4,87674,87674,87790,0,116,87848,true,L-s-0 L-m-0 L-m-0 L-l-0 
job-1756,1,11,6,87774,87774,87790,0,16,87837,true,L-l-0 L-l-0 L-l-0 C-s-2 C-s-0 C-s-1 
job-1757,1,11,2,87827,87827,87861,0,34,87973,true,L-s-0 L-m-0 
job-1758,4,6,6,87875,87875,88043,0,168,88136,true,L-s-0 L-m-0 L-m-0 L-l-0 L-l-0 L-l-0 
job-1760,5,8,4,87981,87981,88123,0,142,88417,true,C-l-1 C-l-1 C-l-2 C-l-2 
job-1759,5,11,3,87923,87923,88142,0,219,88278,true,C-m-1 C-m-2 C-m-0 
job-1761,6,11,6,88026,88123,88162,97,39,88274,true,L-m-0 L-l-0 L-l-0 C-l-1 C-l-1 C-l-2 
job-1763,4,7,7,88123,88142,88209,19,67,88331,true,C-l-0 C-l-0 C-m-1 C-m-1 C-m-2 C-m-2 C-m-0 
job-1762,4,6,6,88072,88123,88220,51,97,88184,false,C-l-2 L-s-0 C-s-2 C-s-0 C-s-1 C-l-0 
job-1764,6,9,6,88171,88171,88256,0,85,88481,true,C-l-2 L-m-0 L-l-0 L-l-0 C-l-1 C-l-1 
job-1766,6,4,7,88266,88266,88280,0,14,88351,true,L-m-0 L-l-0 L-l-0 C-m-1 C-m-2 C-m-0 C-l-1 
job-1765,2,7,1,88219,88219,88283,0,64,88477,true,L-m-0 
job-1767,3,7,2,88322,88322,88364,0,42,88643,true,L-s-0 L-m-0 
job-1768,3,5,7,88372,88372,88415,0,43,88631,true,L-s-0 L-m-0 L-m-0 L-l-0 L-l-0 L-l-0 L-l-0 
job-1769,4,4,5,88411,88411,88425,0,14,88610,true,C-s-2 C-s-0 C-s-1 C-m-1 C-m-1 
job-1770,4,6,3,88469,88469,88510,0,41,88761,true,L-s-0 L-m-0 L-m-0 
job-1771,4,10,6,88519,88519,88531,0,12,88619,true,L-s-0 L-m-0 L-m-0 L-l-0 L-l-0 L-l-0 
job-1773,2,12,8,88623,88623,88635,0,12,88837,true,L-l-0 L-l-0 L-l-0 L-l-0 C-s-2 C-s-0 C-s-1 C-m-1 
job-1774,3,11,2,88661,88661,88727,0,66,88812,true,L-l-0 L-l-0 
job-1775,6,12,1,88700,88700,88770,0,70,88798,true,L-l-0 
job-1776,1,6,4,88754,88754,88811,0,57,89014,true,L-l-0 L-l-0 L-l-0 L-l-0 
job-1777,6,11,7,88794,88794,88862,0,68,88996,true,L-l-0 C-m-1 C-m-2 C-m-0 C-l-1 C-l-1 C-l-2 
job-1778,4,12,5,88843,88843,88884,0,41,89012,true,L-l-0 C-l-2 C-s-2 C-s-0 C-s-1 
job-1779,1,4,2,88912,88912,88959,0,47,89008,true,L-l-0 L-l-0 
job-1772,2,5,6,88578,88578,88962,0,384,89170,true,L-s-0 L-s-0 L-m-0 L-m-0 L-m-0 L-m-0 
job-1781,2,7,2,89011,89011,89124,0,113,89220,true,L-l-0 L-l-0 
job-1782,6,6,2,89069,89069,89130,0,61,89337,true,L-m-0 C-m-1 
job-1783,3,9,3,89121,89121,89164,0,43,89401,true,L-s-0 C-s-0 C-s-1 
job-1780,4,11,3,88958,88958,89215,0,257,89468,true,L-l-0 L-l-0 C-s-2 
job-1785,5,11,8,89224,89224,89270,0,46,89344,true,L-m-0 L-l-0 C-m-1 C-m-2 C-m-0 C-l-1 C-l-1 C-l-2 
job-1784,3,7,3,89167,89167,89354,0,187,89490,true,L-l-0 L-s-0 L-m-0 
job-1786,3,6,6,89284,89284,89357,0,73,89522,true,L-m-0 L-l-0 L-l-0 L-l-0 C-s-2 C-s-0 
job-1788,6,5,3,89397,89397,89547,0,150,89585,true,L-m-0 L-l-0 L-l-0 
job-1787,3,4,5,89338,89338,89556,0,218,89670,true,C-s-1 C-m-1 C-m-1 C-m-2 C-m-2 
job-1789,1,7,3,89450,89450,89570,0,120,89673,true,L-m-0 L-m-0 C-s-1 
job-1791,5,6,7,89553,89553,89619,0,66,89703,true,L-m-0 L-l-0 L-l-0 C-l-2 C-l-2 C-l-0 C-l-0 
job-1790,4,12,8,89501,89501,89647,0,146,89917,true,L-s-0 C-s-2 C-s-0 C-m-0 C-m-0 C-l-1 C-l-1 C-l-1 
job-1792,1,6,1,89598,89598,89732,0,134,89898,true,L-m-0 
job-1794,2,8,7,89710,89710,89772,0,62,89911,true,L-l-0 L-l-0 L-l-0 L-l-0 L-l-0 C-s-2 C-s-2 
job-1796,4,12,5,89805,89805,89837,0,32,90115,true,L-l-0 L-l-0 C-s-2 C-m-0 C-m-0 
job-1795,3,11,2,89753,89753,89870,0,117,90059,true,C-s-0 C-s-1 
job-1799,6,6,5,89958,89958,90032,0,74,90155,true,C-l-1 C-l-2 C-l-2 C-l-0 C-l-0 
job-1798,2,12,8,89911,89911,90062,0,151,90264,true,C-s-0 C-s-1 C-m-1 C-m-1 C-m-2 C-m-2 C-l-1 C-l-1 
job-1801,3,10,2,90046,90046,90067,0,21,90069,true,C-l-2 C-l-0 
job-1802,3,4,7,90102,90102,90127,0,25,90335,true,C-s-2 C-m-1 C-m-2 C-l-1 C-l-2 C-s-0 C-s-1 
job-1797,1,10,8,89859,89859,90142,0,283,90399,true,L-l-0 L-l-0 L-l-0 L-l-0 C-s-2 C-m-0 C-m-0 C-m-0 
job-1793,1,6,7,89652,89652,90191,0,539,90437,true,L-m-0 L-m-0 L-m-0 L-m-0 L-s-0 L-s-0 L-l-0 
job-1800,4,7,7,90005,90032,90207,27,175,90206,false,L-m-0 C-m-1 C-m-2 C-l-1 C-l-1 C-l-2 C-l-2 
job-1805,3,10,6,90237,90237,90282,0,45,90543,true,L-m-0 C-m-1 C-m-2 C-l-1 C-l-1 C-l-1 
job-1803,4,10,4,90153,90153,90289,0,136,90293,true,L-l-0 L-l-0 C-m-1 C-m-2 
job-1806,5,6,1,90297,90297,90357,0,60,90378,true,L-m-0 
job-1807,3,8,7,90355,90355,90372,0,17,90616,true,L-l-0 L-l-0 C-l-1 C-l-1 C-l-1 L-s-0 C-s-2 
job-1809,1,9,6,90450,90450,90507,0,57,90673,true,L-l-0 C-m-1 C-m-1 C-m-2 C-m-2 C-m-0 
job-1804,1,9,6,90192,90192,90544,0,352,90814,true,L-m-0 L-m-0 L-l-0 L-l-0 L-l-0 C-l-1 
job-1808,6,5,6,90404,90404,90582,0,178,90641,true,L-m-0 L-l-0 C-l-1 C-m-1 C-m-2 C-m-0 
job-1810,6,12,8,90505,90582,90612,77,30,90623,true,L-m-0 L-l-0 L-l-0 C-m-1 C-m-2 C-m-0 C-l-1 C-l-1 
job-1813,4,4,4,90667,90667,90680,0,13,90822,true,C-l-1 L-s-0 C-s-2 C-s-0 
job-1811,6,11,7,90564,90612,90712,48,100,90712,false,L-m-0 L-l-0 L-l-0 C-m-1 C-m-2 C-m-0 C-l-1 
job-1815,4,6,5,90748,90748,90769,0,21,90909,true,L-s-0 C-s-2 C-s-0 C-s-1 C-l-1 
job-1814,6,12,6,90714,90714,90838,0,124,91064,true,L-m-0 L-l-0 L-l-0 C-m-1 C-m-2 C-m-0 
job-1816,3,8,4,90805,90805,90855,0,50,91096,true,L-s-0 C-s-2 C-s-0 C-s-1 
job-1812,1,7,2,90618,90618,90860,0,242,91097,true,L-m-0 L-m-0 
job-1818,2,12,8,90909,90909,90925,0,16,91015,true,L-m-0 L-s-0 L-l-0 L-l-0 L-l-0 L-l-0 C-s-2 C-s-0 
job-1817,1,5,3,90855,90855,90981,0,126,91147,true,L-m-0 L-m-0 L-m-0 
job-1819,3,9,5,90953,90953,91049,0,96,91174,true,L-m-0 L-s-0 L-l-0 L-l-0 L-l-0 
job-1820,1,11,5,91002,91002,91153,0,151,91205,true,L-m-0 L-m-0 L-l-0 C-s-2 C-s-0 
job-1822,1,10,2,91120,91120,91157,0,37,91175,true,L-l-0 L-l-0 
job-1823,6,8,5,91158,91158,91268,0,110,91471,true,L-l-0 C-m-0 C-l-1 C-l-1 C-l-2 
job-1824,6,8,7,91208,91268,91436,60,168,91545,true,L-l-0 C-m-0 C-l-1 C-l-1 C-l-2 C-l-2 C-l-0 
job-1826,1,11,8,91304,91436,91493,132,57,91383,false,L-m-0 L-m-0 L-l-0 C-m-1 C-m-1 C-m-2 C-m-2 C-m-0 
job-1827,3,9,7,91367,91436,91493,69,57,91659,true,C-l-2 C-l-2 L-s-0 C-s-2 C-s-0 C-s-1 C-l-0 
job-1828,3,6,4,91398,91493,91510,95,17,91449,false,C-m-0 C-l-0 C-l-0 C-l-0 
job-1821,6,5,4,91069,91069,91523,0,454,91549,true,L-m-0 L-l-0 C-m-1 C-m-2 
job-1825,5,9,5,91262,91436,91558,174,122,91674,true,L-l-0 C-m-0 C-l-1 C-l-1 C-l-2 
job-1832,3,6,6,91584,91584,91689,0,105,91879,true,L-l-0 L-l-0 C-l-2 C-l-2 C-l-0 C-l-0 
job-1829,6,8,4,91445,91523,91695,78,172,91820,true,L-l-0 C-l-2 L-m-0 C-m-1 
job-1831,2,5,1,91554,91554,91700,0,146,91817,true,L-m-0 
job-1830,4,4,7,91505,91523,91727,18,204,91812,true,L-s-0 C-s-2 C-s-0 C-s-1 C-m-2 C-m-2 C-l-0 
job-1835,2,10,4,91723,91723,91747,0,24,91941,true,L-l-0 L-l-0 L-l-0 C-m-0 
job-1833,5,8,6,91629,91689,91763,60,74,91945,true,L-l-0 C-l-2 C-l-0 C-m-0 C-l-1 C-l-1 
job-1834,1,10,2,91679,91689,91790,10,101,91928,true,L-l-0 C-m-1 
job-1836,3,11,6,91767,91767,91835,0,68,92022,true,L-l-0 L-l-0 L-l-0 C-m-1 C-m-1 L-s-0 
job-1838,4,10,1,91860,91860,91877,0,17,91877,false,L-l-0 
job-1837,2,10,1,91812,91812,91908,0,96,92038,true,L-l-0 
job-1839,2,9,6,91900,91900,91939,0,39,91969,true,L-l-0 L-l-0 L-l-0 L-l-0 L-s-0 L-m-0 
job-1842,2,6,1,92040,92040,92057,0,17,92267,true,L-s-0 
job-1840,2,10,2,91943,91943,92068,0,125,92220,true,L-s-0 L-m-0 
job-1841,3,10,5,91994,91994,92131,0,137,92381,true,L-m-0 L-m-0 L-l-0 L-l-0 L-l-0 
job-1844,4,10,3,92123,92123,92140,0,17,92324,true,C-m-1 C-m-2 C-m-2 
job-1845,4,9,2,92176,92176,92206,0,30,92305,true,L-m-0 L-l-0 
job-1843,2,10,7,92082,92082,92240,0,158,92498,true,L-m-0 L-l-0 L-s-0 C-s-2 C-s-0 C-s-1 C-m-1 
job-1846,4,12,7,92224,92224,92242,0,18,92332,true,L-m-0 L-l-0 L-l-0 C-m-1 C-m-2 C-m-2 C-m-0 
job-1847,4,10,2,92268,92268,92334,0,66,92403,true,L-s-0 L-m-0 
job-1849,4,10,5,92376,92376,92395,0,19,92656,true,L-m-0 L-s-0 L-l-0 L-l-0 L-l-0 
job-1850,2,9,4,92427,92427,92453,0,26,92706,true,L-m-0 L-s-0 L-l-0 L-l-0 
job-1848,1,5,4,92314,92314,92459,0,145,92643,true,L-m-0 L-m-0 L-m-0 L-m-0 
job-1853,4,4,2,92589,92589,92652,0,63,92906,true,C-s-2 C-s-0 
job-1851,4,6,1,92488,92488,92667,0,179,92761,true,L-s-0 
job-1854,2,4,8,92631,92631,92677,0,46,92801,true,L-m-0 L-l-0 C-m-1 C-s-1 C-s-1 C-m-2 C-m-2 C-m-2 
job-1852,5,11,4,92535,92535,92735,0,200,93023,true,L-m-0 L-l-0 L-l-0 C-m-1 
job-1855,5,10,8,92665,92677,92761,12,84,92801,true,C-m-2 C-m-0 C-l-1 C-l-1 C-l-0 C-l-0 C-l-2 C-l-2 
job-1857,1,9,3,92759,92759,92800,0,41,92981,true,L-m-0 L-m-0 L-l-0 
job-1856,2,8,8,92708,92708,92875,0,167,93033,true,L-m-0 L-l-0 C-m-1 C-m-2 C-m-0 C-l-1 C-l-0 C-l-2 
job-1860,4,8,4,92895,92895,92941,0,46,92969,true,L-l-0 L-s-0 C-s-1 C-s-2 
job-1858,3,10,2,92804,92804,92946,0,142,92969,true,L-m-0 L-m-0 
job-1861,2,8,2,92950,92950,93009,0,59,93140,true,L-l-0 L-l-0 
job-1862,4,8,7,92991,92991,93028,0,37,93291,true,L-s-0 L-m-0 L-m-0 C-s-1 C-s-2 C-s-0 C-m-2 
job-1863,4,4,4,93034,93034,93048,0,14,93061,true,L-l-0 L-s-0 L-m-0 L-m-0 
job-1859,2,8,4,92851,92851,93065,0,214,93337,true,L-l-0 L-l-0 L-l-0 L-l-0 
job-1864,3,4,3,93094,93094,93183,0,89,93260,true,L-s-0 L-m-0 L-m-0 
job-1865,5,11,2,93147,93147,93203,0,56,93467,true,L-l-0 L-l-0 
job-1868,5,9,6,93284,93284,93317,0,33,93460,true,C-l-1 C-l-1 C-l-0 C-l-0 C-l-2 C-l-2 
job-1866,5,11,2,93181,93181,93328,0,147,93539,true,C-m-2 C-m-0 
job-1869,4,8,1,93334,93334,93363,0,29,93445,true,L-s-0 
job-1871,6,10,6,93432,93432,93499,0,67,93649,true,C-m-2 C-m-0 C-l-1 C-l-1 C-l-0 C-l-0 
job-1870,2,10,2,93383,93383,93584,0,201,93622,true,L-m-0 L-l-0 
job-1874,2,5,3,93578,93578,93597,0,19,93619,true,C-m-2 C-m-0 C-m-0 
job-1872,3,8,7,93483,93483,93650,0,167,93699,true,C-m-1 L-s-0 C-s-1 C-s-2 C-s-0 C-l-2 C-l-2 
job-1867,5,9,4,93228,93228,93651,0,423,93766,true,L-m-0 L-l-0 L-l-0 C-m-1 
job-1875,4,9,6,93636,93636,93688,0,52,93690,true,C-m-0 C-l-1 C-l-1 C-l-1 C-l-0 C-l-0 
job-1873,2,9,8,93529,93529,93762,0,233,93957,true,C-l-2 C-l-2 C-l-2 C-m-2 C-m-2 C-m-2 C-m-0 C-m-0 
job-1877,5,12,6,93722,93722,93815,0,93,94050,true,L-m-0 C-l-0 L-l-0 L-l-0 C-m-1 C-l-1 
job-1878,1,8,2,93768,93768,93836,0,68,93965,true,L-m-0 L-l-0 
job-1880,2,4,4,93858,93858,93874,0,16,94156,true,L-s-0 L-m-0 L-l-0 C-m-1 
job-1876,1,10,7,93683,93683,93883,0,200,94076,true,C-l-2 C-l-2 C-l-0 C-l-0 C-l-0 L-s-0 L-m-0 
job-1879,5,10,8,93815,93815,93887,0,72,94072,true,L-m-0 L-l-0 L-l-0 C-l-0 C-l-2 C-l-2 C-m-1 C-m-2 
job-1881,6,5,4,93910,93910,93924,0,14,94087,true,L-m-0 L-l-0 L-l-0 C-m-1 
job-1882,6,5,4,93963,93963,94013,0,50,94252,true,L-m-0 L-l-0 L-l-0 C-m-1 
job-1884,2,7,3,94061,94061,94082,0,21,94125,true,L-m-0 L-l-0 L-s-0 
job-1885,2,9,6,94108,94108,94131,0,23,94308,true,L-m-0 L-l-0 L-s-0 C-s-1 C-s-2 C-s-0 
job-1886,4,5,4,94145,94145,94248,0,103,94321,true,L-s-0 C-s-1 C-s-2 C-s-0 
job-1887,3,9,6,94206,94206,94259,0,53,94482,true,L-m-0 C-m-1 C-m-1 C-m-2 C-m-2 C-m-0 
job-1889,3,12,7,94306,94306,94317,0,11,94499,true,L-m-0 C-m-1 L-s-0 C-s-1 C-s-2 C-s-0 C-m-2 
job-1888,2,9,2,94250,94250,94361,0,111,94570,true,L-l-0 C-m-1 
job-1890,3,4,7,94347,94347,94383,0,36,94393,true,L-m-0 C-m-1 C-m-1 L-s-0 C-s-1 C-s-2 C-s-0 
job-1883,5,12,3,94014,94014,94470,0,456,94652,true,L-m-0 L-l-0 L-l-0 
job-1891,3,7,3,94403,94403,94502,0,99,94513,true,L-m-0 L-s-0 C-s-1 
job-1892,5,5,4,94450,94450,94543,0,93,94691,true,C-m-1 C-m-2 C-m-0 C-l-2 
job-1893,3,9,6,94503,94503,94611,0,108,94649,true,C-m-1 C-m-2 C-m-0 C-l-2 C-l-2 L-s-0 
job-1894,5,5,4,94560,94560,94660,0,100,94849,true,C-m-1 C-m-2 C-m-0 C-l-2 
job-1895,1,12,1,94608,94608,94676,0,68,94973,true,C-l-2 
job-1896,6,9,6,94661,94661,94732,0,71,94882,true,C-l-2 L-m-0 L-l-0 L-l-0 C-m-1 C-m-2 
job-1897,6,10,3,94714,94714,94804,0,90,95065,true,C-l-2 C-m-0 C-l-0 
job-1899,3,4,1,94834,94834,94865,0,31,95143,true,L-m-0 
job-1898,5,12,8,94767,94767,94868,0,101,95112,true,C-l-2 C-l-0 L-m-0 L-l-0 L-l-0 C-m-1 C-m-2 C-l-1 
job-1900,4,7,5,94884,94884,94924,0,40,95101,true,L-s-0 L-m-0 L-m-0 L-l-0 L-l-0 
job-1901,6,6,4,94937,94937,94958,0,21,95186,true,L-m-0 L-l-0 L-l-0 C-m-1 
job-1902,6,6,8,94980,94980,95063,0,83,95249,true,L-m-0 L-l-0 L-l-0 C-m-1 C-m-2 C-m-0 C-l-2 C-l-2 
job-1905,2,8,6,95128,95128,95144,0,16,95300,true,L-m-0 C-m-1 C-m-2 C-m-0 C-m-0 C-l-2 
job-1906,1,7,1,95181,95181,95202,0,21,95351,true,L-m-0 
job-1903,6,4,5,95027,95063,95290,36,227,95359,true,L-m-0 L-l-0 L-l-0 C-m-1 C-m-2 
job-1904,4,8,5,95076,95076,95311,0,235,95603,true,L-s-0 C-s-1 C-s-2 C-s-0 C-m-0 
job-1909,1,5,5,95323,95323,95340,0,17,95525,true,L-m-0 L-l-0 C-m-1 C-m-1 C-m-1 
job-1907,5,9,7,95230,95290,95369,60,79,95498,true,L-m-0 L-l-0 L-l-0 C-m-1 C-m-2 C-l-2 C-l-2 
job-1908,1,9,3,95272,95290,95389,18,99,95548,true,L-m-0 L-m-0 L-l-0 
job-1910,6,6,6,95364,95369,95424,5,55,95694,true,L-m-0 L-l-0 C-m-1 C-m-2 C-m-0 C-l-2 
job-1911,2,11,7,95410,95410,95429,0,19,95505,true,L-m-0 L-l-0 L-l-0 L-l-0 C-m-1 C-m-2 C-m-0 
job-1913,6,12,4,95510,95510,95524,0,14,95762,true,C-l-2 C-l-0 C-l-0 C-l-1 
job-1914,3,7,5,95550,95550,95611,0,61,95678,true,C-l-2 C-l-2 L-s-0 C-s-1 C-s-2 
job-1915,1,10,7,95606,95606,95632,0,26,95881,true,L-m-0 L-m-0 C-m-1 C-m-1 C-m-2 C-m-2 C-m-0 
job-1912,6,8,7,95461,95461,95742,0,281,95749,true,L-m-0 L-l-0 L-l-0 C-m-1 C-m-2 C-m-0 C-l-2 
job-1917,2,4,8,95706,95706,95806,0,100,95945,true,C-l-2 C-l-2 C-l-2 L-s-0 L-s-0 C-s-1 C-s-1 C-s-2 
job-1920,3,9,2,95853,95853,95898,0,45,96042,true,C-m-0 L-s-0 
job-1919,1,5,1,95807,95807,95912,0,105,96206,true,L-m-0 
job-1918,4,8,4,95753,95753,95927,0,174,96103,true,L-m-0 C-m-1 C-m-2 C-m-0 
job-1921,2,12,2,95912,95912,95952,0,40,96229,true,C-m-0 L-s-0 
job-1923,6,9,8,96015,96015,96040,0,25,96137,true,C-m-0 L-l-0 L-l-0 C-l-2 C-l-2 C-l-0 C-l-0 C-l-1 
job-1916,1,9,7,95652,95652,96065,0,413,96297,true,L-m-0 L-m-0 C-m-1 C-m-1 C-m-2 C-m-2 C-m-0 
job-1922,1,9,4,95973,95973,96083,0,110,96363,true,L-m-0 C-m-1 C-m-2 C-m-0 
job-1924,1,9,8,96071,96071,96083,0,12,96194,true,L-m-0 L-m-0 C-m-1 C-m-1 C-m-2 C-m-2 C-m-0 C-m-0 
job-1927,1,9,6,96215,96215,96263,0,48,96449,true,L-m-0 C-m-1 C-m-1 C-m-1 C-m-2 C-m-2 
job-1925,5,11,3,96124,96124,96274,0,150,96389,true,L-m-0 L-l-0 L-l-0 
job-1926,2,9,6,96170,96170,96323,0,153,96605,true,L-m-0 L-l-0 L-s-0 C-s-1 C-s-2 C-s-0 
job-1928,2,7,3,96259,96259,96353,0,94,96555,true,L-s-0 C-s-1 C-s-2 
job-1929,4,7,1,96315,96315,96365,0,50,96369,true,L-m-0 
job-1930,2,5,6,96368,96368,96567,0,199,96719,true,L-s-0 L-s-0 L-m-0 L-m-0 L-m-0 L-m-0 
job-1933,3,7,1,96522,96522,96798,0,276,96955,true,C-m-1 
job-1932,5,8,6,96468,96468,96875,0,407,96937,true,C-m-1 C-m-2 C-m-0 C-l-2 C-l-2 C-l-0 
job-1936,2,8,4,96672,96875,96906,203,31,96884,false,C-s-2 C-s-2 C-s-0 C-s-0 
job-1935,2,9,7,96624,96875,96931,251,56,96794,false,L-m-0 L-l-0 C-m-1 C-m-2 C-m-0 L-s-0 C-s-1 
job-1931,5,6,2,96417,96417,96976,0,559,97115,true,L-l-0 L-l-0 
job-1934,6,8,6,96576,96875,96995,299,120,96700,false,L-m-0 C-m-1 C-m-2 C-m-0 C-l-2 C-l-2 
job-1939,6,8,6,96815,96995,97013,180,18,96923,false,L-m-0 L-l-0 L-l-0 C-m-1 C-m-2 C-m-0 
job-1940,3,11,1,96867,96995,97039,128,44,97142,true,L-s-0 
job-1941,2,5,3,96920,96995,97063,75,68,97245,true,L-m-0 C-m-1 C-m-2 
job-1942,4,9,6,96966,97013,97085,47,72,97173,true,L-m-0 C-m-1 C-m-2 L-l-0 L-l-0 L-l-0 
job-1943,4,11,7,97014,97039,97088,25,49,97268,true,L-s-0 C-s-1 C-m-0 C-m-0 C-l-2 C-l-2 C-l-2 
job-1937,2,10,6,96716,96875,97115,159,240,97238,true,C-l-0 C-l-0 C-l-0 C-l-0 C-l-1 C-l-1 
job-1938,1,12,4,96777,96906,97121,129,215,97014,false,C-l-1 C-l-1 C-s-2 C-s-0 
job-1945,6,8,3,97126,97126,97138,0,12,97243,true,C-m-0 C-m-1 C-m-2 
job-1944,6,11,3,97080,97085,97222,5,137,97335,true,L-m-0 L-l-0 L-l-0 
job-1947,5,7,2,97222,97222,97275,0,53,97468,true,L-m-0 L-l-0 
job-1949,3,10,2,97313,97313,97348,0,35,97535,true,L-m-0 L-m-0 
job-1946,4,7,1,97176,97176,97372,0,196,97378,true,L-s-0 
job-1948,2,12,4,97269,97269,97402,0,133,97462,true,L-m-0 L-l-0 L-l-0 L-l-0 
job-1950,5,9,2,97372,97372,97420,0,48,97606,true,L-m-0 L-l-0 
job-1953,4,5,8,97511,97511,97542,0,31,97609,true,L-m-0 L-m-0 C-m-0 C-m-0 C-m-1 C-m-1 C-m-2 C-m-2 
job-1954,3,12,6,97575,97575,97611,0,36,97728,true,L-m-0 L-m-0 C-m-0 C-m-0 C-m-1 C-m-1 
job-1951,4,12,5,97414,97414,97612,0,198,97622,true,L-l-0 L-s-0 C-s-1 C-s-2 C-s-0 
job-1952,6,10,1,97472,97472,97641,0,169,97681,true,L-l-0 
job-1956,4,9,4,97680,97680,97691,0,11,97968,true,L-l-0 C-s-1 C-s-2 C-s-0 
job-1955,3,5,5,97631,97631,97703,0,72,97737,true,L-l-0 L-l-0 L-s-0 L-m-0 L-m-0 
job-1958,4,6,5,97783,97783,97865,0,82,98115,true,L-s-0 C-s-1 C-s-2 C-s-0 C-l-0 
job-1960,2,8,3,97886,97886,97927,0,41,98135,true,L-m-0 L-l-0 C-m-0 
job-1961,3,7,7,97945,97945,97964,0,19,98257,true,L-m-0 C-m-0 C-m-1 C-m-2 C-l-0 C-l-0 L-s-0 
job-1959,6,6,1,97832,97832,97968,0,136,97983,true,C-l-0 
job-1957,5,12,8,97731,97731,98019,0,288,98158,true,L-m-0 L-l-0 L-l-0 C-m-0 C-m-1 C-m-2 C-l-2 C-l-2 
job-1962,1,12,3,97992,97992,98028,0,36,98266,true,L-m-0 L-l-0 L-l-0 
job-1965,6,7,2,98149,98149,98215,0,66,98400,true,C-m-1 C-m-2 
job-1966,1,4,6,98190,98190,98235,0,45,98316,true,L-s-0 L-l-0 L-l-0 C-m-1 C-m-1 C-m-2 
job-1968,4,11,4,98307,98307,98324,0,17,98505,true,C-s-2 C-s-0 C-m-1 C-m-1 
job-1967,3,8,1,98244,98244,98326,0,82,98504,true,C-s-1 
job-1969,3,5,6,98361,98361,98433,0,72,98537,true,C-s-1 C-s-2 C-s-0 C-m-1 C-m-1 C-m-2 
job-1964,3,8,3,98097,98097,98435,0,338,98500,true,L-m-0 C-m-0 L-s-0 
job-1963,5,10,4,98046,98046,98483,0,437,98682,true,L-m-0 L-l-0 L-l-0 C-m-0 
job-1972,2,4,8,98505,98505,98529,0,24,98741,true,L-m-0 L-m-0 L-l-0 L-l-0 L-l-0 L-l-0 L-l-0 C-m-2 
job-1970,6,10,8,98404,98433,98580,29,147,98553,false,C-m-1 C-m-2 C-l-2 C-l-2 C-l-0 C-l-0 C-l-1 C-l-1 
job-1973,3,5,8,98559,98559,98615,0,56,98627,true,L-m-0 L-m-0 L-l-0 L-l-0 L-l-0 L-s-0 C-s-1 C-s-2 
job-1974,6,6,8,98611,98611,98676,0,65,98838,true,C-m-1 C-m-2 C-m-0 C-l-2 C-l-2 C-l-0 C-l-0 C-l-1 
job-1975,4,6,6,98666,98666,98694,0,28,98702,true,L-m-0 L-l-0 L-l-0 C-l-1 L-s-0 C-s-1 
job-1976,4,12,1,98719,98719,98740,0,21,99012,true,L-l-0 
job-1977,5,12,7,98775,98775,98879,0,104,99005,true,L-l-0 L-l-0 C-m-1 C-m-2 C-m-0 C-l-2 C-l-2 
job-1971,1,11,5,98454,98454,98927,0,473,99072,true,L-m-0 L-m-0 L-l-0 L-l-0 C-m-1 
job-1978,2,6,3,98820,98820,99029,0,209,99229,true,L-m-0 C-m-1 C-m-2 
job-1980,2,10,1,98919,98919,99036,0,117,99283,true,L-l-0 
job-1981,3,9,3,98968,98968,99135,0,167,99197,true,L-m-0 L-m-0 L-l-0 
job-1979,6,6,3,98864,98864,99170,0,306,99335,true,C-l-0 C-l-0 C-l-1 
job-1983,1,7,2,99076,99135,99234,59,99,99368,true,L-m-0 L-m-0 
job-1982,6,10,8,99016,99135,99309,119,174,99208,false,C-l-1 L-m-0 L-l-0 L-l-0 C-m-1 C-m-2 C-m-0 C-l-2 
job-1986,4,7,2,99238,99309,99335,71,26,99540,true,C-s-2 C-s-0 
job-1984,5,12,8,99128,99309,99338,181,29,99416,true,L-m-0 L-l-0 L-l-0 C-m-1 C-m-2 C-m-0 C-l-1 C-l-1 
job-1988,3,4,7,99339,99339,99409,0,70,99578,true,L-m-0 C-m-1 C-m-2 C-m-0 C-l-1 C-l-1 C-s-2 
job-1987,5,8,7,99283,99338,99428,55,90,99566,true,L-m-0 L-l-0 L-l-0 C-m-1 C-m-2 C-m-0 C-l-1 
job-1985,4,11,2,99179,99309,99494,130,185,99568,true,L-s-0 C-s-1 
job-1990,5,12,1,99447,99447,99514,0,67,99593,true,L-l-0 
job-1989,2,6,7,99402,99402,99526,0,124,99751,true,L-l-0 C-s-0 C-s-0 C-l-2 C-l-2 C-l-2 C-l-2 
job-1991,3,12,7,99507,99507,99608,0,101,99853,true,L-l-0 C-l-2 L-s-0 L-m-0 L-m-0 C-s-1 C-s-2 
job-1992,5,4,3,99558,99558,99629,0,71,99690,true,L-l-0 C-l-2 C-m-1 
job-1993,6,11,7,99610,99610,99639,0,29,99937,true,L-l-0 C-l-2 L-m-0 C-m-2 C-m-0 C-l-1 C-l-1 
job-1994,3,9,3,99653,99653,99674,0,21,99729,true,L-s-0 L-m-0 L-m-0 
job-1997,2,6,7,99797,99797,99827,0,30,99970,true,L-m-0 L-l-0 L-l-0 C-s-1 C-s-1 C-s-2 C-s-2 
job-1996,3,11,1,99750,99750,99836,0,86,99918,true,L-l-0 
job-1995,2,11,5,99701,99701,99894,0,193,100188,true,L-s-0 L-m-0 L-m-0 L-l-0 L-l-0 
job-1998,5,5,6,99853,99853,99969,0,116,99974,true,L-l-0 C-m-1 C-m-2 C-m-0 C-l-2 C-l-2 
job-1999,5,10,6,99909,99909,99999,0,90,100259,true,L-l-0 L-m-0 C-l-1 C-l-1 C-l-0 C-l-0 
job-2003,1,12,1,100099,100099,100122,0,23,100130,true,L-m-0 
job-2000,6,11,1,99959,99969,100147,10,178,100340,true,L-l-0 
job-2002,5,7,3,100055,100055,100229,0,174,100281,true,C-l-1 C-l-1 C-l-0 
job-2004,3,8,5,100145,100145,100255,0,110,100350,true,C-l-0 C-l-0 L-s-0 C-s-1 C-s-2 
job-2006,2,11,6,100236,100236,100269,0,33,100544,true,L-m-0 L-l-0 C-m-1 C-m-2 C-m-0 C-l-0 
job-2005,4,6,2,100191,100191,100307,0,116,100381,true,L-l-0 C-s-0 
job-2007,1,10,5,100297,100297,100399,0,102,100589,true,L-m-0 L-m-0 L-l-0 L-l-0 C-m-1 
job-2001,6,9,5,100018,100018,100430,0,412,100569,true,L-l-0 L-m-0 C-m-1 C-m-2 C-m-0 
job-2008,1,6,8,100357,100357,100516,0,159,100664,true,L-l-0 L-l-0 L-l-0 C-m-1 C-m-2 C-m-2 C-m-0 C-m-0 
job-2010,6,6,5,100468,100468,100535,0,67,100571,true,L-m-0 L-l-0 C-m-2 C-m-0 C-m-1 
job-2011,1,10,7,100521,100521,100594,0,73,100632,true,L-l-0 L-l-0 L-l-0 L-l-0 C-m-2 C-m-2 C-m-0 
job-2012,3,11,2,100564,100564,100667,0,103,100702,true,L-m-0 L-m-0 
job-2013,1,7,6,100616,100616,100694,0,78,100893,true,L-s-0 L-s-0 L-l-0 L-l-0 L-l-0 L-l-0 
job-2014,4,10,2,100674,100674,100887,0,213,100960,true,L-m-0 L-l-0 
job-2009,1,4,2,100403,100403,100889,0,486,101102,true,L-m-0 L-m-0 
job-2015,1,8,1,100722,100722,100898,0,176,100973,true,L-m-0 
job-2016,1,7,2,100784,100784,100906,0,122,100971,true,L-l-0 L-l-0 
job-2018,1,12,2,100877,100877,100928,0,51,101026,true,C-m-2 C-m-0 
job-2019,5,5,4,100925,100925,101009,0,84,101115,true,L-l-0 C-m-0 L-m-0 C-m-1 
job-2017,3,7,8,100832,100832,101024,0,192,101223,true,L-l-0 L-l-0 L-s-0 C-s-0 C-s-1 C-s-2 C-m-2 C-m-2 
job-2020,3,5,5,100975,100975,101047,0,72,101198,true,L-m-0 C-m-0 C-m-1 C-l-0 C-l-0 
job-2021,3,6,1,101023,101023,101129,0,106,101191,true,L-m-0 
job-2024,4,4,7,101167,101167,101192,0,25,101328,true,L-l-0 C-s-2 C-m-2 C-m-2 C-m-0 C-m-0 C-m-1 
job-2022,1,10,5,101073,101073,101201,0,128,101365,true,L-m-0 L-m-0 L-s-0 L-l-0 L-l-0 
job-2025,2,10,2,101226,101226,101281,0,55,101533,true,L-m-0 L-m-0 
job-2027,1,7,8,101335,101335,101372,0,37,101515,true,L-l-0 L-l-0 C-m-2 C-m-2 C-m-0 C-m-0 L-s-0 L-s-0 
job-2028,6,12,1,101368,101368,101380,0,12,101626,true,C-m-1 
job-2023,2,11,5,101131,101131,101405,0,274,101551,true,L-m-0 L-l-0 L-l-0 C-s-0 C-s-1 
job-2026,6,8,4,101288,101288,101446,0,158,101484,true,L-m-0 L-l-0 C-m-2 C-m-0 
job-2029,4,12,6,101419,101419,101540,0,121,101623,true,L-l-0 L-s-0 C-s-0 C-s-1 C-s-2 C-m-1 
job-2032,4,10,3,101549,101549,101621,0,72,101693,true,L-l-0 C-m-1 C-l-0 
job-2031,3,5,3,101506,101506,101641,0,135,101930,true,L-m-0 L-l-0 C-m-1 
job-2030,5,6,5,101461,101461,101756,0,295,101783,true,L-l-0 L-m-0 C-m-2 C-m-0 C-l-0 
job-2033,5,6,3,101590,101590,101774,0,184,101904,true,C-l-1 C-l-1 C-l-2 
job-2034,6,8,5,101633,101756,101802,123,46,101688,false,C-l-2 L-m-0 L-l-0 L-l-0 C-m-2 
job-2035,6,6,8,101693,101802,101829,109,27,101904,true,L-m-0 L-l-0 L-l-0 C-m-2 C-m-0 C-m-1 C-l-2 C-l-2 
job-2036,3,5,6,101751,101802,101853,51,51,102007,true,L-s-0 C-s-0 C-s-1 C-s-2 C-l-1 C-l-1 
job-2037,1,5,6,101797,101802,101930,5,128,102139,true,L-s-0 L-m-0 L-m-0 C-s-0 C-s-1 C-s-2 
job-2039,4,11,1,101923,101923,101973,0,50,102140,true,L-l-0 
job-2040,6,6,2,101963,101963,101994,0,31,102260,true,C-l-1 C-m-2 
job-2041,6,9,1,102009,102009,102098,0,89,102161,true,L-l-0 
job-2038,2,9,8,101851,101851,102117,0,266,102247,true,L-m-0 L-m-0 C-l-1 C-l-1 C-l-1 L-l-0 L-l-0 L-l-0 
job-2043,3,8,6,102099,102099,102125,0,26,102300,true,L-m-0 L-l-0 L-l-0 L-s-0 C-s-0 C-s-1 
job-2042,5,10,1,102052,102052,102152,0,100,102314,true,C-l-1 
job-2045,1,12,2,102200,102200,102228,0,28,102355,true,L-m-0 L-m-0 
job-2046,6,9,6,102254,102254,102298,0,44,102300,true,C-l-1 L-l-0 L-l-0 C-m-2 C-m-0 C-m-1 
job-2047,5,9,5,102290,102298,102383,8,85,102478,true,C-l-1 L-l-0 L-l-0 C-m-2 C-m-0 
job-2049,6,12,6,102389,102389,102416,0,27,102680,true,L-l-0 C-m-2 C-m-0 C-l-1 C-m-1 C-l-2 
job-2048,2,11,7,102337,102337,102424,0,87,102469,true,L-m-0 L-m-0 L-l-0 C-m-2 C-m-0 C-l-1 C-s-0 
job-2050,1,5,5,102431,102431,102457,0,26,102735,true,L-m-0 L-m-0 L-m-0 L-m-0 C-l-1 
job-2044,4,6,3,102140,102140,102478,0,338,102757,true,C-l-1 L-s-0 L-m-0 
job-2052,3,5,2,102549,102549,102587,0,38,102627,true,L-m-0 L-m-0 
job-2051,2,5,1,102495,102495,102602,0,107,102712,true,L-s-0 
job-2053,5,5,1,102601,102601,102665,0,64,102683,true,L-m-0 
job-2055,3,11,5,102701,102701,102782,0,81,103036,true,L-m-0 L-s-0 L-l-0 L-l-0 L-l-0 
job-2059,1,4,1,102921,102921,102956,0,35,102998,true,L-m-0 
job-2057,2,12,4,102826,102826,102978,0,152,103031,true,L-m-0 C-m-2 C-m-0 C-m-1 
job-2054,3,9,1,102640,102640,103022,0,382,103089,true,L-m-0 
job-2056,6,9,4,102768,102768,103026,0,258,103232,true,C-m-2 C-m-0 C-m-1 C-l-1 
job-2058,5,10,7,102875,102875,103038,0,163,103210,true,C-l-1 L-l-0 L-l-0 C-l-2 C-l-2 C-l-0 C-l-0 
job-2061,1,6,7,103015,103026,103072,11,46,103223,true,L-m-0 L-m-0 L-m-0 L-l-0 L-l-0 C-m-2 C-m-2 
job-2062,3,6,4,103051,103051,103095,0,44,103238,true,L-l-0 L-l-0 L-l-0 C-m-0 
job-2060,5,8,5,102966,103026,103098,60,72,103135,true,C-l-1 L-m-0 C-m-2 C-m-0 C-m-1 
job-2065,4,12,2,103197,103197,103214,0,17,103356,true,L-l-0 L-l-0 
job-2064,3,10,3,103152,103152,103238,0,86,103526,true,L-m-0 L-m-0 L-l-0 
job-2066,6,4,2,103252,103252,103407,0,155,103451,true,L-m-0 L-l-0 
job-2067,3,4,3,103295,103295,103411,0,116,103598,true,L-s-0 L-l-0 L-l-0 
job-2068,6,5,8,103343,103343,103450,0,107,103731,true,C-m-2 C-m-0 C-m-1 C-l-1 C-l-1 C-l-2 C-l-2 C-l-0 
job-2069,3,9,5,103386,103386,103471,0,85,103476,true,C-l-0 C-l-0 C-s-0 C-s-1 C-s-2 
job-2063,1,10,2,103105,103105,103492,0,387,103596,true,L-s-0 L-m-0 
job-2071,4,12,6,103481,103481,103499,0,18,103508,true,C-l-0 C-s-0 C-s-1 C-s-2 C-m-0 C-m-0 
job-2070,5,12,5,103426,103450,103514,24,64,103727,true,L-m-0 C-l-0 L-l-0 L-l-0 C-m-2 
job-2072,2,5,1,103519,103519,103555,0,36,103670,true,L-s-0 
job-2073,5,4,3,103575,103575,103639,0,64,103694,true,L-m-0 L-l-0 L-l-0 
job-2074,4,7,2,103633,103633,103656,0,23,103671,true,L-s-0 C-s-0 
job-2076,3,4,3,103732,103732,103745,0,13,103838,true,L-m-0 L-l-0 L-l-0 
job-2075,1,7,6,103681,103681,103756,0,75,103961,true,L-s-0 L-s-0 L-m-0 L-m-0 L-m-0 L-m-0 
job-2078,1,5,8,103820,103820,103872,0,52,103958,true,L-s-0 L-m-0 L-l-0 L-l-0 L-l-0 L-l-0 L-l-0 L-l-0 
job-2077,2,9,6,103775,103775,103913,0,138,104010,true,L-s-0 L-m-0 L-m-0 L-m-0 L-l-0 L-l-0 
job-2079,4,7,8,103867,103867,103919,0,52,104100,true,C-s-0 C-s-1 C-s-2 C-m-2 C-m-2 C-m-0 C-m-0 C-m-1 
job-2080,3,11,3,103920,103920,104020,0,100,104196,true,L-s-0 L-m-0 L-m-0 
job-2081,1,12,2,103970,103970,104075,0,105,104331,true,L-l-0 L-l-0 
job-2083,5,11,2,104055,104055,104079,0,24,104263,true,L-m-0 C-l-1 
job-2082,5,4,7,104011,104011,104160,0,149,104348,true,L-l-0 L-l-0 C-m-2 C-m-0 C-m-1 C-l-0 C-l-0 
job-2084,2,8,3,104109,104109,104315,0,206,104495,true,L-l-0 C-m-2 C-m-0 
job-2088,6,6,4,104294,104294,104328,0,34,104450,true,C-m-2 C-m-0 C-l-0 C-l-0 
job-2085,3,9,6,104146,104146,104397,0,251,104520,true,C-m-1 L-s-0 L-m-0 L-m-0 C-s-0 C-s-1 
job-2087,1,10,4,104252,104252,104441,0,189,104545,true,L-l-0 L-l-0 L-l-0 C-m-1 
job-2090,6,9,2,104408,104408,104543,0,135,104551,true,L-m-0 C-m-1 
job-2091,2,7,5,104464,104464,104548,0,84,104564,true,L-s-0 L-l-0 L-l-0 L-l-0 L-l-0 
job-2094,2,5,5,104630,104630,104655,0,25,104913,true,L-s-0 L-m-0 L-l-0 C-s-2 C-m-0 
job-2086,1,5,5,104190,104190,104658,0,468,104898,true,L-s-0 L-m-0 L-m-0 L-l-0 L-l-0 
job-2093,4,6,6,104582,104582,104717,0,135,104717,false,L-m-0 L-l-0 L-l-0 C-m-1 C-l-0 C-l-0 
job-2089,1,10,5,104350,104350,104730,0,380,104731,true,C-m-1 C-s-2 C-m-2 C-m-2 C-m-2 
job-2096,4,11,1,104727,104727,104757,0,30,104767,true,L-m-0 
job-2097,6,9,1,104783,104783,104809,0,26,104967,true,C-l-0 
job-2095,4,10,1,104684,104684,104836,0,152,104882,true,L-m-0 
job-2098,3,4,7,104839,104839,104875,0,36,105025,true,C-l-0 C-l-0 C-l-0 L-s-0 L-m-0 L-m-0 L-l-0 
job-2099,5,6,8,104883,104883,104997,0,114,105018,true,C-l-0 L-m-0 L-l-0 L-l-0 C-m-2 C-m-1 C-l-1 C-l-1 
job-2101,5,12,3,104980,104997,105090,17,93,105275,true,L-m-0 C-l-0 L-l-0 
job-2100,1,10,1,104930,104930,105096,0,166,105248,true,L-m-0 
job-2103,6,7,8,105092,105092,105111,0,19,105206,true,L-m-0 L-l-0 C-l-0 C-m-2 C-m-1 C-l-1 C-l-1 C-l-2 
job-2092,3,10,5,104515,104515,105111,0,596,105225,true,C-s-0 C-s-1 C-m-0 C-m-0 C-l-0 
job-2102,3,7,2,105037,105037,105178,0,141,105363,true,L-l-0 L-l-0 
job-2105,4,6,6,105185,105185,105216,0,31,105466,true,L-l-0 C-s-2 C-m-0 C-m-0 C-m-2 C-m-2 
job-2104,3,4,7,105139,105139,105297,0,158,105308,true,L-l-0 L-l-0 L-s-0 L-m-0 L-m-0 C-s-0 C-s-1 
job-2106,6,8,7,105230,105230,105366,0,136,105501,true,L-l-0 C-m-0 C-m-2 C-m-1 C-l-0 C-l-0 C-l-1 
job-2107,6,12,4,105279,105297,105372,18,75,105445,true,L-l-0 C-l-1 L-m-0 C-l-2 
job-2108,5,12,3,105344,105366,105431,22,65,105598,true,L-l-0 C-l-1 C-l-2 
job-2110,4,11,7,105458,105458,105498,0,40,105642,true,L-l-0 C-l-1 C-l-2 C-l-2 L-s-0 L-m-0 L-m-0 
job-2111,1,9,2,105508,105508,105538,0,30,105601,true,L-l-0 L-l-0 
job-2113,1,11,8,105601,105601,105643,0,42,105814,true,L-l-0 L-l-0 C-l-1 C-l-1 C-l-1 C-l-2 C-l-2 C-l-2 
job-2112,4,11,1,105550,105550,105648,0,98,105945,true,L-l-0 
job-2114,4,10,1,105664,105664,105703,0,39,105804,true,L-l-0 
job-2109,2,4,8,105407,105407,105729,0,322,105979,true,L-l-0 L-l-0 L-l-0 C-l-1 C-l-1 C-l-1 C-l-2 C-l-2 
job-2115,3,8,3,105707,105707,105814,0,107,105975,true,L-l-0 L-l-0 C-l-1 
job-2117,1,8,3,105781,105781,105893,0,112,106125,true,L-m-0 L-m-0 L-m-0 
job-2118,3,11,3,105826,105826,105940,0,114,105988,true,L-l-0 L-l-0 C-m-0 
job-2116,5,8,6,105743,105743,105969,0,226,106179,true,L-l-0 C-l-1 L-m-0 C-m-0 C-m-2 C-m-1 
job-2122,4,11,2,106004,106004,106022,0,18,106065,true,C-s-2 C-m-0 
job-2123,3,4,6,106043,106043,106068,0,25,106069,true,C-s-2 C-m-0 C-m-0 C-m-2 C-m-2 C-m-1 
job-2120,1,5,4,105910,105940,106104,30,164,106199,true,L-m-0 L-m-0 L-m-0 L-l-0 
job-2121,4,10,6,105962,105969,106116,7,147,106360,true,L-m-0 L-l-0 C-l-1 L-s-0 C-s-0 C-s-1 
job-2119,6,12,6,105856,105940,106139,84,199,106140,true,L-l-0 C-l-1 C-l-2 C-l-2 C-l-0 C-l-0 
job-2125,4,11,7,106154,106154,106169,0,15,106428,true,L-s-0 L-m-0 L-m-0 L-l-0 L-l-0 L-l-0 C-s-0 
job-2124,3,6,5,106101,106101,106303,0,202,106477,true,C-s-2 C-m-0 C-m-0 C-m-2 C-m-2 
job-2126,6,7,4,106204,106204,106343,0,139,106547,true,L-m-0 L-l-0 L-l-0 C-m-1 
job-2127,4,11,2,106265,106265,106372,0,107,106375,true,L-s-0 C-s-0 
job-2128,6,11,4,106331,106331,106388,0,57,106558,true,C-m-0 C-m-2 C-l-2 C-l-2 
job-2129,6,5,7,106389,106389,106944,0,555,107167,true,L-m-0 L-l-0 L-l-0 C-m-1 C-m-0 C-m-2 C-l-2 
job-2131,5,4,1,106481,106944,106969,463,25,106791,false,C-l-2 
job-2130,6,12,7,106440,106944,107039,504,95,106577,false,L-m-0 L-l-0 L-l-0 C-m-1 C-m-0 C-m-2 C-l-2 
job-2132,6,6,8,106534,107039,107149,505,110,106645,false,L-m-0 L-l-0 L-l-0 C-m-1 C-m-0 C-m-2 C-l-2 C-l-2 
job-2133,6,7,4,106587,107039,107149,452,110,106858,false,C-l-0 C-l-0 C-l-1 C-l-1 
job-2134,6,7,5,106633,107149,107161,516,12,106857,false,L-m-0 L-l-0 L-l-0 C-m-1 C-m-0 
job-2136,6,9,3,106752,107149,107164,397,15,106840,false,C-m-2 C-l-2 C-l-2 
job-2142,2,4,1,107061,107161,107196,100,35,107109,false,C-m-1 
job-2141,4,7,3,107013,107161,107196,148,35,107141,false,C-s-0 C-s-2 C-s-1 
job-2137,5,5,1,106805,107149,107217,344,68,106909,false,C-l-0 
job-2138,2,6,1,106857,107149,107229,292,80,106969,false,L-m-0 
job-2135,4,12,1,106687,107149,107236,462,87,106925,false,L-s-0 
job-2139,5,12,4,106910,107161,107268,251,107,107019,false,L-m-0 C-l-0 L-l-0 L-l-0 
job-2140,2,9,3,106967,107161,107270,194,109,107168,false,L-l-0 C-m-2 C-l-0 
job-2143,5,11,7,107115,107164,107423,49,259,107672,true,C-m-2 C-m-1 C-m-0 C-l-2 C-l-2 C-l-1 C-l-1 
job-2145,6,11,7,107219,107423,107465,204,42,107301,false,C-m-2 C-m-1 C-m-0 C-l-2 C-l-2 C-l-1 C-l-1 
job-2144,4,11,7,107171,107268,107466,97,198,107606,true,L-l-0 L-l-0 C-l-0 C-l-0 L-s-0 L-m-0 L-m-0 
job-2146,3,12,8,107276,107465,107481,189,16,107393,false,L-l-0 C-l-0 C-s-0 C-s-2 C-s-1 C-m-2 C-m-2 C-m-1 
job-2148,4,12,4,107358,107466,107483,108,17,107661,true,C-m-1 L-s-0 C-l-1 C-l-1 
job-2149,2,8,3,107400,107466,107504,66,38,107492,false,L-m-0 L-l-0 C-m-2 
job-2147,6,11,6,107320,107466,107609,146,143,107672,true,L-l-0 C-l-0 L-m-0 C-m-0 C-l-2 C-l-2 
job-2152,4,7,3,107558,107609,107632,51,23,107647,true,C-s-0 C-s-2 C-s-1 
job-2150,6,6,8,107452,107609,107633,157,24,107518,false,L-m-0 L-l-0 L-l-0 C-m-0 C-m-2 C-m-1 C-l-2 C-l-2 
job-2151,2,4,5,107494,107609,107684,115,75,107701,true,L-m-0 C-m-0 C-m-2 C-m-1 L-s-0 
job-2155,4,11,6,107735,107735,107804,0,69,107856,true,C-l-0 C-l-0 C-l-0 C-l-1 C-l-1 C-l-1 
job-2153,6,12,6,107619,107633,107827,14,194,108017,true,L-m-0 C-m-0 C-m-2 C-m-1 L-l-0 L-l-0 
job-2156,4,6,8,107784,107827,107866,43,39,107847,false,L-m-0 L-m-0 L-l-0 L-l-0 L-l-0 C-m-0 C-m-0 C-m-2 
job-2159,2,8,7,107927,107927,107944,0,17,108057,true,C-l-0 C-l-0 L-m-0 L-m-0 L-m-0 L-m-0 L-l-0 
job-2157,4,7,4,107831,107831,108028,0,197,108186,true,C-m-2 C-m-1 C-m-1 C-l-0 
job-2154,1,11,8,107676,107676,108030,0,354,108306,true,L-s-0 C-s-0 C-s-2 C-s-1 C-l-2 C-l-2 C-l-2 C-l-2 
job-2161,3,6,6,108032,108032,108088,0,56,108232,true,L-m-0 L-l-0 L-l-0 C-m-2 C-l-0 L-s-0 
job-2158,4,11,2,107880,107880,108128,0,248,108292,true,C-m-2 C-l-0 
job-2160,2,12,7,107978,107978,108241,0,263,108330,true,C-l-0 C-l-0 L-m-0 L-m-0 L-l-0 L-l-0 L-l-0 
job-2163,1,7,5,108134,108134,108296,0,162,108516,true,L-m-0 L-l-0 C-l-0 C-l-0 C-l-0 
job-2162,2,10,2,108086,108086,108332,0,246,108477,true,C-s-0 C-s-2 
job-2164,6,12,5,108182,108182,108463,0,281,108604,true,C-m-2 C-m-1 C-m-0 C-l-2 C-l-2 
job-2165,6,4,4,108232,108241,108504,9,263,108606,true,L-m-0 L-l-0 C-l-0 C-l-1 
job-2166,1,5,6,108282,108282,108515,0,233,108533,true,L-m-0 L-l-0 L-l-0 L-l-0 L-l-0 L-l-0 
job-2167,6,5,4,108336,108463,108550,127,87,108712,true,C-l-0 C-l-1 C-m-2 C-m-1 
job-2169,5,9,2,108445,108504,108583,59,79,108635,true,L-m-0 L-l-0 
job-2168,5,10,2,108391,108463,108626,72,163,108799,true,C-m-0 C-l-2 
job-2172,1,4,5,108605,108605,108640,0,35,108897,true,L-m-0 L-m-0 L-m-0 L-m-0 L-m-0 
job-2173,2,8,7,108656,108656,108684,0,28,108739,true,L-m-0 L-m-0 L-l-0 L-l-0 L-l-0 C-m-2 C-m-1 
job-2171,3,7,1,108553,108553,108748,0,195,108969,true,L-m-0 
job-2174,6,9,4,108702,108702,108768,0,66,108984,true,L-l-0 C-l-2 C-m-0 C-l-1 
job-2175,2,10,2,108747,108747,108823,0,76,109055,true,L-m-0 L-m-0 
job-2178,1,11,8,108883,108883,108922,0,39,109037,true,C-l-2 L-s-0 C-s-0 C-s-2 C-s-1 C-m-0 C-m-0 C-l-1 
job-2170,5,10,6,108507,108550,108928,43,378,109054,true,L-l-0 C-l-2 C-m-2 C-m-1 C-l-0 C-l-0 
job-2179,2,11,3,108935,108935,108956,0,21,109239,true,L-l-0 C-m-1 C-m-2 
job-2180,2,12,1,108980,108980,109043,0,63,109048,true,L-l-0 
job-2181,6,7,5,109026,109026,109054,0,28,109158,true,C-m-1 C-m-2 C-l-0 C-l-2 C-m-0 
job-2177,1,10,7,108830,108830,109229,0,399,109356,true,L-m-0 L-m-0 C-m-1 C-l-0 C-l-0 C-l-2 C-l-2 
job-2184,5,12,3,109189,109189,109247,0,58,109485,true,C-m-0 C-l-1 C-l-1 
job-2185,4,5,1,109239,109239,109281,0,42,109336,true,L-m-0 
job-2176,1,8,8,108793,108793,109285,0,492,109404,true,L-m-0 L-l-0 L-l-0 L-l-0 L-l-0 C-m-2 C-m-2 C-m-1 
job-2182,1,7,8,109073,109073,109285,0,212,109508,true,L-l-0 L-l-0 C-m-1 C-m-1 C-m-2 C-m-2 C-l-0 C-l-0 
job-2186,6,10,5,109276,109285,109309,9,24,109440,true,L-l-0 C-m-2 C-m-1 L-m-0 C-m-0 
job-2183,4,5,8,109123,109123,109336,0,213,109354,true,C-l-0 C-l-0 C-l-2 C-l-2 L-s-0 C-s-0 C-s-2 C-s-1 
job-2187,6,5,4,109336,109336,109434,0,98,109663,true,L-m-0 L-l-0 L-l-0 C-m-2 
job-2189,5,4,2,109429,109429,109446,0,17,109545,true,C-m-1 C-m-0 
job-2188,1,5,6,109379,109379,109475,0,96,109731,true,L-m-0 L-m-0 C-m-2 C-m-2 L-s-0 L-s-0 
job-2190,4,12,3,109478,109478,109570,0,92,109808,true,L-s-0 L-m-0 L-m-0 
job-2192,1,7,8,109580,109580,109605,0,25,109759,true,C-m-2 C-m-2 C-m-1 C-m-1 C-m-0 C-m-0 C-l-2 C-l-2 
job-2193,4,4,2,109640,109640,109661,0,21,109687,true,C-l-2 L-s-0 
job-2194,2,10,5,109687,109687,109716,0,29,109971,true,C-m-2 C-m-1 C-m-0 C-l-2 C-l-2 
job-2191,6,11,8,109539,109539,109783,0,244,109786,true,L-l-0 L-l-0 C-m-2 C-m-1 C-m-0 C-l-0 C-l-0 C-l-2 
job-2196,6,7,2,109783,109783,109811,0,28,110086,true,C-l-2 L-l-0 
job-2195,5,9,4,109732,109732,109884,0,152,110029,true,C-l-2 L-m-0 C-l-1 C-l-1 
job-2197,6,6,3,109846,109846,109911,0,65,110175,true,C-l-2 L-l-0 L-l-0 
job-2199,3,4,8,109945,109945,109957,0,12,110179,true,L-s-0 L-m-0 L-m-0 C-l-2 C-l-2 C-l-2 L-l-0 L-l-0 
job-2198,1,11,5,109887,109887,110116,0,229,110362,true,C-l-2 C-l-2 C-l-2 L-s-0 L-m-0 
job-2201,2,7,7,110047,110047,110123,0,76,110173,true,C-s-2 C-s-2 C-s-1 C-s-1 C-m-2 C-m-2 C-m-2 
job-2200,3,9,8,109992,109992,110147,0,155,110163,true,L-m-0 L-m-0 C-l-2 L-l-0 L-l-0 L-l-0 L-l-0 C-s-0 
job-2203,1,8,2,110125,110125,110178,0,53,110267,true,L-s-0 L-m-0 
job-2205,3,6,3,110202,110202,110232,0,30,110463,true,L-m-0 C-m-2 L-l-0 
job-2208,4,11,7,110342,110342,110352,0,10,110552,true,C-l-2 C-s-1 C-l-1 C-l-1 C-l-1 C-l-0 C-l-0 
job-2207,6,6,3,110298,110298,110357,0,59,110602,true,C-m-1 C-m-0 C-l-2 
job-2206,3,9,8,110253,110253,110363,0,110,110393,true,L-m-0 C-m-2 L-l-0 L-l-0 L-l-0 L-l-0 C-s-0 C-s-2 
job-2204,2,10,3,110166,110166,110415,0,249,110604,true,L-m-0 L-m-0 C-m-2 
job-2202,2,5,2,110079,110079,110418,0,339,110486,true,L-s-0 C-m-2 
job-2211,2,10,2,110504,110504,110563,0,59,110782,true,L-s-0 L-l-0 
job-2210,4,8,2,110450,110450,110569,0,119,110845,true,L-m-0 L-l-0 
job-2213,6,6,2,110610,110610,110630,0,20,110678,true,L-l-0 C-m-1 
job-2214,5,7,7,110652,110652,110729,0,77,110892,true,L-l-0 C-m-1 C-m-0 C-l-2 C-l-2 C-l-1 C-l-1 
job-2215,2,10,8,110703,110703,110793,0,90,110899,true,L-s-0 L-m-0 L-m-0 L-l-0 C-m-1 C-m-0 C-l-2 C-l-1 
job-2209,2,4,6,110390,110390,110850,0,460,110971,true,L-s-0 L-m-0 L-m-0 C-m-2 C-m-2 L-l-0 
job-2216,2,9,8,110753,110753,110858,0,105,111038,true,L-l-0 C-m-1 C-m-1 C-m-0 C-m-0 C-l-2 C-l-2 C-l-2 
job-2218,5,12,6,110861,110861,110880,0,19,110950,true,L-m-0 L-l-0 C-m-1 C-m-0 C-l-2 C-l-2 
job-2212,1,7,6,110561,110561,110882,0,321,111001,true,L-l-0 L-l-0 L-l-0 C-m-2 C-m-2 C-m-2 
job-2217,3,7,2,110815,110815,110959,0,144,111195,true,L-m-0 L-l-0 
job-2219,1,12,6,110914,110914,110978,0,64,111183,true,L-m-0 L-m-0 L-l-0 L-l-0 L-l-0 L-s-0 
job-2222,5,4,2,111046,111046,111162,0,116,111337,true,L-m-0 L-l-0 
job-2221,2,9,4,111004,111004,111205,0,201,111379,true,C-m-2 C-m-1 C-m-0 L-s-0 
job-2224,2,10,4,111130,111130,111277,0,147,111567,true,L-l-0 L-l-0 L-l-0 C-s-0 
job-2225,4,4,5,111182,111182,111284,0,102,111464,true,L-m-0 L-l-0 C-s-2 C-s-1 C-l-2 
job-2226,6,7,7,111232,111284,111307,52,23,111413,true,L-l-0 C-l-2 C-l-2 C-l-1 C-l-1 C-l-0 C-l-0 
job-2220,5,12,3,110957,110957,111327,0,370,111450,true,C-m-2 C-m-1 C-m-0 
job-2223,1,4,5,111086,111086,111340,0,254,111371,true,L-s-0 L-m-0 L-m-0 L-m-0 L-l-0 
job-2228,3,4,6,111334,111334,111365,0,31,111601,true,L-s-0 L-m-0 L-l-0 C-l-1 C-l-1 C-s-2 
job-2227,6,7,4,111280,111307,111423,27,116,111657,true,L-l-0 C-l-2 C-l-2 C-l-1 
job-2231,5,11,2,111488,111488,111547,0,59,111633,true,C-l-2 C-l-0 
job-2232,1,7,2,111526,111526,111563,0,37,111801,true,L-m-0 L-m-0 
job-2229,2,8,6,111375,111375,111569,0,194,111772,true,L-l-0 L-l-0 L-l-0 C-l-1 C-l-1 C-l-1 
job-2230,5,7,7,111430,111430,111574,0,144,111771,true,L-l-0 C-l-1 L-m-0 C-m-2 C-m-1 C-m-0 C-l-2 
job-2234,1,4,4,111622,111622,111657,0,35,111846,true,L-s-0 L-m-0 L-m-0 L-m-0 
job-2236,6,4,8,111713,111713,111736,0,23,111759,true,C-m-1 C-m-0 C-l-1 C-l-1 C-l-2 C-l-2 C-l-0 C-l-0 
job-2233,1,9,3,111576,111576,111821,0,245,111852,true,L-s-0 L-m-0 L-m-0 
job-2237,3,6,2,111765,111765,111899,0,134,111920,true,L-s-0 C-m-2 
job-2235,4,7,8,111667,111667,111949,0,282,111950,true,L-m-0 L-l-0 L-l-0 L-l-0 C-s-2 C-s-1 C-s-0 C-m-2 
job-2239,4,10,5,111871,111871,111969,0,98,112221,true,L-m-0 C-l-2 C-l-0 C-l-0 C-l-0 
job-2238,6,12,5,111822,111822,111997,0,175,112055,true,C-m-1 C-m-0 C-l-1 C-l-1 C-l-2 
job-2241,3,7,8,111961,111961,112032,0,71,112118,true,L-m-0 L-l-0 L-l-0 L-s-0 C-s-2 C-s-1 C-s-0 C-m-2 
job-2240,5,5,1,111915,111949,112150,34,201,112287,true,L-l-0 
job-2243,6,12,5,112039,112039,112352,0,313,112530,true,L-l-0 C-l-0 C-l-0 C-l-1 C-l-1 
job-2247,4,12,8,112250,112352,112385,102,33,112476,true,C-s-2 C-s-1 C-s-0 C-l-1 C-l-1 C-l-1 C-l-2 C-l-2 
job-2245,5,7,4,112153,112352,112415,199,63,112218,false,L-l-0 L-l-0 C-l-0 C-l-0 
job-2242,4,12,6,112001,112001,112430,0,429,112521,true,L-m-0 C-m-2 C-m-1 C-m-1 C-m-0 C-m-0 
job-2250,3,8,2,112405,112405,112443,0,38,112561,true,C-l-2 C-l-2 
job-2246,2,10,6,112195,112352,112460,157,108,112332,false,L-m-0 L-l-0 C-m-2 C-m-2 C-l-0 L-s-0 
job-2249,4,9,2,112350,112385,112508,35,123,112533,true,C-l-1 C-l-1 
job-2248,2,9,5,112290,112385,112621,95,236,112687,true,C-s-2 C-s-1 C-s-0 C-l-1 C-l-1 
job-2244,2,9,1,112093,112093,112635,0,542,112841,true,L-m-0 
job-2251,6,5,5,112439,112439,112683,0,244,112927,true,L-l-0 C-l-2 C-l-0 C-m-1 C-m-0 
job-2252,5,4,7,112488,112621,112751,133,130,112835,true,L-m-0 L-l-0 C-l-2 C-l-0 C-m-2 C-l-1 C-l-1 
job-2257,2,8,5,112747,112751,112835,4,84,112938,true,C-m-2 C-l-1 C-s-2 C-s-2 C-s-1 
job-2255,1,9,7,112646,112751,112877,105,126,113061,true,L-m-0 L-m-0 L-m-0 L-l-0 C-m-1 C-m-1 C-m-0 
job-2254,5,5,7,112597,112751,112904,154,153,112977,true,L-l-0 C-l-2 C-l-0 L-m-0 C-m-2 C-l-1 C-l-1 
job-2256,4,10,1,112690,112751,112948,61,197,112956,true,L-s-0 
job-2258,3,5,7,112798,112904,112976,106,72,113075,true,L-l-0 L-l-0 C-l-2 C-l-2 C-l-0 C-l-0 L-m-0 
job-2253,6,6,5,112542,112683,112981,141,298,112900,false,L-l-0 C-l-2 C-l-0 C-m-1 C-m-0 
job-2262,6,5,4,112989,112989,113003,0,14,113197,true,L-l-0 C-l-2 C-l-0 C-m-1 
job-2261,1,12,2,112936,112976,113013,40,37,113005,false,L-m-0 L-m-0 
job-2259,6,5,4,112849,112976,113022,127,46,112982,false,L-l-0 C-l-2 C-l-0 L-m-0 
job-2260,6,5,3,112890,112976,113055,86,79,113052,false,C-m-2 C-l-1 C-l-1 
job-2263,6,10,7,113037,113037,113659,0,622,113863,true,L-m-0 L-l-0 L-l-0 C-m-1 C-m-0 C-l-2 C-l-2 
job-2265,4,6,2,113147,113659,113685,512,26,113311,false,L-s-0 C-s-2 
job-2267,3,12,3,113247,113659,113705,412,46,113539,false,C-l-1 C-l-1 C-l-0 
job-2266,4,6,6,113191,113659,113725,468,66,113406,false,C-s-1 C-s-0 C-l-2 C-l-2 C-l-2 C-l-1 
job-2264,6,4,6,113102,113659,113734,557,75,113323,false,L-m-0 L-l-0 L-l-0 C-m-1 C-m-0 C-m-2 
job-2268,3,12,2,113300,113659,113760,359,101,113481,false,C-l-0 C-l-0 
job-2269,3,10,2,113356,113685,113793,329,108,113603,false,C-l-0 L-s-0 
job-2271,1,12,8,113448,113685,113795,237,110,113603,false,L-m-0 L-m-0 C-m-1 C-m-1 C-m-0 C-m-0 C-m-2 C-m-2 
job-2275,2,10,5,113657,113795,113817,138,22,113722,false,C-l-0 C-m-1 C-m-1 C-m-1 C-m-0 
job-2273,3,9,4,113564,113725,113821,161,96,113809,false,C-l-1 C-l-1 C-l-1 C-l-1 
job-2277,2,6,3,113755,113821,113859,66,38,113908,true,C-m-1 C-m-0 C-m-2 
job-2274,4,9,8,113607,113795,113881,188,86,113917,true,C-l-0 C-l-0 L-s-0 L-m-0 L-m-0 L-l-0 L-l-0 L-l-0 
job-2278,1,8,7,113790,113859,113891,69,32,114075,true,C-m-1 C-m-1 C-m-0 C-m-0 C-m-2 C-m-2 C-l-0 
job-2276,6,4,5,113709,113821,113931,112,110,114068,true,C-m-1 C-m-0 C-m-2 C-l-1 C-l-1 
job-2270,4,11,1,113405,113685,113937,280,252,113954,true,C-s-2 
job-2272,2,12,7,113506,113725,113984,219,259,113909,false,C-l-0 C-s-1 C-s-0 C-l-2 C-l-2 C-l-2 C-l-2 
job-2281,1,8,5,113940,113940,114020,0,80,114243,true,C-l-0 L-l-0 L-l-0 L-l-0 L-l-0 
job-2282,5,8,1,113995,113995,114021,0,26,114151,true,L-l-0 
job-2283,1,11,2,114035,114035,114096,0,61,114357,true,C-l-0 C-l-0 
job-2284,4,7,8,114089,114089,114107,0,18,114132,true,L-l-0 L-l-0 L-l-0 C-s-1 C-s-0 C-s-2 C-m-1 C-m-1 
job-2286,3,5,1,114187,114187,114243,0,56,114524,true,C-s-1 
job-2279,3,6,3,113855,113881,114298,26,417,114366,true,C-l-0 C-l-0 C-l-0 
job-2280,4,5,3,113901,113901,114302,0,401,114390,true,L-s-0 L-m-0 L-m-0 
job-2288,6,11,2,114279,114279,114369,0,90,114663,true,C-m-1 C-m-0 
job-2289,5,4,5,114323,114323,114405,0,82,114703,true,C-l-0 L-m-0 C-m-2 C-l-2 C-l-2 
job-2290,1,10,8,114371,114371,114408,0,37,114541,true,L-m-0 L-m-0 C-s-1 C-m-2 C-m-2 C-l-2 C-l-2 C-l-0 
job-2285,2,4,7,114146,114146,114417,0,271,114478,true,C-l-0 L-l-0 L-l-0 L-l-0 L-l-0 L-l-0 L-l-0 
job-2291,1,11,3,114412,114412,114427,0,15,114546,true,C-s-1 C-l-0 C-l-0 
job-2287,1,5,2,114228,114228,114550,0,322,114644,true,C-s-1 C-l-0 
job-2294,1,9,8,114552,114552,114625,0,73,114743,true,C-s-1 C-l-0 C-l-0 L-l-0 L-l-0 L-l-0 L-l-0 L-l-0 
job-2292,6,5,2,114454,114454,114628,0,174,114921,true,C-l-0 L-m-0 
job-2293,2,5,6,114500,114500,114630,0,130,114746,true,L-m-0 C-s-1 C-l-0 C-l-0 L-s-0 L-s-0 
job-2295,1,6,6,114608,114608,114712,0,104,114732,true,C-s-0 C-s-0 C-s-2 C-s-2 C-m-2 C-m-2 
job-2297,6,10,5,114707,114707,114764,0,57,114876,true,L-l-0 C-m-1 C-m-0 C-l-0 C-l-0 
job-2296,6,10,3,114658,114658,114783,0,125,114863,true,C-m-2 L-m-0 L-l-0 
job-2298,2,4,8,114764,114764,114868,0,104,115108,true,L-m-0 L-l-0 L-l-0 L-l-0 C-m-2 L-s-0 L-s-0 C-s-0 
job-2299,3,4,4,114810,114810,114901,0,91,115060,true,L-m-0 L-m-0 L-l-0 L-l-0 
job-2300,6,6,4,114863,114863,114927,0,64,115027,true,C-m-2 C-m-1 C-m-0 C-l-0 
job-2301,1,12,7,114916,114916,115010,0,94,115048,true,C-m-2 C-m-2 C-m-1 C-m-1 C-m-0 C-m-0 C-l-0 
job-2302,6,9,3,114964,114964,115059,0,95,115173,true,C-l-0 L-m-0 L-l-0 
job-2303,2,7,1,115021,115021,115115,0,94,115257,true,L-m-0 
job-2304,2,7,8,115061,115061,115255,0,194,115472,true,L-m-0 L-m-0 L-m-0 L-s-0 L-s-0 L-l-0 L-l-0 L-l-0 
job-2306,2,10,3,115161,115161,115286,0,125,115338,true,L-m-0 C-s-0 C-s-2 
job-2307,5,8,1,115211,115211,115309,0,98,115424,true,C-m-2 
job-2309,6,9,6,115309,115309,115371,0,62,115505,true,C-m-2 C-m-1 C-m-0 C-l-0 C-l-0 C-l-2 
job-2305,2,4,4,115109,115109,115447,0,338,115597,true,L-l-0 L-l-0 L-l-0 C-s-0 
job-2308,2,6,8,115266,115266,115454,0,188,115696,true,L-m-0 L-m-0 L-m-0 L-l-0 L-l-0 L-l-0 C-s-2 C-m-2 
job-2311,4,4,8,115399,115454,115471,55,17,115622,true,L-s-0 L-m-0 L-m-0 L-l-0 L-l-0 L-l-0 C-s-2 C-s-0 
job-2312,3,8,7,115449,115471,115483,22,12,115603,true,L-s-0 L-m-0 L-m-0 L-l-0 L-l-0 L-l-0 L-l-0 
job-2313,2,8,2,115500,115500,115564,0,64,115852,true,C-m-2 C-m-1 
job-2314,4,8,3,115555,115555,115573,0,18,115736,true,L-s-0 L-m-0 L-m-0 
job-2310,6,12,7,115349,115371,115610,22,239,115836,true,C-m-2 C-m-1 C-m-0 C-l-0 C-l-0 C-l-2 C-l-2 
job-2316,3,11,4,115668,115668,115696,0,28,115708,true,L-m-0 L-s-0 L-l-0 L-l-0 
job-2315,5,7,1,115613,115613,115708,0,95,115964,true,L-m-0 
job-2318,5,8,8,115772,115772,115786,0,14,116008,true,L-m-0 L-l-0 L-l-0 C-m-2 C-m-1 C-m-0 C-l-0 C-l-0 
job-2317,1,10,1,115717,115717,115937,0,220,115937,false,L-s-0 
job-2321,6,6,3,115916,115916,115956,0,40,116234,true,C-m-2 C-m-1 C-m-0 
job-2320,1,11,4,115863,115863,115960,0,97,116217,true,L-l-0 L-l-0 L-l-0 L-l-0 
job-2322,3,8,4,115954,115954,115964,0,10,116145,true,L-s-0 C-s-2 C-s-0 C-s-1 
job-2319,4,7,2,115813,115813,115972,0,159,116109,true,L-m-0 L-m-0 
job-2323,6,10,7,116003,116003,116026,0,23,116188,true,L-m-0 L-l-0 L-l-0 C-m-2 C-m-1 C-m-0 C-l-0 
job-2324,5,11,1,116044,116044,116094,0,50,116307,true,L-m-0 
job-2325,2,4,5,116079,116079,116094,0,15,116129,true,L-m-0 L-s-0 L-s-0 L-l-0 L-l-0 
job-2326,6,12,6,116121,116121,116187,0,66,116447,true,L-m-0 L-l-0 L-l-0 C-m-2 C-m-1 C-m-0 
job-2327,5,8,4,116178,116178,116194,0,16,116445,true,C-l-0 C-l-0 C-l-2 C-l-2 
job-2328,2,12,6,116222,116222,116266,0,44,116323,true,L-s-0 L-m-0 L-m-0 L-l-0 L-l-0 L-l-0 
job-2329,2,5,8,116271,116271,116337,0,66,116469,true,L-s-0 L-s-0 L-m-0 L-m-0 L-m-0 L-m-0 L-l-0 L-l-0 
job-2330,2,12,1,116322,116322,116339,0,17,116340,true,L-l-0 
job-2331,5,7,7,116378,116378,116426,0,48,116636,true,L-m-0 L-l-0 L-l-0 C-m-2 C-m-1 C-m-0 C-l-0 
job-2332,5,7,2,116452,116452,116494,0,42,116643,true,L-m-0 L-l-0 
job-2334,3,12,6,116549,116549,116598,0,49,116708,true,C-s-1 C-m-2 C-m-2 C-m-1 C-m-1 C-m-0 
job-2337,2,5,2,116689,116689,116704,0,15,116842,true,C-s-1 C-m-2 
job-2336,1,11,5,116641,116641,116735,0,94,116922,true,C-s-1 C-m-2 C-m-2 C-m-1 C-m-1 
job-2338,2,12,5,116748,116748,116781,0,33,116876,true,C-s-1 C-m-2 C-m-2 C-m-1 C-m-1 
job-2333,4,6,8,116499,116499,116785,0,286,116909,true,L-s-0 L-m-0 L-m-0 L-l-0 L-l-0 L-l-0 C-s-2 C-s-0 
job-2339,6,7,1,116794,116794,116930,0,136,117035,true,L-m-0 
job-2341,2,7,5,116890,116890,116960,0,70,117088,true,L-m-0 L-l-0 L-l-0 C-s-2 C-s-2 
job-2342,2,5,2,116952,116952,116962,0,10,117147,true,L-m-0 L-m-0 
job-2343,2,5,1,117005,117005,117062,0,57,117250,true,L-l-0 
job-2340,4,12,3,116841,116841,117079,0,238,117100,true,L-s-0 L-l-0 L-l-0 
job-2335,6,7,4,116589,116589,117112,0,523,117236,true,C-l-0 C-l-0 C-l-2 C-l-2 
job-2345,4,7,2,117090,117090,117221,0,131,117265,true,L-s-0 L-l-0 
job-2344,3,6,7,117052,117052,117267,0,215,117397,true,L-m-0 L-m-0 C-s-2 C-s-0 C-s-1 C-m-2 C-m-2 
job-2346,2,9,4,117140,117140,117309,0,169,117565,true,L-m-0 L-l-0 L-l-0 L-l-0 
job-2347,4,12,8,117195,117195,117349,0,154,117571,true,C-m-1 C-m-1 C-m-0 C-m-0 C-l-0 C-l-0 C-l-0 C-l-2 
job-2350,2,7,7,117361,117361,117375,0,14,117636,true,L-m-0 L-m-0 L-l-0 L-l-0 L-l-0 L-l-0 C-s-2 
job-2348,1,5,5,117251,117251,117377,0,126,117462,true,L-l-0 L-l-0 L-l-0 L-l-0 C-s-2 
job-2349,4,12,8,117303,117303,117424,0,121,117597,true,L-m-0 C-l-2 C-l-2 L-s-0 C-s-0 C-s-1 C-m-2 C-m-2 
job-2351,5,6,2,117415,117415,117473,0,58,117744,true,L-l-0 L-l-0 
job-2352,4,11,6,117460,117460,117572,0,112,117743,true,L-s-0 L-m-0 L-m-0 C-s-0 C-s-1 C-s-2 
job-2354,4,11,8,117562,117562,117603,0,41,117866,true,C-m-0 C-l-2 C-l-2 C-l-2 C-l-0 C-l-0 C-l-0 C-l-1 
job-2355,5,10,2,117609,117609,117699,0,90,117783,true,L-m-0 C-l-2 
job-2357,4,4,8,117707,117707,117794,0,87,118010,true,L-m-0 L-s-0 C-s-0 C-s-1 C-s-2 C-l-2 C-l-2 C-l-2 
job-2353,4,5,8,117511,117511,117858,0,347,118016,true,L-l-0 L-l-0 L-l-0 C-m-2 C-m-2 C-m-1 C-m-1 C-m-0 
job-2356,1,6,5,117654,117654,117881,0,227,118129,true,L-m-0 L-m-0 L-m-0 C-m-0 C-m-0 
job-2359,1,5,3,117811,117858,117936,47,78,118114,true,L-l-0 L-l-0 C-m-0 
job-2361,1,5,1,117920,117920,117966,0,46,118041,true,L-m-0 
job-2358,5,7,8,117763,117858,118001,95,143,118114,true,L-m-0 C-m-0 L-l-0 L-l-0 C-m-2 C-m-1 C-l-2 C-l-2 
job-2362,1,8,4,117965,117965,118037,0,72,118221,true,L-m-0 L-m-0 L-l-0 L-l-0 
job-2360,6,8,4,117870,117870,118070,0,200,118159,true,C-l-0 C-l-0 C-l-1 C-l-1 
job-2364,3,7,1,118068,118068,118110,0,42,118220,true,L-l-0 
job-2365,2,8,5,118113,118113,118192,0,79,118337,true,L-m-0 L-l-0 L-l-0 L-l-0 C-m-0 
job-2366,3,10,4,118157,118157,118209,0,52,118453,true,L-s-0 C-s-0 C-s-1 C-s-2 
job-2367,2,7,5,118209,118209,118258,0,49,118351,true,L-m-0 L-l-0 L-l-0 L-l-0 C-m-0 
job-2368,5,9,7,118269,118269,118299,0,30,118479,true,L-l-0 C-m-1 C-l-0 C-l-0 C-l-1 C-l-1 C-l-2 
job-2369,2,6,6,118317,118317,118344,0,27,118361,true,L-m-0 L-l-0 L-l-0 L-l-0 C-m-0 C-m-2 
job-2363,6,4,4,118027,118027,118431,0,404,118538,true,L-m-0 L-l-0 C-m-0 C-m-2 
job-2371,2,7,2,118421,118421,118439,0,18,118673,true,L-m-0 C-m-1 
job-2370,5,12,6,118374,118374,118483,0,109,118759,true,L-l-0 C-m-1 C-l-0 C-l-0 C-l-1 C-l-1 
job-2374,4,7,1,118559,118559,118608,0,49,118765,true,L-s-0 
job-2372,6,8,4,118471,118471,118623,0,152,118754,true,L-l-0 L-m-0 C-m-0 C-m-2 
job-2373,2,7,4,118517,118517,118642,0,125,118890,true,L-m-0 L-l-0 L-l-0 L-l-0 
job-2375,5,6,5,118608,118608,118670,0,62,118835,true,C-m-1 C-l-0 C-l-0 C-l-1 C-l-1 
job-2377,2,10,4,118716,118716,118792,0,76,118830,true,C-m-1 C-m-1 C-l-0 C-l-0 
job-2379,1,4,5,118805,118805,118827,0,22,118854,true,C-m-1 C-m-1 C-m-1 C-m-1 C-m-1 
job-2378,2,4,5,118760,118760,118854,0,94,118900,true,C-l-0 C-l-0 C-l-0 L-s-0 L-s-0 
job-2376,2,12,2,118663,118663,118932,0,269,119053,true,C-m-1 C-l-0 
job-2381,2,11,2,118907,118907,118968,0,61,119209,true,L-s-0 L-m-0 
job-2380,5,6,3,118856,118856,118984,0,128,119200,true,C-m-1 C-l-0 C-l-0 
job-2382,2,7,7,118954,118954,119009,0,55,119055,true,L-m-0 L-m-0 L-m-0 C-m-1 C-l-0 L-l-0 L-l-0 
job-2383,6,12,8,118985,118985,119061,0,76,119324,true,L-l-0 C-m-1 C-l-0 C-m-0 C-m-2 C-l-1 C-l-1 C-l-2 
job-2385,1,4,1,119096,119096,119164,0,68,119383,true,L-l-0 
job-2386,5,9,1,119146,119146,119187,0,41,119222,true,L-l-0 
job-2384,4,6,1,119035,119035,119222,0,187,119353,true,L-l-0 
job-2387,6,10,8,119205,119205,119246,0,41,119350,true,L-l-0 L-m-0 C-m-1 C-m-0 C-m-2 C-l-1 C-l-1 C-l-0 
job-2389,5,9,3,119300,119300,119328,0,28,119372,true,L-l-0 L-l-0 C-m-1 
job-2390,5,5,6,119341,119341,119373,0,32,119480,true,L-l-0 L-l-0 C-m-1 C-m-0 C-m-2 C-l-1 
job-2391,2,4,8,119397,119397,119455,0,58,119540,true,L-m-0 L-l-0 L-l-0 L-l-0 L-l-0 L-l-0 L-l-0 C-s-0 
job-2392,3,11,1,119454,119454,119489,0,35,119640,true,C-s-1 
job-2394,5,6,1,119562,119562,119576,0,14,119662,true,L-l-0 
job-2393,1,7,7,119507,119507,119582,0,75,119786,true,L-s-0 L-m-0 L-m-0 L-l-0 L-l-0 L-l-0 L-l-0 
job-2388,3,5,3,119252,119252,119648,0,396,119713,true,L-s-0 L-m-0 L-m-0 
job-2395,5,6,5,119617,119617,119682,0,65,119717,true,L-l-0 L-l-0 C-m-1 C-m-0 C-m-2 
job-2396,4,6,4,119663,119663,119735,0,72,119860,true,L-s-0 L-m-0 L-m-0 C-s-0 
job-2399,2,12,7,119812,119812,119857,0,45,120066,true,C-m-1 C-m-0 C-l-1 C-l-1 C-l-1 C-l-1 C-l-0 
job-2400,3,10,8,119854,119857,119870,3,13,120087,true,C-l-1 C-l-1 C-l-1 C-l-1 C-l-0 C-l-0 C-l-0 C-l-0 
job-2398,4,6,8,119771,119771,119928,0,157,119929,true,L-s-0 L-m-0 L-m-0 C-s-0 C-s-1 C-s-2 C-m-2 C-m-2 
job-2397,6,4,4,119721,119721,119945,0,224,120077,true,L-l-0 L-l-0 C-m-1 C-m-0 
job-2402,2,11,5,119963,119963,119992,0,29,120144,true,C-m-1 C-m-1 C-m-0 C-m-0 C-l-1 
job-2403,2,5,6,120011,120011,120035,0,24,120261,true,C-m-1 C-m-1 C-m-1 C-m-0 C-m-0 C-m-0 
job-2401,2,7,3,119901,119901,120036,0,135,120222,true,C-m-1 C-m-0 C-l-1 
job-2404,3,12,8,120056,120056,120075,0,19,120223,true,L-s-0 L-m-0 L-m-0 L-l-0 L-l-0 L-l-0 L-l-0 C-s-0 
job-2405,3,6,5,120108,120108,120178,0,70,120297,true,L-s-0 L-m-0 L-m-0 L-l-0 L-l-0 
job-2406,3,4,4,120169,120169,120193,0,24,120244,true,L-l-0 L-l-0 C-s-0 C-s-1 
job-2409,1,4,2,120312,120312,120342,0,30,120525,true,L-m-0 L-m-0 
job-2408,5,4,7,120251,120251,120348,0,97,120354,true,L-m-0 L-l-0 L-l-0 C-m-1 C-m-0 C-m-2 C-l-1 
job-2407,4,12,1,120215,120215,120359,0,144,120379,true,L-s-0 
job-2411,4,12,6,120419,120419,120438,0,19,120660,true,L-s-0 C-s-0 C-s-1 C-s-2 C-m-2 C-m-2 
job-2410,6,6,5,120366,120366,120471,0,105,120522,true,L-m-0 L-l-0 L-l-0 C-m-1 C-m-0 
job-2413,2,7,4,120511,120511,120543,0,32,120658,true,L-m-0 L-m-0 L-m-0 L-m-0 
job-2412,3,6,3,120469,120469,120630,0,161,120896,true,L-s-0 C-s-0 C-s-1 
job-2414,2,5,6,120565,120565,120630,0,65,120824,true,L-m-0 L-m-0 L-m-0 L-m-0 L-l-0 L-l-0 
job-2417,5,12,4,120695,120695,120740,0,45,120751,true,C-l-0 L-m-0 C-l-2 C-l-2 
job-2416,4,6,1,120647,120647,120799,0,152,120989,true,L-l-0 
job-2418,6,11,5,120745,120799,120812,54,13,121028,true,L-l-0 C-l-0 L-m-0 C-l-2 C-l-2 
job-2419,6,5,1,120788,120812,120916,24,104,121139,true,L-l-0 
job-2421,5,7,3,120890,120890,120931,0,41,121125,true,C-l-0 L-m-0 C-l-2 
job-2420,1,12,4,120843,120843,120979,0,136,121252,true,C-m-1 C-m-0 C-m-2 C-l-0 
job-2415,6,11,7,120610,120610,120985,0,375,121175,true,L-l-0 C-m-1 C-m-0 C-m-2 C-l-1 C-l-1 C-l-0 
job-2422,2,12,1,120941,120941,121028,0,87,121157,true,L-l-0 
job-2424,2,12,1,121038,121038,121075,0,37,121083,true,L-l-0 
job-2423,1,11,3,120991,120991,121128,0,137,121203,true,L-l-0 L-l-0 L-l-0 
job-2425,5,7,5,121087,121087,121198,0,111,121458,true,L-l-0 L-m-0 C-m-1 C-m-0 C-m-2 
job-2426,6,6,6,121137,121137,121276,0,139,121530,true,L-l-0 C-l-1 C-l-1 C-l-0 C-l-0 C-l-2 
job-2428,3,7,2,121238,121238,121279,0,41,121573,true,L-m-0 L-l-0 
job-2429,4,9,2,121285,121285,121327,0,42,121625,true,L-l-0 L-l-0 
job-2427,1,12,3,121187,121187,121407,0,220,121656,true,L-m-0 L-m-0 L-l-0 
job-2431,4,8,7,121376,121376,121410,0,34,121593,true,L-m-0 C-l-1 L-s-0 C-s-0 C-s-1 C-s-2 C-l-0 
job-2430,5,12,6,121342,121342,121431,0,89,121599,true,L-l-0 L-l-0 C-m-1 C-m-0 C-m-2 C-l-1 
job-2433,5,9,2,121488,121488,121557,0,69,121742,true,C-l-1 C-l-1 
job-2432,5,9,6,121443,121443,121576,0,133,121618,true,L-m-0 L-l-0 L-l-0 C-m-1 C-m-0 C-m-2 
job-2434,6,10,3,121531,121531,121634,0,103,121868,true,C-l-0 C-l-0 C-l-2 
job-2435,1,5,8,121578,121578,121666,0,88,121862,true,C-l-2 C-l-2 C-l-2 C-l-2 C-l-2 C-l-2 L-s-0 L-s-0 
job-2436,1,5,1,121622,121622,121733,0,111,121828,true,L-s-0 
job-2439,1,10,1,121778,121778,121790,0,12,121828,true,L-s-0 
job-2438,5,4,1,121730,121730,121825,0,95,121945,true,L-m-0 
job-2437,1,4,1,121676,121676,121847,0,171,122027,true,L-s-0 
job-2441,1,10,5,121889,121889,121953,0,64,121995,true,L-s-0 L-m-0 L-m-0 C-s-0 C-s-1 
job-2440,3,6,8,121845,121845,121988,0,143,122110,true,L-s-0 L-m-0 L-m-0 L-l-0 L-l-0 L-l-0 L-l-0 C-s-0 
job-2443,6,5,4,121990,121990,122058,0,68,122277,true,L-m-0 L-l-0 L-l-0 C-m-2 
job-2442,5,4,2,121937,121937,122060,0,123,122283,true,C-m-1 C-m-0 
job-2445,3,9,6,122067,122067,122086,0,19,122358,true,L-m-0 L-m-0 C-m-2 C-m-2 C-m-1 C-m-1 
job-2444,1,4,6,122024,122024,122095,0,71,122190,true,L-m-0 L-m-0 C-m-2 C-m-2 C-m-1 C-m-1 
job-2446,4,10,8,122110,122110,122129,0,19,122130,true,L-s-0 L-m-0 L-m-0 L-l-0 L-l-0 L-l-0 C-s-0 C-s-1 
job-2447,5,9,1,122152,122152,122191,0,39,122418,true,L-m-0 
job-2448,3,12,2,122211,122211,122285,0,74,122309,true,L-s-0 L-m-0 
job-2449,5,5,8,122265,122265,122343,0,78,122553,true,L-m-0 L-l-0 L-l-0 C-m-2 C-m-1 C-m-0 C-l-2 C-l-2 
job-2450,2,9,4,122326,122326,122395,0,69,122674,true,L-m-0 L-l-0 C-m-2 C-m-1 
job-2452,1,6,5,122421,122421,122495,0,74,122638,true,L-m-0 L-m-0 L-s-0 L-s-0 L-l-0 
job-2451,3,8,2,122384,122384,122594,0,210,122870,true,L-m-0 L-m-0 
job-2454,6,10,5,122516,122516,122625,0,109,122674,true,C-m-1 C-m-0 C-l-2 C-l-2 C-l-0 
job-2455,6,5,8,122566,122625,122732,59,107,122821,true,L-m-0 C-m-1 C-m-0 C-l-2 C-l-2 C-l-0 C-l-0 C-l-1 
job-2456,6,10,2,122624,122732,122770,108,38,122689,false,L-m-0 C-m-1 
job-2453,5,7,3,122466,122466,122774,0,308,122904,true,L-l-0 L-l-0 C-m-2 
job-2458,5,11,1,122736,122736,122786,0,50,122907,true,C-m-0 
job-2457,1,11,5,122690,122732,122833,42,101,123058,true,L-m-0 L-m-0 L-l-0 L-l-0 C-m-1 
job-2460,4,6,6,122830,122830,122899,0,69,123073,true,L-s-0 C-s-0 C-s-1 C-s-2 C-m-0 C-m-0 
job-2461,1,4,8,122879,122879,123045,0,166,123231,true,L-m-0 L-m-0 L-m-0 L-l-0 L-l-0 C-m-1 C-m-1 C-m-1 
job-2462,5,7,1,122932,122932,123108,0,176,123150,true,C-m-0 
job-2466,4,11,2,123144,123144,123165,0,21,123311,true,L-s-0 C-s-0 
job-2464,2,11,2,123037,123108,123194,71,86,123294,true,L-m-0 L-l-0 
job-2463,5,12,7,122983,123108,123269,125,161,123375,true,C-m-0 C-l-2 C-l-2 C-l-0 C-l-0 C-l-1 C-l-1 
job-2465,1,12,2,123095,123108,123295,13,187,123385,true,L-m-0 C-m-0 
job-2468,6,10,3,123229,123269,123331,40,62,123559,true,C-m-0 C-l-2 C-l-0 
job-2469,3,10,5,123288,123288,123346,0,58,123534,true,C-l-2 C-l-0 L-s-0 C-s-0 C-s-1 
job-2467,2,12,4,123184,123184,123348,0,164,123608,true,C-m-1 C-m-2 C-l-2 C-l-0 
job-2459,5,6,5,122786,122786,123381,0,595,123611,true,L-m-0 L-l-0 L-l-0 C-m-1 C-m-2 
job-2471,5,7,6,123387,123387,123420,0,33,123422,true,C-l-2 C-l-0 L-m-0 L-l-0 L-l-0 C-m-1 
job-2474,3,5,1,123531,123531,123580,0,49,123861,true,L-m-0 
job-2470,4,4,2,123338,123338,123590,0,252,123846,true,C-l-2 C-l-0 
job-2473,6,11,6,123482,123482,123656,0,174,123935,true,L-l-0 L-l-0 C-m-1 C-m-2 C-m-0 C-l-1 
job-2475,1,9,4,123573,123573,123668,0,95,123679,true,C-m-1 C-m-1 C-m-2 C-m-2 
job-2477,4,12,8,123670,123670,123719,0,49,123751,true,C-m-0 C-l-1 C-l-0 L-s-0 L-l-0 L-l-0 L-l-0 C-s-0 
job-2472,5,8,3,123433,123433,123833,0,400,124110,true,C-l-2 C-l-0 L-m-0 
job-2478,3,4,8,123718,123718,124009,0,291,124223,true,C-l-0 C-l-2 C-s-1 C-s-2 C-m-1 C-m-1 C-m-2 C-m-2 
job-2479,6,7,8,123767,124009,124019,242,10,124076,true,L-m-0 C-m-0 C-l-1 C-l-2 L-l-0 L-l-0 C-m-1 C-m-2 
job-2480,1,11,8,123824,124009,124038,185,29,123913,false,C-m-1 C-m-1 C-m-2 C-m-2 C-l-2 C-l-2 L-s-0 C-s-1 
job-2476,2,5,7,123620,123620,124066,0,446,124104,true,L-m-0 C-m-0 C-l-1 C-l-1 C-l-1 C-l-2 C-l-2 
job-2481,2,10,2,123882,124009,124091,127,82,124107,true,C-s-2 C-s-0 
job-2484,2,11,3,124011,124019,124111,8,92,124278,true,C-l-0 C-l-0 C-l-0 
job-2486,2,4,6,124123,124123,124136,0,13,124252,true,C-s-2 C-s-0 C-m-1 C-m-2 C-m-0 C-l-0 
job-2482,1,5,7,123928,124009,124157,81,148,124203,true,L-s-0 C-s-2 C-s-0 C-s-1 C-l-0 C-l-0 C-l-0 
job-2483,5,5,6,123974,124019,124176,45,157,124335,true,L-m-0 C-m-1 C-m-2 C-m-0 C-l-2 C-l-1 
job-2485,1,9,5,124072,124072,124178,0,106,124239,true,L-s-0 L-m-0 L-m-0 L-m-0 C-s-1 
job-2488,3,9,4,124201,124201,124211,0,10,124315,true,C-m-1 C-m-2 L-m-0 L-m-0 
job-2489,4,7,2,124246,124246,124317,0,71,124485,true,C-m-1 C-m-2 
job-2490,1,5,6,124290,124290,124319,0,29,124378,true,L-s-0 C-s-1 C-m-1 C-m-2 L-m-0 L-m-0 
job-2491,5,5,5,124325,124325,124354,0,29,124523,true,C-m-1 C-m-2 L-m-0 L-l-0 L-l-0 
job-2492,4,10,2,124379,124379,124399,0,20,124459,true,C-m-1 C-m-2 
job-2494,3,8,8,124475,124475,124535,0,60,124601,true,L-m-0 C-m-0 C-s-2 C-s-0 C-l-1 C-l-1 C-l-1 C-l-1 
job-2487,3,5,4,124161,124161,124538,0,377,124685,true,L-s-0 C-s-1 C-m-1 C-m-2 
job-2493,5,8,8,124429,124429,124601,0,172,124606,true,C-m-1 C-m-2 L-m-0 L-l-0 L-l-0 C-m-0 C-l-2 C-l-2 
job-2495,4,9,6,124542,124542,124666,0,124,124777,true,L-s-0 C-s-1 C-s-2 C-s-0 C-l-1 C-l-1 
job-2496,4,8,8,124589,124601,124710,12,109,124784,true,C-l-1 L-m-0 L-m-0 L-l-0 L-l-0 L-l-0 C-m-1 C-m-1 
job-2497,3,6,4,124634,124634,124831,0,197,125083,true,C-m-2 C-m-2 C-m-0 C-m-0 
job-2499,4,8,6,124744,124744,124883,0,139,125002,true,L-s-0 L-m-0 L-m-0 L-l-0 L-l-0 L-l-0 
job-2501,2,10,1,124849,124849,124894,0,45,125100,true,C-m-1 
job-2502,1,8,4,124902,124902,124923,0,21,124973,true,C-s-1 C-s-2 C-s-0 C-m-1 
job-2498,1,4,3,124689,124689,124984,0,295,125141,true,C-m-2 C-m-2 C-m-0 
job-2503,1,8,4,124959,124959,125000,0,41,125097,true,C-s-1 C-s-2 C-s-0 C-m-1 
job-2504,6,12,7,125001,125001,125013,0,12,125122,true,L-m-0 L-l-0 L-l-0 C-m-2 C-m-0 C-l-2 C-l-2 
job-2500,3,6,8,124809,124809,125014,0,205,125266,true,C-s-1 C-s-2 C-s-0 C-m-1 C-m-1 C-l-1 C-l-1 C-l-1 
job-2505,1,5,7,125059,125059,125170,0,111,125377,true,L-s-0 L-s-0 L-s-0 L-m-0 L-m-0 L-m-0 L-m-0 
job-2506,5,9,1,125115,125115,125184,0,69,125362,true,L-l-0 
job-2507,2,8,4,125159,125159,125255,0,96,125349,true,L-m-0 L-l-0 L-l-0 L-l-0 
job-2509,6,11,1,125262,125262,125299,0,37,125309,true,L-l-0 
job-2511,3,11,4,125342,125342,125359,0,17,125581,true,L-l-0 L-l-0 C-s-1 C-s-2 
job-2508,3,4,1,125212,125212,125401,0,189,125533,true,L-m-0 
job-2513,1,8,3,125444,125444,125463,0,19,125614,true,L-s-0 L-m-0 L-m-0 
job-2510,3,5,4,125309,125309,125465,0,156,125674,true,L-m-0 L-s-0 L-l-0 L-l-0 
job-2512,2,11,1,125388,125388,125487,0,99,125525,true,L-m-0 
job-2517,6,8,4,125640,125640,125651,0,11,125770,true,C-l-2 C-l-2 C-l-0 C-l-0 
job-2516,3,12,7,125597,125597,125731,0,134,125750,true,C-m-2 C-m-2 C-m-0 C-m-0 C-l-1 C-l-1 C-l-1 
job-2514,6,12,4,125493,125493,125747,0,254,125796,true,L-m-0 L-l-0 L-l-0 C-m-1 
job-2515,3,10,4,125539,125539,125898,0,359,126020,true,L-s-0 C-s-1 C-s-2 C-s-0 
job-2518,5,5,3,125696,125696,125903,0,207,125916,true,C-l-2 C-l-2 C-l-0 
job-2519,5,12,8,125743,125747,125928,4,181,126033,true,C-l-0 L-m-0 L-l-0 L-l-0 C-m-1 C-m-2 C-m-0 C-l-1 
job-2522,1,6,5,125916,125916,125952,0,36,125967,true,L-m-0 L-m-0 L-m-0 L-l-0 L-l-0 
job-2521,6,7,2,125851,125903,125962,52,59,125985,true,C-l-0 C-l-2 
job-2523,3,6,3,125965,125965,125998,0,33,126069,true,C-l-1 C-l-1 L-m-0 
job-2520,4,6,2,125795,125898,126106,103,208,126235,true,C-l-1 L-s-0 
job-2526,2,9,8,126135,126135,126145,0,10,126382,true,L-m-0 C-l-1 C-l-1 C-l-1 L-s-0 C-s-2 C-s-0 C-m-1 
job-2524,6,6,2,126031,126031,126162,0,131,126415,true,C-l-1 L-m-0 
job-2527,4,12,5,126192,126192,126223,0,31,126395,true,L-s-0 L-m-0 L-m-0 C-s-2 C-s-0 
job-2525,3,11,5,126088,126088,126322,0,234,126412,true,L-l-0 L-l-0 L-l-0 L-l-0 C-s-1 
job-2528,6,4,5,126241,126241,126341,0,100,126437,true,L-m-0 C-m-1 C-m-2 C-m-0 C-l-1 
job-2530,4,6,2,126338,126338,126381,0,43,126628,true,L-s-0 L-l-0 
job-2529,6,7,5,126283,126283,126408,0,125,126687,true,C-l-1 C-l-0 C-l-0 C-l-2 C-l-2 
job-2531,3,12,5,126389,126389,126431,0,42,126543,true,C-l-1 C-l-1 L-s-0 L-m-0 L-m-0 
job-2532,1,11,6,126437,126437,126457,0,20,126648,true,L-s-0 L-m-0 L-m-0 L-l-0 L-l-0 L-l-0 
job-2534,4,12,7,126538,126538,126593,0,55,126815,true,L-l-0 L-l-0 C-s-1 C-s-2 C-s-0 C-m-1 C-m-1 
job-2533,1,10,6,126492,126492,126594,0,102,126693,true,L-s-0 L-m-0 L-m-0 L-m-0 L-l-0 L-l-0 
job-2536,3,10,4,126634,126634,126717,0,83,126938,true,C-l-0 C-l-0 L-s-0 L-m-0 
job-2535,2,10,8,126588,126588,126718,0,130,126804,true,C-m-2 C-m-2 C-m-2 C-m-0 C-m-0 C-m-0 C-l-0 C-l-0 
job-2538,3,4,7,126721,126721,126752,0,31,126921,true,L-m-0 C-m-1 C-l-2 C-l-2 L-s-0 C-s-1 C-s-2 
job-2540,5,7,6,126832,126832,126940,0,108,127112,true,C-l-2 C-m-2 C-m-0 C-l-0 C-l-0 C-l-1 
job-2537,5,11,5,126673,126673,127045,0,372,127271,true,L-m-0 L-l-0 L-l-0 C-m-1 C-l-2 
job-2544,3,11,3,127025,127045,127060,20,15,127127,true,C-m-0 C-m-2 C-l-2 
job-2542,5,12,7,126930,127045,127111,115,66,127095,false,L-m-0 L-l-0 L-l-0 C-l-2 C-m-1 C-m-0 C-l-0 
job-2545,4,7,7,127087,127111,127137,24,26,127186,true,L-m-0 L-l-0 L-l-0 C-m-2 C-m-1 C-l-2 C-l-2 
job-2543,3,9,1,126981,127045,127143,64,98,127133,false,C-m-1 
job-2546,4,6,5,127148,127148,127161,0,13,127347,true,L-m-0 L-l-0 L-l-0 C-m-2 C-l-2 
job-2541,4,10,6,126869,126940,127175,71,235,127318,true,C-l-2 L-s-0 C-s-1 C-s-2 C-s-0 C-m-2 
job-2539,1,11,3,126772,126772,127205,0,433,127380,true,L-m-0 L-l-0 L-l-0 
job-2547,4,8,6,127201,127201,127292,0,91,127351,true,L-m-0 L-l-0 L-l-0 L-s-0 C-s-1 C-s-2 
job-2548,3,9,1,127231,127231,127307,0,76,127503,true,L-m-0 
job-2549,5,11,2,127282,127282,127324,0,42,127539,true,C-m-2 C-m-1 
job-2550,4,10,4,127333,127333,127363,0,30,127600,true,L-s-0 L-m-0 L-m-0 L-l-0 
job-2551,6,8,7,127377,127377,127399,0,22,127609,true,L-m-0 L-l-0 L-l-0 C-m-2 C-m-1 C-m-0 C-l-2 
job-2553,6,9,7,127484,127484,127508,0,24,127725,true,C-m-2 C-m-1 C-m-0 C-l-2 C-l-2 C-l-0 C-l-0 
job-2552,5,11,3,127442,127442,127552,0,110,127575,true,L-m-0 L-l-0 L-l-0 
job-2554,4,5,7,127525,127525,127576,0,51,127697,true,L-s-0 C-s-1 C-s-2 C-s-0 C-m-2 C-m-2 C-m-1 
job-2555,4,12,4,127591,127591,127675,0,84,127870,true,L-s-0 L-m-0 L-m-0 L-l-0 
job-2557,3,11,2,127681,127681,127727,0,46,128009,true,L-l-0 L-l-0 
job-2556,1,5,5,127631,127631,127773,0,142,128053,true,L-l-0 L-l-0 L-l-0 L-l-0 L-l-0 
job-2560,4,7,1,127841,127841,127851,0,10,128007,true,C-l-0 
job-2558,5,10,6,127742,127742,127876,0,134,127958,true,L-l-0 L-m-0 C-m-2 C-m-1 C-m-0 C-l-2 
job-2559,4,9,6,127792,127792,127879,0,87,128031,true,L-l-0 C-l-2 L-s-0 C-s-1 C-s-2 C-s-0 
job-2561,1,5,7,127887,127887,127899,0,12,127955,true,L-s-0 L-s-0 L-s-0 L-m-0 L-m-0 L-m-0 L-m-0 
job-2562,2,8,2,127933,127933,128044,0,111,128119,true,L-s-0 L-s-0 
job-2563,4,11,4,127981,127981,128046,0,65,128198,true,L-m-0 L-m-0 L-l-0 L-l-0 
job-2564,1,6,4,128023,128023,128124,0,101,128188,true,L-l-0 L-l-0 L-l-0 L-l-0 
job-2565,5,8,4,128069,128069,128159,0,90,128445,true,L-l-0 L-m-0 C-m-2 C-m-1 
job-2566,1,11,7,128129,128129,128196,0,67,128241,true,L-m-0 L-m-0 L-l-0 L-l-0 L-l-0 C-m-2 C-m-2 
job-2567,6,12,8,128181,128181,128278,0,97,128504,true,L-l-0 C-m-1 C-m-0 C-l-2 C-l-2 C-l-0 C-l-0 C-l-1 
job-2568,5,9,7,128235,128278,128295,43,17,128486,true,L-m-0 L-l-0 L-l-0 C-m-1 C-m-0 C-m-2 C-l-2 
job-2570,2,9,7,128330,128330,128361,0,31,128544,true,L-m-0 L-l-0 L-l-0 C-m-1 C-m-1 L-s-0 C-s-1 
job-2571,5,4,3,128382,128382,128403,0,21,128414,true,L-m-0 L-l-0 L-l-0 
job-2569,1,11,5,128294,128294,128510,0,216,128533,true,L-m-0 L-m-0 L-l-0 L-l-0 C-m-1 
job-2573,3,11,8,128473,128473,128571,0,98,128656,true,L-s-0 C-s-1 C-s-2 C-s-0 C-m-0 C-m-0 C-m-2 C-m-2 
job-2575,2,5,5,128567,128567,128581,0,14,128867,true,L-m-0 C-m-0 C-m-2 C-m-1 C-m-1 
job-2572,1,10,5,128425,128425,128611,0,186,128853,true,L-m-0 L-l-0 L-l-0 C-m-1 C-m-1 
job-2574,5,8,3,128516,128516,128615,0,99,128831,true,L-m-0 L-l-0 L-l-0 
job-2576,3,9,8,128612,128612,128685,0,73,128827,true,L-m-0 L-s-0 C-s-1 C-s-2 C-s-0 C-m-0 C-m-0 C-m-2 
job-2577,5,12,4,128658,128658,128731,0,73,128829,true,L-m-0 C-m-2 L-l-0 L-l-0 
job-2578,2,8,2,128703,128703,128733,0,30,128970,true,L-m-0 L-l-0 
job-2579,5,10,4,128754,128754,128765,0,11,128783,true,L-m-0 L-l-0 L-l-0 C-m-2 
job-2581,3,7,5,128848,128848,128878,0,30,128959,true,L-m-0 C-m-2 C-m-0 L-s-0 C-s-1 
job-2580,5,5,5,128796,128796,128891,0,95,129012,true,L-m-0 L-l-0 L-l-0 C-m-2 C-m-0 
job-2582,2,8,6,128898,128898,128996,0,98,129167,true,L-s-0 L-s-0 L-m-0 L-m-0 L-m-0 L-m-0 
job-2583,4,9,2,128939,128939,129046,0,107,129303,true,L-l-0 L-l-0 
job-2584,1,4,5,128990,128990,129082,0,92,129102,true,L-l-0 L-l-0 L-l-0 L-l-0 C-s-1 
job-2585,6,10,6,129039,129039,129150,0,111,129279,true,L-m-0 C-m-2 C-m-0 C-m-1 C-l-2 C-l-2 
job-2586,5,9,5,129086,129086,129166,0,80,129188,true,L-l-0 L-l-0 C-l-0 C-l-0 C-l-1 
job-2589,6,10,2,129249,129249,129316,0,67,129500,true,C-m-2 C-m-0 
job-2590,1,7,7,129294,129294,129335,0,41,129413,true,L-s-0 L-m-0 C-s-1 C-s-2 C-m-2 C-m-2 C-m-0 
job-2587,3,8,5,129145,129145,129336,0,191,129482,true,C-l-1 C-l-1 L-s-0 C-s-1 C-s-2 
job-2588,3,12,8,129207,129207,129345,0,138,129359,true,C-l-1 C-l-1 L-m-0 L-m-0 L-l-0 L-l-0 L-l-0 L-l-0 
job-2592,6,4,4,129388,129388,129419,0,31,129506,true,C-m-2 C-m-0 C-m-1 C-l-1 
job-2593,4,11,4,129438,129438,129471,0,33,129595,true,L-s-0 C-s-1 C-s-2 C-s-0 
job-2594,2,12,5,129504,129504,129521,0,17,129526,true,L-m-0 L-l-0 L-s-0 C-s-1 C-s-2 
job-2591,5,12,3,129345,129345,129530,0,185,129549,true,L-m-0 L-l-0 L-l-0 
job-2596,3,12,6,129591,129591,129623,0,32,129722,true,C-s-2 C-s-0 C-m-2 C-m-2 C-m-0 C-m-0 
job-2597,5,11,1,129643,129643,129664,0,21,129740,true,C-m-2 
job-2598,3,7,1,129700,129700,129736,0,36,129982,true,C-s-2 
job-2595,3,8,8,129546,129546,129787,0,241,130018,true,L-s-0 L-m-0 L-m-0 L-l-0 L-l-0 L-l-0 L-l-0 C-s-1 
job-2600,3,4,8,129810,129810,129892,0,82,130067,true,L-s-0 L-m-0 L-m-0 L-l-0 L-l-0 L-l-0 L-l-0 C-s-1 
job-2602,2,9,6,129908,129908,129980,0,72,130223,true,L-m-0 L-m-0 L-s-0 L-l-0 L-l-0 L-l-0 
job-2603,5,5,4,129965,129965,129987,0,22,130200,true,L-l-0 C-m-1 C-l-1 C-l-1 
job-2601,2,8,4,129856,129856,129997,0,141,130164,true,L-m-0 C-m-0 C-m-0 C-m-0 
job-2604,6,7,5,130019,130019,130093,0,74,130281,true,L-m-0 L-l-0 L-l-0 C-m-0 C-m-1 
job-2605,6,5,1,130064,130064,130118,0,54,130164,true,C-l-1 
job-2606,2,6,2,130117,130117,130127,0,10,130150,true,C-l-1 C-l-1 
job-2608,1,5,6,130214,130214,130262,0,48,130282,true,L-m-0 L-m-0 L-m-0 L-l-0 L-l-0 C-m-0 
job-2599,4,4,4,129757,129757,130342,0,585,130342,false,C-s-2 C-s-0 C-m-2 C-m-2 
job-2607,5,5,5,130162,130162,130376,0,214,130512,true,L-m-0 L-l-0 L-l-0 C-m-0 C-m-1 
job-2609,1,11,6,130257,130257,130401,0,144,130458,true,C-m-0 C-m-0 C-m-1 C-m-1 L-s-0 C-s-1 
job-2612,2,6,2,130406,130406,130418,0,12,130681,true,L-s-0 L-s-0 
job-2613,5,9,3,130452,130452,130485,0,33,130655,true,L-m-0 L-l-0 L-l-0 
job-2611,4,11,1,130351,130351,130486,0,135,130557,true,C-s-2 
job-2614,6,5,4,130505,130505,130521,0,16,130612,true,L-m-0 L-l-0 L-l-0 C-m-0 
job-2610,4,10,6,130313,130313,130538,0,225,130581,true,C-l-1 C-l-1 C-l-1 C-l-2 C-l-2 C-l-2 
job-2615,2,6,6,130555,130555,130618,0,63,130700,true,L-s-0 L-s-0 L-m-0 L-m-0 L-m-0 L-m-0 
job-2616,2,10,8,130603,130603,130673,0,70,130852,true,L-l-0 L-l-0 L-l-0 L-l-0 C-s-2 C-s-1 C-s-0 C-m-0 
job-2617,3,7,1,130651,130651,130675,0,24,130923,true,L-l-0 
job-2621,6,7,1,130861,130861,130877,0,16,130929,true,C-l-1 
job-2622,1,6,7,130898,130898,130927,0,29,131147,true,L-s-0 L-m-0 L-m-0 C-s-2 C-m-1 C-m-2 C-l-1 
job-2620,3,11,8,130812,130812,130928,0,116,131023,true,C-m-0 C-s-1 C-s-0 C-m-1 C-m-1 C-m-2 C-m-2 C-l-1 
job-2619,5,6,1,130756,130756,130979,0,223,131114,true,C-m-0 
job-2623,4,9,4,130950,130950,131068,0,118,131184,true,C-s-1 C-s-0 C-m-1 C-m-1 
job-2625,6,4,1,131044,131044,131131,0,87,131321,true,C-l-2 
job-2618,3,5,8,130707,130707,131181,0,474,131419,true,L-s-0 L-m-0 L-m-0 L-l-0 L-l-0 L-l-0 L-l-0 C-s-2 
job-2627,1,12,5,131147,131181,131214,34,33,131288,true,L-m-0 L-l-0 L-l-0 C-m-1 C-l-2 
job-2628,4,12,1,131212,131212,131239,0,27,131432,true,L-s-0 
job-2626,5,10,6,131096,131181,131259,85,78,131244,false,L-m-0 L-l-0 L-l-0 C-m-1 C-l-2 C-l-2 
job-2630,5,10,2,131313,131313,131338,0,25,131588,true,C-l-2 C-l-2 
job-2624,3,11,8,130991,130991,131442,0,451,131490,true,C-m-0 C-m-0 C-m-2 C-m-2 C-l-1 C-l-1 C-l-1 C-l-1 
job-2629,5,8,4,131261,131261,131453,0,192,131725,true,L-m-0 L-l-0 L-l-0 C-m-1 
job-2632,1,10,4,131421,131421,131485,0,64,131670,true,L-m-0 C-m-1 C-m-0 C-m-2 
job-2634,1,10,3,131518,131518,131554,0,36,131692,true,L-m-0 L-m-0 C-m-1 
job-2633,3,11,3,131468,131468,131565,0,97,131622,true,L-l-0 L-l-0 L-l-0 
job-2635,2,12,8,131561,131561,131584,0,23,131865,true,L-m-0 C-m-1 C-s-0 C-m-0 C-m-0 C-m-2 C-m-2 C-l-1 
job-2631,2,12,6,131368,131368,131636,0,268,131804,true,L-m-0 L-l-0 C-m-1 L-s-0 C-s-2 C-s-1 
job-2636,5,9,3,131619,131619,131727,0,108,131750,true,L-m-0 L-l-0 L-l-0 
job-2638,2,10,2,131726,131726,131739,0,13,131831,true,L-m-0 L-l-0 
job-2637,6,10,4,131668,131668,131770,0,102,131920,true,C-m-1 C-m-0 C-m-2 C-l-1 
job-2639,6,5,6,131770,131770,131875,0,105,132171,true,L-m-0 L-l-0 L-l-0 C-m-1 C-m-0 C-m-2 
job-2642,3,9,1,131910,131910,132026,0,116,132177,true,C-l-1 
job-2641,1,12,6,131858,131858,132075,0,217,132142,true,L-s-0 L-m-0 L-m-0 C-s-2 C-s-1 C-s-0 
job-2643,4,8,7,131950,131950,132102,0,152,132317,true,L-m-0 L-l-0 L-l-0 L-l-0 C-m-1 C-m-1 C-m-0 
job-2644,6,12,7,132001,132102,132125,101,23,132257,true,C-l-1 L-m-0 L-l-0 L-l-0 C-m-1 C-m-0 C-m-2 
job-2640,3,4,6,131812,131812,132129,0,317,132258,true,L-s-0 C-s-2 C-s-1 C-s-0 C-l-1 C-l-1 
job-2646,4,11,3,132103,132125,132141,22,16,132273,true,C-m-2 C-m-2 C-l-2 
job-2645,6,6,6,132052,132125,132192,73,67,132313,true,C-l-1 L-m-0 L-l-0 L-l-0 C-m-1 C-m-0 
job-2647,5,6,1,132152,132152,132238,0,86,132484,true,C-l-1 
job-2648,2,8,6,132196,132196,132271,0,75,132408,true,C-l-1 C-l-1 C-l-1 L-s-0 L-s-0 L-m-0 
job-2649,4,6,3,132244,132244,132300,0,56,132565,true,L-m-0 C-l-1 L-l-0 
job-2650,1,7,4,132293,132293,132331,0,38,132623,true,L-m-0 L-m-0 L-m-0 L-l-0 
job-2651,3,11,7,132335,132335,132433,0,98,132688,true,L-s-0 L-m-0 L-m-0 L-l-0 L-l-0 L-l-0 L-l-0 
job-2652,1,7,4,132387,132387,132434,0,47,132531,true,L-m-0 C-s-2 C-s-2 C-s-1 
job-2654,2,12,5,132484,132484,132549,0,65,132842,true,L-l-0 L-l-0 C-s-2 C-s-1 C-s-0 
job-2656,3,6,7,132577,132577,132622,0,45,132881,true,L-l-0 C-s-1 C-s-0 C-m-1 C-m-1 C-m-0 C-m-0 
job-2655,2,4,3,132533,132533,132642,0,109,132801,true,L-l-0 L-l-0 C-s-2 
job-2657,3,4,8,132630,132630,132645,0,15,132716,true,L-l-0 C-s-1 C-s-0 C-m-1 C-m-1 C-m-0 C-m-0 C-m-2 
job-2658,1,9,8,132685,132685,132754,0,69,132952,true,L-l-0 L-l-0 L-l-0 C-s-2 C-s-1 C-s-0 C-m-1 C-m-1 
job-2659,3,5,7,132723,132723,132754,0,31,132809,true,L-l-0 C-s-2 C-s-1 C-s-0 C-m-1 C-m-1 C-m-0 
job-2660,2,12,3,132773,132773,132829,0,56,133071,true,L-l-0 L-l-0 C-s-2 
job-2662,4,10,5,132877,132877,132916,0,39,133200,true,L-l-0 C-s-2 C-m-1 C-m-1 C-m-0 
job-2661,4,4,3,132827,132827,132975,0,148,133034,true,L-l-0 C-s-1 C-s-0 
job-2663,3,12,3,132923,132923,133024,0,101,133184,true,L-l-0 C-s-2 C-m-1 
job-2653,2,7,8,132443,132443,133033,0,590,133073,true,L-s-0 L-s-0 L-m-0 L-m-0 L-m-0 L-m-0 L-l-0 L-l-0 
job-2665,1,6,8,133028,133028,133146,0,118,133303,true,L-l-0 L-l-0 L-l-0 L-l-0 L-l-0 C-m-0 C-m-0 C-m-2 
job-2666,2,5,7,133082,133082,133220,0,138,133363,true,L-l-0 L-l-0 L-l-0 C-m-1 C-m-1 C-l-1 C-l-1 
job-2668,1,10,7,133169,133169,133222,0,53,133387,true,L-m-0 L-m-0 L-l-0 L-l-0 L-l-0 C-m-1 C-m-0 
job-2664,3,8,6,132972,132972,133257,0,285,133300,true,C-m-1 C-m-0 C-m-0 C-m-2 C-m-2 C-l-1 
job-2670,4,7,7,133285,133285,133348,0,63,133464,true,C-l-1 L-s-0 L-l-0 L-l-0 L-l-0 C-s-2 C-s-1 
job-2669,6,6,2,133229,133229,133429,0,200,133442,true,C-l-2 C-l-1 
job-2673,6,12,2,133420,133420,133443,0,23,133526,true,L-l-0 L-l-0 
job-2671,6,9,3,133327,133327,133462,0,135,133641,true,C-m-0 C-m-2 C-m-1 
job-2672,1,12,8,133368,133368,133476,0,108,133476,false,L-m-0 L-m-0 C-m-0 C-m-2 C-m-1 C-l-1 C-l-1 C-l-1 
job-2667,6,6,2,133127,133127,133515,0,388,133619,true,L-m-0 C-l-2 
job-2674,1,8,3,133471,133471,133571,0,100,133805,true,C-m-0 C-m-0 C-m-2 
job-2675,3,5,8,133514,133514,133583,0,69,133837,true,C-m-0 C-m-0 C-m-2 C-m-2 C-l-2 C-l-2 L-s-0 L-l-0 
job-2677,4,12,4,133601,133601,133630,0,29,133654,true,L-l-0 L-l-0 L-m-0 L-m-0 
job-2678,1,6,1,133652,133652,133718,0,66,133822,true,L-s-0 
job-2680,2,7,2,133761,133761,133773,0,12,133995,true,L-s-0 L-m-0 
job-2679,2,12,7,133704,133704,133807,0,103,134032,true,L-l-0 L-l-0 L-m-0 L-m-0 C-s-2 C-s-1 C-s-0 
job-2681,2,12,8,133811,133811,133911,0,100,134124,true,L-l-0 L-l-0 L-m-0 L-m-0 C-s-2 C-s-1 C-s-0 C-m-0 
job-2676,1,5,4,133556,133556,133981,0,425,134065,true,L-s-0 L-l-0 L-l-0 L-l-0 
job-2684,4,5,1,133962,133962,134059,0,97,134114,true,L-m-0 
job-2683,4,7,4,133907,133907,134107,0,200,134296,true,L-m-0 C-m-1 C-l-2 C-l-2 
job-2682,2,9,8,133859,133859,134110,0,251,134186,true,L-s-0 L-l-0 C-m-0 C-m-0 C-m-2 C-m-2 C-m-2 C-m-1 
job-2687,6,4,5,134123,134123,134156,0,33,134190,true,C-m-2 C-m-1 C-l-2 C-l-2 C-l-1 
job-2686,3,9,4,134081,134081,134185,0,104,134478,true,L-m-0 L-l-0 L-l-0 C-m-0 
job-2685,2,7,3,134034,134034,134211,0,177,134456,true,L-s-0 L-l-0 L-l-0 
job-2688,2,6,4,134180,134180,134238,0,58,134308,true,L-s-0 L-m-0 L-m-0 L-l-0 
job-2689,6,8,8,134229,134229,134336,0,107,134379,true,L-l-0 C-m-0 C-m-2 C-m-1 C-l-2 C-l-2 C-l-1 C-l-1 
job-2690,6,4,6,134273,134336,134452,63,116,134465,true,L-m-0 L-l-0 L-l-0 C-m-0 C-m-2 C-m-1 
job-2692,6,12,6,134390,134452,134472,62,20,134559,true,L-m-0 L-l-0 L-l-0 C-m-0 C-m-2 C-m-1 
job-2691,6,9,2,134329,134336,134483,7,147,134537,true,C-l-2 C-l-2 
job-2694,6,4,2,134469,134469,134565,0,96,134818,true,C-l-1 C-l-0 
job-2693,4,9,5,134426,134452,134568,26,116,134699,true,L-s-0 C-s-2 C-s-1 C-s-0 C-l-1 
job-2696,6,12,1,134579,134579,134591,0,12,134730,true,C-l-0 
job-2697,1,10,6,134643,134643,134656,0,13,134813,true,C-m-0 C-m-0 C-l-0 C-l-0 C-l-0 L-s-0 
job-2698,3,4,7,134685,134685,134709,0,24,134892,true,C-m-0 C-l-0 C-l-0 L-s-0 C-s-2 C-s-1 C-s-0 
job-2700,1,5,2,134789,134789,134810,0,21,134904,true,C-m-2 C-m-2 
job-2699,6,10,2,134732,134732,134856,0,124,134866,true,C-l-0 C-m-2 
job-2701,5,5,1,134841,134841,134917,0,76,135191,true,C-m-1 
job-2702,2,8,3,134883,134883,135026,0,143,135309,true,C-m-0 C-m-0 C-m-1 
job-2695,4,9,7,134521,134521,135053,0,532,135078,true,C-l-0 L-m-0 L-m-0 L-l-0 L-l-0 L-l-0 C-m-0 
job-2703,3,8,7,134933,134933,135067,0,134,135083,true,C-m-1 C-m-1 C-l-0 C-l-0 L-s-0 C-s-2 C-s-1 
job-2705,3,9,2,135023,135023,135070,0,47,135156,true,C-l-2 C-l-2 
job-2704,6,8,4,134978,134978,135103,0,125,135304,true,C-m-2 C-l-1 C-l-1 C-l-2 
job-2708,6,6,3,135173,135173,135191,0,18,135194,true,C-m-2 C-l-1 C-l-1 
job-2706,5,8,6,135086,135086,135195,0,109,135411,true,C-l-2 L-m-0 L-l-0 L-l-0 C-m-0 C-m-1 
job-2707,2,11,5,135130,135130,135203,0,73,135406,true,L-m-0 L-l-0 C-m-0 C-m-1 C-l-2 
job-2709,2,4,5,135234,135234,135312,0,78,135345,true,L-s-0 L-s-0 L-m-0 L-m-0 L-m-0 
job-2711,4,12,3,135349,135349,135392,0,43,135550,true,L-m-0 L-l-0 L-l-0 
job-2710,1,4,4,135290,135290,135397,0,107,135497,true,L-m-0 L-m-0 L-l-0 L-l-0 
job-2713,3,9,1,135438,135438,135456,0,18,135672,true,L-m-0 
job-2715,2,4,2,135537,135537,135556,0,19,135710,true,L-m-0 L-l-0 
job-2712,4,6,2,135386,135386,135558,0,172,135843,true,L-s-0 C-s-2 
job-2714,5,10,6,135488,135488,135581,0,93,135752,true,L-m-0 L-l-0 L-l-0 C-m-0 C-m-1 C-m-2 
job-2717,1,11,1,135623,135623,135745,0,122,135955,true,L-m-0 
job-2718,3,4,7,135678,135678,135798,0,120,135892,true,L-m-0 L-m-0 L-l-0 L-l-0 L-l-0 L-l-0 C-s-2 
job-2716,2,9,1,135584,135584,135810,0,226,135841,true,L-s-0 
job-2720,5,4,5,135800,135800,135814,0,14,136084,true,L-m-0 L-l-0 L-l-0 C-m-2 C-l-2 
job-2721,4,11,4,135855,135855,135925,0,70,136206,true,L-s-0 L-m-0 L-m-0 L-l-0 
job-2719,3,6,6,135743,135743,135990,0,247,136276,true,C-s-1 C-s-0 C-m-0 C-m-0 C-m-1 C-m-1 
job-2723,1,4,1,135958,135958,136000,0,42,136065,true,L-l-0 
job-2722,5,4,3,135911,135911,136056,0,145,136233,true,L-l-0 C-m-2 C-l-2 
job-2724,1,4,3,136011,136011,136097,0,86,136347,true,L-l-0 L-l-0 L-l-0 
job-2727,2,4,2,136168,136168,136265,0,97,136383,true,L-s-0 L-m-0 
job-2729,2,12,5,136259,136259,136273,0,14,136323,true,C-m-0 C-m-1 C-m-1 C-l-2 C-l-2 
job-2726,6,8,1,136114,136114,136294,0,180,136507,true,L-l-0 
job-2725,2,12,7,136067,136067,136302,0,235,136554,true,L-l-0 L-l-0 L-l-0 L-s-0 L-m-0 L-m-0 C-s-1 
job-2728,2,9,6,136226,136226,136322,0,96,136611,true,C-s-0 C-s-2 C-m-2 C-m-2 C-m-2 C-m-0 
job-2730,6,7,3,136317,136317,136371,0,54,136584,true,C-m-0 L-m-0 L-l-0 
job-2731,6,12,8,136377,136377,136399,0,22,136501,true,L-m-0 L-l-0 L-l-0 C-m-2 C-m-0 C-m-1 C-l-2 C-l-2 
job-2733,2,4,2,136454,136454,136502,0,48,136687,true,L-m-0 C-m-2 
job-2732,6,9,6,136409,136409,136514,0,105,136647,true,L-m-0 L-l-0 L-l-0 C-m-2 C-m-0 C-m-1 
job-2735,6,11,8,136552,136552,136571,0,19,136715,true,L-m-0 L-l-0 L-l-0 C-m-2 C-m-0 C-m-1 C-l-2 C-l-2 
job-2734,4,12,4,136510,136510,136608,0,98,136756,true,L-s-0 C-s-0 C-s-2 C-s-1 
job-2737,5,8,5,136643,136643,136656,0,13,136787,true,C-m-2 C-m-0 C-m-1 C-l-2 C-l-2 
job-2738,6,8,7,136687,136687,136745,0,58,136828,true,C-m-2 C-m-0 C-m-1 C-l-2 C-l-2 C-l-1 C-l-1 
job-2739,4,12,7,136745,136745,136789,0,44,137068,true,L-s-0 C-s-0 C-s-2 C-s-1 C-m-2 C-m-2 C-m-0 
job-2740,1,5,4,136787,136787,136860,0,73,136867,true,L-m-0 L-l-0 L-l-0 C-m-0 
job-2736,3,12,5,136600,136600,136879,0,279,136940,true,L-m-0 L-m-0 L-l-0 L-l-0 L-l-0 
job-2742,1,12,7,136883,136883,136915,0,32,136950,true,C-s-0 C-m-0 L-m-0 L-m-0 L-l-0 L-l-0 L-l-0 
job-2741,2,4,6,136829,136829,136919,0,90,137215,true,C-m-0 C-m-0 C-m-0 L-s-0 L-s-0 C-s-0 
job-2745,6,5,1,137032,137032,137050,0,18,137082,true,C-m-2 
job-2744,6,4,4,136997,136997,137114,0,117,137228,true,L-m-0 L-l-0 L-l-0 C-m-0 
job-2743,2,7,2,136940,136940,137133,0,193,137330,true,L-s-0 L-s-0 
job-2746,3,6,5,137090,137090,137134,0,44,137406,true,C-s-0 C-s-2 C-s-1 C-m-2 C-m-2 
job-2748,4,9,1,137184,137184,137221,0,37,137454,true,L-m-0 
job-2749,5,4,7,137234,137234,137260,0,26,137412,true,L-m-0 L-l-0 L-l-0 C-m-0 C-m-2 C-m-1 C-l-2 
job-2750,5,6,2,137285,137285,137305,0,20,137432,true,L-m-0 L-l-0 
job-2747,1,5,5,137140,137140,137391,0,251,137584,true,L-s-0 L-s-0 L-s-0 L-m-0 L-m-0 
job-2752,2,5,6,137384,137384,137402,0,18,137583,true,C-s-0 C-s-0 C-s-2 C-s-2 C-s-1 C-s-1 
job-2751,6,11,3,137335,137335,137511,0,176,137528,true,L-m-0 L-l-0 L-l-0 
job-2755,3,8,5,137518,137518,137533,0,15,137597,true,L-m-0 L-m-0 C-l-2 C-l-2 L-l-0 
job-2753,2,5,7,137441,137441,137614,0,173,137667,true,L-m-0 L-s-0 L-s-0 C-s-0 C-s-0 C-s-2 C-s-2 
job-2756,4,5,3,137561,137561,137624,0,63,137758,true,L-m-0 C-l-2 C-l-2 
job-2757,5,12,5,137616,137616,137631,0,15,137846,true,L-l-0 L-l-0 C-l-1 C-l-1 C-l-0 
job-2754,4,7,8,137476,137476,137648,0,172,137676,true,C-s-1 C-m-0 C-m-0 C-m-2 C-m-2 C-m-1 C-m-1 C-l-2 
job-2758,2,4,6,137667,137667,137718,0,51,137953,true,L-s-0 L-s-0 L-m-0 L-m-0 L-m-0 L-m-0 
job-2759,5,7,8,137718,137718,137728,0,10,137732,true,L-m-0 L-l-0 L-l-0 C-m-0 C-m-2 C-m-1 C-l-2 C-l-2 
job-2762,2,9,1,137865,137865,137957,0,92,138239,true,L-m-0 
job-2760,3,10,1,137778,137778,137961,0,183,138171,true,L-s-0 
job-2761,3,7,6,137821,137821,137988,0,167,138234,true,L-m-0 L-m-0 L-l-0 L-l-0 L-l-0 L-l-0 
job-2763,1,12,5,137919,137919,138126,0,207,138386,true,C-s-1 C-s-0 C-s-2 C-m-0 C-m-0 
job-2767,3,12,4,138121,138121,138146,0,25,138352,true,C-m-1 C-l-2 C-l-2 C-l-2 
job-2766,3,6,5,138077,138077,138150,0,73,138305,true,L-s-0 L-l-0 C-m-2 C-m-0 C-m-1 
job-2764,1,9,3,137973,137973,138164,0,191,138371,true,L-m-0 L-m-0 L-s-0 
job-2769,3,7,2,138217,138217,138292,0,75,138435,true,L-l-0 C-m-2 
job-2770,5,11,1,138260,138260,138323,0,63,138441,true,C-m-1 
job-2765,2,10,7,138030,138030,138337,0,307,138388,true,L-m-0 L-l-0 L-l-0 L-l-0 L-l-0 C-m-2 C-m-2 
job-2771,4,4,6,138305,138305,138360,0,55,138409,true,L-l-0 C-m-2 L-s-0 C-s-1 C-s-0 C-s-2 
job-2772,6,6,8,138354,138354,138479,0,125,138765,true,L-l-0 C-m-1 C-l-2 C-l-2 C-l-1 C-l-1 C-l-0 C-l-0 
job-2768,5,8,2,138173,138173,138485,0,312,138624,true,L-m-0 C-m-0 
job-2773,5,6,4,138410,138479,138578,69,99,138634,true,L-l-0 L-l-0 C-m-1 C-m-2 
job-2776,1,12,6,138565,138578,138624,13,46,138873,true,L-m-0 L-l-0 L-l-0 C-m-1 C-m-2 C-m-0 
job-2777,3,6,5,138607,138607,138627,0,20,138679,true,C-l-1 C-l-1 L-s-0 C-s-1 C-s-0 
job-2774,6,6,2,138454,138479,138677,25,198,138804,true,C-l-2 C-l-2 
job-2778,3,5,4,138654,138654,138695,0,41,138847,true,L-m-0 C-m-1 C-m-2 C-m-0 
job-2775,5,9,7,138517,138578,138773,61,195,138907,true,L-m-0 L-l-0 L-l-0 C-m-1 C-m-2 C-m-0 C-l-1 
job-2779,4,9,8,138688,138688,138774,0,86,139045,true,C-l-1 L-s-0 C-s-1 C-s-0 C-s-2 C-l-2 C-l-2 C-l-2 
job-2780,6,9,7,138743,138773,138843,30,70,139103,true,C-l-1 L-m-0 L-l-0 L-l-0 C-m-1 C-m-2 C-m-0 
job-2781,3,11,1,138792,138792,138876,0,84,139105,true,C-l-1 
job-2782,4,9,5,138834,138834,138956,0,122,139041,true,L-s-0 C-s-1 C-s-0 C-s-2 C-l-2 
job-2783,6,6,4,138890,138890,138979,0,89,139118,true,C-l-2 L-m-0 L-l-0 L-l-0 
job-2784,6,12,6,138944,138944,139012,0,68,139215,true,C-m-1 C-m-2 C-m-0 C-l-1 C-l-1 C-l-0 
job-2785,6,7,4,138993,138993,139048,0,55,139324,true,C-l-0 L-m-0 L-l-0 L-l-0 
job-2787,1,12,8,139081,139081,139112,0,31,139354,true,C-l-0 C-l-0 L-m-0 L-m-0 L-l-0 L-l-0 L-l-0 L-l-0 
job-2788,1,7,3,139125,139125,139148,0,23,139165,true,C-l-0 C-l-0 C-l-0 
job-2786,3,12,5,139028,139028,139226,0,198,139351,true,C-l-0 C-l-0 L-s-0 C-s-1 C-s-0 
job-2789,4,6,1,139181,139181,139231,0,50,139402,true,C-l-0 
job-2790,3,10,2,139234,139234,139341,0,107,139468,true,L-s-0 L-m-0 
job-2791,4,6,3,139274,139274,139426,0,152,139579,true,L-m-0 L-l-0 L-l-0 
job-2792,6,11,7,139315,139315,139491,0,176,139628,true,C-m-1 C-m-2 C-m-0 C-l-0 C-l-0 C-l-1 C-l-1 
job-2793,2,5,3,139370,139370,139517,0,147,139570,true,L-m-0 L-m-0 L-l-0 
job-2794,5,7,5,139418,139491,139519,73,28,139603,true,L-l-0 L-l-0 C-m-1 C-m-2 C-m-0 
job-2796,1,8,5,139526,139526,139573,0,47,139848,true,C-l-0 C-l-0 C-l-1 C-l-1 L-s-0 
job-2797,6,6,2,139569,139569,139585,0,16,139820,true,L-m-0 L-l-0 
job-2795,5,11,4,139477,139491,139688,14,197,139907,true,C-l-0 C-l-0 C-l-1 C-l-1 
job-2800,1,9,3,139708,139708,139735,0,27,139975,true,L-l-0 C-l-0 C-l-0 
job-2801,2,8,4,139748,139748,139763,0,15,139924,true,L-l-0 C-l-0 C-l-0 C-l-0 
job-2798,3,8,5,139617,139617,139823,0,206,140020,true,L-s-0 L-m-0 L-m-0 L-l-0 L-l-0 
job-2799,1,11,7,139661,139661,139843,0,182,140042,true,L-m-0 L-l-0 L-l-0 C-l-0 C-l-0 C-l-1 C-l-1 
job-2802,6,9,8,139791,139823,139901,32,78,140024,true,L-m-0 L-l-0 C-l-0 C-l-1 C-m-1 C-m-2 C-m-0 C-l-2 
job-2804,2,6,1,139892,139892,139921,0,29,140029,true,L-m-0 
job-2803,4,12,6,139846,139846,139942,0,96,140164,true,L-l-0 C-l-0 C-l-1 C-l-2 L-s-0 C-s-1 
job-2805,6,9,7,139942,139942,139960,0,18,140141,true,L-m-0 L-l-0 L-l-0 C-m-1 C-m-2 C-m-0 C-l-0 
job-2806,1,8,6,139991,139991,140036,0,45,140308,true,L-s-0 L-s-0 L-m-0 L-m-0 L-m-0 L-m-0 
job-2807,6,8,8,140042,140042,140077,0,35,140133,true,L-m-0 L-l-0 L-l-0 C-m-1 C-m-2 C-m-0 C-l-0 C-l-0 
job-2810,4,8,4,140179,140179,140202,0,23,140337,true,C-s-1 C-s-0 C-s-2 C-l-1 
job-2809,3,7,5,140133,140133,140225,0,92,140315,true,L-m-0 C-m-1 C-m-2 C-m-0 L-s-0 
job-2808,5,12,8,140099,140099,140334,0,235,140339,true,L-m-0 L-l-0 L-l-0 C-m-1 C-m-2 C-m-0 C-l-0 C-l-0 
job-2811,6,6,8,140228,140334,140601,106,267,140714,true,L-m-0 L-l-0 L-l-0 C-m-1 C-m-2 C-m-0 C-l-0 C-l-0 
job-2813,1,11,2,140331,140601,140642,270,41,140489,false,L-m-0 L-m-0 
job-2818,1,10,8,140573,140601,140651,28,50,140736,true,C-l-0 C-l-0 C-l-1 C-l-1 C-l-1 C-l-2 C-l-2 C-l-2 
job-2812,5,6,8,140284,140601,140661,317,60,140461,false,L-m-0 L-l-0 L-l-0 C-m-1 C-m-2 C-m-0 C-l-0 C-l-0 
job-2814,1,9,3,140380,140601,140690,221,89,140728,true,L-l-0 L-l-0 C-m-1 
job-2815,4,5,3,140430,140601,140697,171,96,140681,false,L-s-0 C-s-1 C-s-0 
job-2817,3,9,5,140525,140601,140769,76,168,140895,true,C-m-2 C-m-0 C-s-2 C-l-1 C-l-1 
job-2819,4,10,7,140634,140661,140777,27,116,140831,true,L-l-0 L-l-0 C-m-1 C-m-2 C-m-0 C-l-1 L-m-0 
job-2816,1,9,1,140477,140601,140798,124,197,140773,false,C-m-1 
job-2820,4,4,4,140681,140681,140828,0,147,141082,true,L-m-0 C-l-0 C-l-0 C-l-0 
job-2821,6,5,3,140741,140769,140841,28,72,140828,false,C-l-1 C-l-2 C-l-2 
job-2823,3,4,4,140824,140824,140878,0,54,140907,true,L-m-0 L-l-0 L-l-0 C-m-2 
job-2822,2,8,5,140775,140775,140902,0,127,141164,true,L-l-0 L-l-0 C-m-1 C-m-2 C-m-2 
job-2826,4,10,4,140967,140967,141006,0,39,141096,true,L-s-0 L-m-0 L-m-0 L-l-0 
job-2824,6,5,4,140876,140876,141041,0,165,141340,true,C-m-1 C-m-0 C-l-0 C-l-0 
job-2827,1,5,8,141005,141005,141069,0,64,141358,true,L-l-0 L-l-0 L-l-0 L-l-0 L-l-0 L-l-0 L-l-0 C-s-2 
job-2828,1,10,2,141052,141052,141124,0,72,141165,true,L-l-0 C-s-2 
job-2830,6,5,5,141145,141145,141196,0,51,141246,true,L-l-0 L-m-0 C-m-2 C-l-0 C-l-0 
job-2825,1,5,4,140921,140921,141200,0,279,141382,true,C-m-1 C-m-1 C-m-0 C-m-0 
job-2831,4,6,7,141186,141186,141253,0,67,141515,true,C-s-2 C-s-1 C-s-0 C-l-2 C-l-2 C-l-2 C-l-1 
job-2832,2,11,8,141227,141227,141254,0,27,141494,true,L-l-0 C-m-1 C-m-0 C-l-1 C-l-1 C-l-1 L-m-0 L-m-0 
job-2829,1,10,8,141098,141098,141298,0,200,141340,true,L-l-0 L-l-0 L-l-0 C-m-1 C-m-1 C-m-0 C-m-0 L-s-0 
job-2834,6,7,2,141324,141324,141377,0,53,141387,true,L-l-0 C-m-1 
job-2835,1,10,2,141370,141370,141385,0,15,141434,true,L-l-0 L-l-0 
job-2833,1,9,7,141271,141271,141417,0,146,141551,true,L-l-0 L-l-0 C-m-1 C-m-0 L-m-0 L-m-0 L-m-0 
job-2836,2,9,3,141421,141421,141503,0,82,141703,true,L-s-0 L-m-0 L-m-0 
job-2837,2,8,1,141467,141467,141524,0,57,141624,true,L-m-0 
job-2838,1,6,6,141526,141526,141626,0,100,141880,true,L-s-0 L-s-0 L-m-0 L-m-0 L-m-0 L-m-0 
job-2839,3,10,8,141574,141574,141635,0,61,141813,true,L-l-0 L-l-0 L-l-0 L-l-0 C-s-2 C-s-1 C-s-0 C-m-1 
job-2840,4,5,8,141628,141628,141693,0,65,141715,true,C-m-1 L-s-0 L-m-0 L-m-0 C-m-0 C-m-0 C-m-2 C-m-2 
job-2841,3,11,1,141689,141689,141921,0,232,142107,true,C-m-1 
job-2842,1,9,1,141730,141730,141926,0,196,141946,true,C-m-1 
job-2843,6,8,3,141791,141791,141928,0,137,142214,true,L-m-0 L-l-0 L-l-0 
job-2846,6,4,3,141950,141950,141962,0,12,142060,true,L-m-0 L-l-0 L-l-0 
job-2844,1,11,1,141855,141855,141994,0,139,142181,true,L-m-0 
job-2847,3,9,5,141995,141995,142005,0,10,142122,true,C-m-1 L-m-0 L-m-0 L-l-0 L-l-0 
job-2848,6,4,5,142046,142046,142080,0,34,142298,true,L-m-0 L-l-0 L-l-0 C-m-0 C-m-2 
job-2845,2,5,5,141909,141909,142097,0,188,142164,true,C-m-1 C-m-1 L-s-0 L-s-0 C-s-2 
job-2850,1,6,4,142129,142129,142165,0,36,142313,true,L-m-0 L-m-0 C-m-1 C-m-1 
job-2849,3,10,7,142083,142083,142241,0,158,142255,true,C-m-1 L-m-0 L-m-0 L-l-0 L-l-0 L-l-0 L-l-0 
job-2852,2,8,7,142224,142224,142288,0,64,142553,true,C-s-2 C-s-2 C-s-1 C-s-1 C-s-0 C-s-0 C-m-0 
job-2851,2,10,4,142171,142171,142289,0,118,142341,true,L-m-0 C-m-1 C-m-1 L-s-0 
job-2853,2,9,8,142263,142263,142326,0,63,142471,true,L-m-0 L-m-0 C-m-1 C-m-0 C-m-0 L-l-0 L-l-0 L-l-0 
job-2854,6,11,7,142306,142306,142364,0,58,142603,true,L-l-0 C-m-1 C-m-2 C-l-2 C-l-2 C-l-1 C-l-1 
job-2857,1,4,5,142446,142446,142460,0,14,142642,true,L-m-0 L-m-0 L-l-0 L-l-0 C-m-1 
job-2858,3,11,7,142490,142490,142509,0,19,142800,true,L-s-0 C-s-2 C-s-1 C-s-0 C-l-2 C-l-2 C-l-2 
job-2856,6,4,5,142405,142405,142525,0,120,142704,true,L-l-0 L-m-0 C-m-1 C-m-2 C-m-0 
job-2855,1,5,4,142355,142355,142539,0,184,142626,true,L-l-0 L-l-0 L-l-0 L-l-0 
job-2859,3,9,2,142528,142528,142683,0,155,142934,true,L-l-0 L-l-0 
job-2860,4,6,4,142580,142580,142703,0,123,142733,true,L-l-0 L-s-0 L-m-0 L-m-0 
job-2862,5,12,2,142684,142684,142721,0,37,143002,true,L-l-0 C-l-2 
job-2863,1,9,8,142728,142728,142752,0,24,142832,true,C-m-0 C-m-0 L-s-0 L-m-0 L-m-0 L-m-0 L-l-0 L-l-0 
job-2861,4,10,8,142635,142635,142755,0,120,142831,true,C-s-2 C-s-1 C-s-0 C-m-1 C-m-1 C-m-2 C-m-2 C-m-0 
job-2864,5,12,6,142789,142789,142810,0,21,142916,true,L-m-0 L-l-0 L-l-0 C-m-1 C-m-2 C-m-0 
job-2865,1,4,5,142829,142829,142896,0,67,143165,true,L-s-0 L-s-0 L-s-0 L-s-0 L-m-0 
job-2867,5,7,2,142923,142923,142990,0,67,143252,true,C-m-1 C-m-2 
job-2866,5,8,3,142870,142870,143031,0,161,143131,true,L-m-0 L-l-0 L-l-0 
job-2868,1,6,6,142972,142972,143040,0,68,143047,true,L-m-0 L-m-0 L-m-0 L-l-0 L-l-0 C-m-1 
job-2870,1,5,8,143072,143072,143177,0,105,143207,true,C-m-1 C-m-1 C-m-2 C-m-2 C-m-0 C-m-0 C-l-1 C-l-1 
job-2869,6,7,6,143018,143018,143217,0,199,143470,true,C-m-1 C-m-2 C-m-0 C-l-2 C-l-2 C-l-1 
job-2872,1,8,2,143170,143170,143264,0,94,143426,true,L-s-0 L-s-0 
job-2873,4,5,5,143218,143218,143305,0,87,143350,true,C-l-1 C-l-1 L-m-0 L-m-0 L-l-0 
job-2874,1,12,8,143279,143279,143332,0,53,143375,true,L-l-0 L-l-0 L-l-0 L-s-0 C-s-2 C-s-1 C-s-0 C-m-1 
job-2871,4,10,1,143129,143129,143350,0,221,143454,true,C-l-1 
job-2876,1,4,8,143383,143383,143418,0,35,143621,true,L-s-0 L-m-0 L-m-0 C-l-1 C-l-1 C-l-1 C-l-1 C-l-1 
job-2877,6,5,6,143422,143422,143447,0,25,143639,true,C-l-1 L-l-0 L-l-0 C-m-1 C-m-2 C-m-0 
job-2875,3,9,5,143348,143348,143463,0,115,143490,true,C-l-1 C-l-1 L-s-0 L-m-0 L-m-0 
job-2879,2,8,7,143520,143520,143568,0,48,143831,true,L-m-0 L-l-0 L-s-0 L-s-0 C-s-2 C-s-2 C-s-1 
job-2881,1,10,3,143621,143621,143688,0,67,143812,true,L-m-0 L-m-0 L-l-0 
job-2880,5,7,3,143572,143572,143736,0,164,143839,true,C-m-1 C-m-2 C-m-0 
job-2882,2,9,4,143692,143692,143752,0,60,143873,true,L-m-0 L-l-0 C-m-1 C-m-2 
job-2883,3,6,2,143745,143745,143824,0,79,144073,true,C-m-1 C-m-1 
job-2878,5,4,3,143475,143475,143839,0,364,144076,true,L-m-0 L-l-0 L-l-0 
job-2884,1,9,6,143801,143801,143933,0,132,144040,true,L-m-0 L-m-0 L-m-0 L-l-0 L-l-0 C-m-1 
job-2885,4,5,4,143851,143851,144045,0,194,144158,true,L-m-0 L-l-0 L-l-0 C-m-1 
job-2888,5,9,2,143996,144045,144090,49,45,144339,true,L-m-0 L-l-0 
job-2886,5,6,8,143892,143892,144127,0,235,144130,true,C-m-2 C-m-0 C-l-1 C-l-1 C-l-2 C-l-2 C-l-0 C-l-0 
job-2887,1,7,5,143938,143938,144156,0,218,144328,true,L-m-0 L-m-0 L-m-0 L-l-0 L-l-0 
job-2889,5,6,7,144038,144127,144156,89,29,144315,true,L-m-0 L-l-0 L-l-0 C-m-2 C-m-0 C-m-1 C-l-1 
job-2891,4,12,8,144142,144156,144171,14,15,144360,true,C-l-1 L-s-0 L-m-0 L-m-0 L-l-0 L-l-0 L-l-0 C-s-2 
job-2890,5,7,3,144101,144127,144236,26,109,144303,true,C-l-1 C-l-2 C-l-2 
job-2895,3,4,2,144353,144353,144369,0,16,144490,true,C-l-0 C-l-1 
job-2893,4,11,3,144231,144231,144378,0,147,144506,true,C-l-0 L-s-0 C-s-2 
job-2896,1,12,5,144400,144400,144431,0,31,144649,true,L-m-0 C-m-2 C-m-0 C-m-1 C-l-0 
job-2894,2,7,5,144285,144285,144509,0,224,144639,true,L-m-0 L-l-0 C-m-2 C-m-0 C-m-1 
job-2897,6,9,3,144452,144452,144539,0,87,144610,true,C-l-0 C-l-1 C-l-2 
job-2892,5,7,8,144192,144192,144546,0,354,144600,true,C-l-1 L-m-0 L-l-0 L-l-0 C-m-2 C-m-0 C-m-1 C-l-0 
job-2898,4,5,4,144495,144495,144578,0,83,144786,true,C-l-2 L-s-0 C-s-2 C-s-1 
job-2899,3,10,2,144550,144550,144602,0,52,144833,true,C-l-2 C-l-2 
job-2900,3,12,6,144608,144608,144643,0,35,144763,true,L-s-0 L-m-0 L-m-0 L-l-0 L-l-0 L-l-0 
job-2901,1,5,7,144656,144656,144729,0,73,144913,true,L-s-0 L-s-0 L-s-0 L-m-0 L-m-0 L-m-0 L-m-0 
job-2902,5,8,4,144703,144703,144871,0,168,144928,true,L-l-0 L-l-0 C-m-2 C-m-0 
job-2903,4,4,3,144749,144749,144873,0,124,144977,true,L-s-0 L-m-0 L-m-0 
job-2905,6,7,1,144830,144830,144934,0,104,145012,true,C-l-2 
job-2904,4,5,5,144789,144789,144946,0,157,145110,true,C-s-2 C-s-1 C-s-0 C-m-1 C-m-1 
job-2906,3,4,4,144883,144883,144977,0,94,145234,true,C-l-2 C-l-2 L-s-0 L-m-0 
job-2907,2,12,2,144935,144935,145166,0,231,145365,true,L-m-0 L-m-0 
job-2908,1,9,8,144990,144990,145187,0,197,145209,true,L-s-0 L-l-0 L-l-0 L-l-0 L-l-0 L-l-0 C-s-2 C-s-1 
job-2909,6,4,2,145031,145031,145193,0,162,145264,true,C-m-1 C-m-2 
job-2910,1,8,7,145081,145081,145253,0,172,145410,true,L-m-0 C-m-1 C-m-1 C-m-2 C-m-2 C-s-0 C-s-0 
job-2913,3,10,6,145228,145228,145255,0,27,145372,true,C-m-1 C-m-2 C-l-0 C-l-0 C-l-0 L-s-0 
job-2912,2,11,8,145181,145181,145258,0,77,145325,true,L-m-0 L-m-0 C-m-0 C-l-2 C-l-2 C-l-2 C-l-2 C-l-0 
job-2914,1,8,6,145287,145287,145325,0,38,145606,true,C-m-0 C-m-0 L-s-0 L-s-0 L-m-0 L-m-0 
job-2911,6,5,1,145135,145135,145328,0,193,145594,true,C-m-0 
job-2915,6,10,6,145331,145331,145364,0,33,145420,true,L-m-0 L-l-0 L-l-0 C-m-0 C-m-1 C-m-2 
job-2916,3,7,7,145377,145377,145434,0,57,145469,true,L-s-0 L-m-0 L-m-0 L-l-0 L-l-0 L-l-0 L-l-0 
job-2918,3,4,8,145481,145481,145538,0,57,145763,true,C-m-0 C-m-1 C-m-2 C-l-2 C-l-2 L-s-0 L-m-0 L-m-0 
job-2917,5,10,4,145424,145424,145597,0,173,145865,true,C-m-0 C-m-1 C-m-2 C-l-2 
job-2920,4,8,4,145573,145573,145655,0,82,145774,true,L-l-0 C-l-2 L-s-0 L-m-0 
job-2919,4,10,2,145519,145519,145675,0,156,145842,true,L-l-0 L-l-0 
job-2922,6,7,6,145684,145684,145790,0,106,145872,true,C-l-2 L-m-0 L-l-0 L-l-0 C-m-1 C-m-2 
job-2921,6,5,2,145625,145625,145800,0,175,145904,true,C-l-2 C-m-0 
job-2924,1,6,3,145789,145789,145814,0,25,146102,true,C-m-0 C-m-0 L-s-0 
job-2925,4,11,3,145845,145845,145890,0,45,146060,true,L-m-0 C-m-1 C-m-2 
job-2927,5,7,1,145932,145932,145973,0,41,146160,true,L-m-0 
job-2928,5,10,2,145978,145978,146034,0,56,146315,true,L-m-0 C-m-1 
job-2923,2,7,3,145741,145741,146108,0,367,146286,true,L-m-0 C-m-1 C-m-2 
job-2930,4,7,2,146078,146078,146131,0,53,146342,true,L-m-0 C-m-1 
job-2926,4,11,8,145883,145883,146207,0,324,146229,true,L-s-0 L-l-0 L-l-0 L-l-0 C-s-0 C-s-2 C-s-1 C-m-0 
job-2929,4,12,6,146028,146028,146215,0,187,146354,true,C-m-0 C-m-2 C-l-2 C-l-2 C-l-2 C-l-0 
job-2932,6,7,4,146184,146207,146235,23,28,146360,true,L-l-0 L-l-0 C-l-1 C-l-1 
job-2931,4,4,6,146139,146139,146259,0,120,146500,true,C-m-2 C-l-0 C-l-0 L-m-0 L-m-0 C-m-1 
job-2933,5,10,4,146245,146245,146316,0,71,146426,true,L-l-0 L-l-0 C-m-0 C-l-2 
job-2934,3,11,1,146302,146302,146338,0,36,146445,true,C-m-0 
job-2936,5,11,3,146392,146392,146419,0,27,146699,true,C-m-0 C-m-2 C-m-1 
job-2939,4,7,6,146549,146549,146574,0,25,146735,true,C-l-2 C-l-2 C-l-2 C-l-0 C-l-0 C-l-0 
job-2935,3,9,8,146348,146348,146714,0,366,146852,true,L-s-0 L-m-0 L-m-0 L-l-0 L-l-0 L-l-0 L-l-0 C-s-0 
job-2937,6,4,2,146447,146447,146731,0,284,146793,true,C-m-0 C-m-2 
job-2941,6,5,4,146641,146714,146737,73,23,146801,true,L-m-0 L-l-0 L-l-0 C-l-1 
job-2940,6,4,4,146590,146590,146743,0,153,146859,true,C-l-2 C-l-2 C-l-0 C-l-0 
job-2942,5,12,1,146710,146714,146784,4,70,146849,true,C-l-1 
job-2944,6,6,8,146809,146809,146827,0,18,147096,true,L-m-0 L-l-0 L-l-0 C-m-0 C-m-2 C-l-1 C-l-1 C-l-2 
job-2938,3,11,4,146507,146507,146829,0,322,146975,true,C-s-2 C-s-1 C-m-1 C-m-1 
job-2943,2,6,1,146760,146760,146838,0,78,147022,true,C-m-1 
job-2945,4,7,3,146860,146860,146999,0,139,147248,true,L-s-0 L-m-0 L-m-0 
job-2946,3,9,3,146911,146911,147017,0,106,147212,true,L-l-0 L-l-0 L-l-0 
job-2948,1,4,7,147005,147005,147020,0,15,147258,true,C-s-2 C-s-1 C-s-0 C-m-1 C-m-1 C-m-0 C-m-0 
job-2947,3,7,7,146949,146949,147021,0,72,147191,true,L-l-0 C-s-2 C-s-1 C-s-0 C-m-1 C-m-1 C-m-0 
job-2949,3,9,3,147057,147057,147073,0,16,147274,true,L-s-0 L-m-0 L-m-0 
job-2950,5,9,4,147116,147116,147174,0,58,147336,true,L-m-0 L-l-0 L-l-0 C-m-1 
job-2951,6,10,1,147178,147178,147224,0,46,147249,true,L-m-0 
job-2952,4,6,8,147228,147228,147315,0,87,147498,true,L-s-0 L-m-0 L-m-0 L-l-0 L-l-0 L-l-0 C-s-2 C-s-1 
job-2953,4,10,5,147274,147274,147369,0,95,147377,true,C-s-0 C-m-1 C-m-1 C-m-0 C-m-0 
job-2955,4,7,1,147380,147380,147426,0,46,147686,true,L-m-0 
job-2956,6,10,5,147425,147425,147534,0,109,147667,true,L-l-0 L-l-0 C-m-1 C-m-0 C-m-2 
job-2957,3,8,1,147469,147469,147545,0,76,147704,true,L-m-0 
job-2954,1,4,8,147327,147327,147598,0,271,147856,true,L-s-0 L-s-0 L-s-0 L-s-0 L-m-0 L-m-0 L-m-0 L-m-0 
job-2958,1,8,5,147519,147519,147764,0,245,147953,true,L-m-0 C-m-1 C-m-1 C-m-0 C-m-0 
job-2960,2,9,8,147624,147624,147769,0,145,147775,true,L-m-0 L-m-0 L-l-0 C-m-2 C-l-1 C-l-2 C-l-2 C-l-2 
job-2959,5,7,8,147576,147576,147778,0,202,147839,true,C-m-1 C-m-0 L-l-0 L-l-0 C-m-2 C-l-1 C-l-1 C-l-2 
job-2963,1,11,2,147768,147768,147817,0,49,147923,true,C-m-2 C-m-1 
job-2964,3,9,5,147821,147821,147844,0,23,147974,true,L-m-0 L-m-0 C-l-0 C-l-0 L-l-0 
job-2961,2,5,5,147665,147665,147896,0,231,147966,true,L-m-0 L-s-0 L-s-0 C-s-0 C-s-0 
job-2965,5,12,5,147876,147876,147913,0,37,148024,true,L-m-0 C-l-0 L-l-0 L-l-0 C-m-2 
job-2966,6,10,2,147927,147927,147973,0,46,147992,true,C-l-0 L-m-0 
job-2962,4,9,3,147720,147720,148018,0,298,148310,true,C-s-2 C-s-1 C-l-0 
job-2967,1,9,1,147982,147982,148044,0,62,148331,true,C-l-0 
job-2969,4,5,3,148073,148073,148104,0,31,148325,true,L-m-0 L-l-0 L-l-0 
job-2970,1,11,4,148126,148126,148189,0,63,148281,true,L-s-0 L-m-0 L-m-0 C-l-0 
job-2971,2,5,3,148172,148172,148291,0,119,148309,true,L-m-0 C-l-0 L-l-0 
job-2968,3,5,5,148022,148022,148319,0,297,148558,true,C-l-0 C-l-0 C-l-0 L-s-0 L-m-0 
job-2975,1,6,7,148354,148354,148405,0,51,148546,true,L-s-0 L-s-0 L-m-0 L-m-0 L-m-0 L-l-0 C-s-2 
job-2977,4,6,3,148447,148447,148479,0,32,148714,true,L-m-0 C-m-1 C-m-1 
job-2976,3,12,3,148398,148398,148513,0,115,148638,true,C-l-0 C-l-0 C-l-0 
job-2972,2,8,4,148217,148217,148515,0,298,148710,true,L-m-0 L-l-0 L-l-0 L-l-0 
job-2978,1,6,2,148493,148493,148533,0,40,148764,true,L-s-0 L-s-0 
job-2974,4,4,4,148308,148308,148536,0,228,148806,true,C-s-1 C-s-0 C-m-2 C-m-2 
job-2979,6,11,6,148547,148547,148667,0,120,148929,true,L-m-0 L-l-0 C-l-0 C-m-2 C-m-1 C-m-0 
job-2981,3,8,1,148644,148644,148749,0,105,148946,true,L-s-0 
job-2973,1,4,8,148261,148261,148763,0,502,148988,true,L-s-0 L-m-0 L-l-0 L-l-0 L-l-0 L-l-0 C-l-0 C-s-2 
job-2982,5,7,2,148686,148686,148877,0,191,148963,true,L-m-0 L-l-0 
job-2980,6,4,3,148594,148594,148881,0,287,149125,true,C-l-2 C-l-2 C-l-1 
job-2985,1,11,8,148810,148881,148933,71,52,149151,true,L-m-0 L-m-0 C-m-2 C-m-2 C-m-1 C-m-1 C-m-0 C-m-0 
job-2983,5,5,2,148732,148732,148978,0,246,149107,true,C-l-1 C-l-0 
job-2984,6,4,8,148771,148881,149049,110,168,149108,true,C-l-1 C-l-0 L-m-0 L-l-0 L-l-0 C-m-2 C-m-1 C-m-0 
job-2987,4,11,4,148902,149049,149063,147,14,149136,true,C-l-2 L-m-0 L-m-0 L-l-0 
job-2986,4,8,6,148849,148881,149065,32,184,149193,true,L-s-0 C-s-2 C-s-1 C-s-0 C-l-2 C-l-2 
job-2990,4,9,5,149055,149055,149075,0,20,149217,true,C-m-0 C-m-0 C-l-1 C-l-1 C-l-1 
job-2991,2,12,4,149107,149107,149211,0,104,149400,true,L-l-0 L-l-0 L-l-0 C-m-1 
job-2993,1,6,5,149199,149199,149245,0,46,149384,true,C-m-2 L-s-0 L-s-0 L-m-0 L-m-0 
job-2992,1,5,1,149160,149160,149249,0,89,149323,true,C-m-2 
job-2994,6,6,6,149249,149249,149276,0,27,149444,true,L-l-0 L-m-0 C-m-0 C-l-2 C-l-2 C-l-1 
job-2988,6,10,2,148943,149049,149291,106,242,149477,true,L-l-0 C-m-2 
job-2989,6,12,1,149004,149049,149300,45,251,149525,true,C-m-1 
job-2996,2,6,7,149343,149343,149386,0,43,149553,true,C-s-2 C-s-2 C-s-1 C-s-1 C-s-0 C-s-0 C-m-1 
job-2995,4,5,6,149299,149299,149459,0,160,149509,true,L-s-0 L-m-0 L-m-0 L-l-0 L-l-0 L-l-0 
job-2998,4,4,7,149428,149428,149505,0,77,149787,true,C-m-1 C-m-2 C-m-0 C-m-0 C-l-2 C-l-2 C-l-2 
job-2997,1,12,7,149389,149389,149533,0,144,149559,true,C-s-2 C-s-1 C-s-0 C-m-1 C-m-1 C-m-2 C-m-2 
job-3000,4,10,2,149532,149532,149594,0,62,149823,true,L-s-0 C-m-0 
job-3002,4,10,1,149653,149653,149663,0,10,149773,true,C-m-0 
job-2999,5,4,3,149487,149487,149733,0,246,149988,true,L-m-0 L-l-0 L-l-0 
job-3005,1,8,7,149806,149806,149822,0,16,149842,true,C-m-1 C-m-1 C-m-2 C-m-2 C-l-2 C-l-2 C-l-1 
job-3004,4,11,8,149747,149747,149837,0,90,150023,true,L-m-0 L-l-0 L-l-0 C-l-0 L-s-0 C-s-2 C-s-1 C-s-0 
job-3003,5,10,8,149698,149698,149851,0,153,149960,true,C-m-0 C-m-1 C-m-2 C-l-2 C-l-2 C-l-1 C-l-1 C-l-0 
job-3007,2,8,4,149910,149910,149962,0,52,150002,true,C-s-2 C-s-1 C-s-1 C-s-0 
job-3001,1,10,6,149589,149589,149983,0,394,150112,true,L-m-0 L-m-0 L-l-0 L-l-0 C-m-0 C-m-0 
job-3008,3,5,3,149954,149954,150016,0,62,150053,true,C-m-1 C-m-1 C-m-2 
job-3006,1,8,8,149862,149862,150048,0,186,150127,true,L-m-0 L-l-0 L-l-0 L-l-0 C-m-0 L-s-0 L-s-0 C-s-2 
job-3011,4,12,1,150090,150090,150101,0,11,150166,true,L-l-0 
job-3012,3,12,2,150138,150138,150151,0,13,150447,true,L-l-0 C-l-2 
job-3010,2,10,8,150043,150043,150172,0,129,150394,true,L-m-0 C-m-0 C-m-2 C-m-2 C-m-1 C-m-1 C-m-1 C-l-2 
job-3009,4,8,7,149995,149995,150353,0,358,150608,true,L-m-0 L-l-0 L-l-0 C-m-2 C-m-0 C-s-1 C-s-0 
job-3013,6,7,8,150194,150353,150393,159,40,150449,true,L-m-0 L-l-0 L-l-0 C-m-2 C-m-0 C-m-1 C-l-2 C-l-2 
job-3014,5,10,6,150254,150393,150414,139,21,150315,false,L-m-0 L-l-0 L-l-0 C-m-2 C-m-0 C-m-1 
job-3017,4,9,3,150395,150395,150442,0,47,150443,true,C-l-1 C-l-1 C-l-0 
job-3015,4,12,4,150299,150393,150452,94,59,150586,true,L-s-0 C-s-1 C-s-0 C-s-2 
job-3018,4,5,1,150435,150435,150501,0,66,150786,true,C-l-0 
job-3020,2,6,1,150532,150532,150550,0,18,150787,true,L-m-0 
job-3019,3,5,8,150488,150488,150623,0,135,150689,true,C-l-0 C-l-0 C-l-1 C-l-1 L-s-0 L-m-0 L-m-0 L-l-0 
job-3022,1,7,3,150633,150633,150655,0,22,150692,true,L-l-0 L-l-0 L-l-0 
job-3016,4,4,4,150342,150393,150671,51,278,150790,true,C-l-2 C-l-2 C-l-2 C-l-1 
job-3021,4,5,6,150581,150581,150674,0,93,150778,true,L-l-0 L-l-0 C-l-0 C-s-1 C-s-0 C-s-2 
job-3023,2,4,6,150676,150676,150700,0,24,150847,true,L-s-0 L-s-0 L-m-0 L-m-0 L-m-0 L-m-0 
job-3024,3,8,7,150726,150726,150781,0,55,150990,true,L-s-0 L-m-0 L-m-0 L-l-0 L-l-0 L-l-0 L-l-0 
job-3025,6,6,8,150781,150781,150798,0,17,150809,true,L-m-0 L-l-0 L-l-0 C-m-2 C-m-0 C-m-1 C-l-2 C-l-2 
job-3027,2,8,1,150871,150871,150929,0,58,151141,true,L-m-0 
job-3026,3,8,6,150819,150819,150951,0,132,150957,true,L-s-0 L-m-0 L-m-0 L-l-0 L-l-0 L-l-0 
job-3028,3,5,1,150922,150922,150962,0,40,151140,true,L-l-0 
job-3031,2,4,2,151080,151080,151101,0,21,151162,true,L-m-0 C-m-2 
job-3030,5,8,2,151023,151023,151194,0,171,151393,true,C-m-1 C-l-2 
job-3032,1,5,6,151118,151118,151224,0,106,151373,true,L-m-0 L-m-0 C-m-2 C-m-2 C-m-0 C-m-0 
job-3034,1,6,6,151225,151225,151265,0,40,151463,true,L-m-0 L-m-0 C-m-2 C-m-2 C-m-0 C-m-0 
job-3036,2,7,8,151323,151323,151341,0,18,151480,true,L-m-0 C-m-2 C-m-0 C-m-1 C-m-1 C-l-2 C-l-2 L-s-0 
job-3033,1,6,4,151173,151173,151348,0,175,151553,true,C-m-1 C-m-1 C-m-1 C-l-2 
job-3029,6,11,5,150969,150969,151367,0,398,151475,true,L-m-0 L-l-0 L-l-0 C-m-2 C-m-0 
job-3037,1,6,1,151368,151368,151384,0,16,151429,true,C-l-2 
job-3035,6,4,5,151274,151274,151472,0,198,151583,true,C-l-2 C-l-0 C-l-0 C-l-1 C-l-1 
job-3038,5,9,7,151424,151424,151478,0,54,151763,true,C-l-2 L-m-0 L-l-0 L-l-0 C-m-2 C-m-0 C-m-1 
job-3039,6,7,5,151488,151488,151567,0,79,151760,true,L-m-0 L-l-0 L-l-0 C-m-2 C-m-0 
job-3041,5,4,1,151576,151576,151587,0,11,151825,true,L-m-0 
job-3042,6,10,6,151637,151637,151749,0,112,151937,true,L-m-0 C-m-2 C-m-0 L-l-0 L-l-0 C-m-1 
job-3043,2,9,5,151682,151682,151762,0,80,152033,true,L-s-0 C-m-1 C-s-1 C-s-0 C-s-2 
job-3045,1,5,3,151785,151785,151822,0,37,151974,true,L-s-0 L-s-0 L-m-0 
job-3040,1,4,7,151530,151530,151888,0,358,151990,true,L-m-0 L-m-0 C-m-2 C-m-2 C-m-0 C-m-0 L-s-0 
job-3047,3,10,2,151883,151883,151933,0,50,152174,true,L-s-0 C-m-1 
job-3046,4,5,7,151833,151833,151945,0,112,152025,true,L-m-0 C-m-2 C-m-0 L-l-0 L-l-0 L-l-0 C-m-1 
job-3048,6,9,7,151940,151945,152002,5,57,152054,true,L-m-0 L-l-0 L-l-0 C-m-2 C-m-0 C-m-1 C-l-1 
job-3044,2,7,8,151730,151730,152064,0,334,152238,true,C-s-1 C-s-0 C-s-2 C-l-0 C-l-0 C-l-0 C-l-0 C-l-0 
job-3049,6,8,3,151996,151996,152109,0,113,152273,true,C-l-1 C-l-2 C-l-2 
job-3050,4,4,5,152044,152044,152120,0,76,152280,true,C-l-1 L-s-0 L-m-0 L-m-0 L-l-0 
job-3051,4,7,7,152092,152092,152144,0,52,152291,true,L-l-0 L-l-0 C-s-1 C-s-0 C-s-2 C-m-2 C-m-2 
job-3053,4,11,8,152200,152200,152218,0,18,152495,true,L-l-0 L-l-0 L-l-0 C-s-1 C-s-0 C-s-2 C-m-2 C-m-2 
job-3052,1,8,5,152146,152146,152225,0,79,152462,true,L-s-0 L-s-0 L-m-0 L-m-0 L-m-0 
job-3056,3,11,2,152362,152362,152436,0,74,152482,true,C-m-0 C-m-1 
job-3054,5,5,6,152257,152257,152442,0,185,152445,true,L-m-0 L-l-0 L-l-0 C-m-2 C-m-0 C-m-1 
job-3055,2,12,3,152313,152313,152528,0,215,152592,true,L-m-0 L-l-0 C-m-2 
job-3058,5,6,5,152447,152447,152547,0,100,152642,true,L-m-0 L-l-0 L-l-0 C-m-2 C-l-2 
job-3059,3,9,1,152489,152489,152553,0,64,152590,true,C-l-2 
job-3060,3,6,6,152541,152541,152618,0,77,152750,true,C-l-2 C-m-0 C-m-0 C-m-1 C-m-1 C-l-1 
job-3057,1,11,7,152401,152401,152634,0,233,152807,true,L-m-0 C-m-2 L-s-0 C-s-1 C-s-0 C-s-2 C-l-2 
job-3061,3,9,1,152597,152597,152669,0,72,152673,true,L-m-0 
job-3062,6,4,4,152641,152641,152750,0,109,152813,true,L-l-0 L-l-0 C-m-0 C-m-1 
job-3063,5,11,3,152699,152699,152751,0,52,152844,true,L-m-0 C-m-2 C-l-2 
job-3064,2,10,1,152752,152752,152822,0,70,153025,true,L-s-0 
job-3065,5,12,6,152810,152810,152831,0,21,153034,true,L-m-0 L-l-0 L-l-0 C-m-0 C-m-1 C-m-2 
job-3067,2,5,4,152912,152912,152937,0,25,153172,true,L-m-0 L-l-0 C-m-0 C-m-1 
job-3066,5,4,7,152870,152870,152960,0,90,153036,true,L-m-0 L-l-0 L-l-0 C-m-0 C-m-1 C-m-2 C-l-2 
job-3069,1,9,4,153006,153006,153051,0,45,153163,true,L-m-0 L-m-0 L-s-0 L-l-0 
job-3070,1,10,6,153070,153070,153130,0,60,153425,true,L-m-0 L-m-0 L-s-0 L-l-0 L-l-0 L-l-0 
job-3068,1,8,1,152959,152959,153147,0,188,153257,true,L-m-0 
job-3071,2,5,8,153120,153120,153229,0,109,153259,true,L-s-0 L-l-0 L-l-0 L-l-0 C-s-1 C-s-1 C-s-0 C-s-0 
job-3073,2,12,8,153228,153228,153276,0,48,153396,true,L-m-0 L-m-0 C-s-2 C-m-0 C-m-0 C-m-1 C-m-1 C-m-2 
job-3074,3,9,1,153273,153273,153302,0,29,153554,true,L-l-0 
job-3076,6,12,1,153378,153378,153391,0,13,153558,true,C-m-0 
job-3072,5,12,1,153177,153177,153402,0,225,153452,true,L-l-0 
job-3079,2,8,4,153525,153525,153618,0,93,153659,true,C-m-0 C-m-1 C-m-1 C-m-2 
job-3077,3,5,5,153425,153425,153626,0,201,153649,true,L-m-0 L-l-0 L-l-0 C-s-0 C-m-0 
job-3080,1,9,8,153576,153576,153640,0,64,153651,true,C-s-0 C-m-2 C-m-2 C-l-2 C-l-2 C-l-2 C-l-2 C-l-2 
job-3075,1,12,8,153331,153331,153716,0,385,153939,true,L-l-0 L-l-0 L-l-0 L-s-0 L-m-0 L-m-0 C-s-2 C-s-1 
job-3082,5,10,1,153679,153679,153733,0,54,153743,true,L-l-0 
job-3083,6,4,3,153730,153730,153751,0,21,154030,true,L-l-0 L-m-0 C-l-2 
job-3084,2,12,3,153782,153782,153826,0,44,154042,true,C-m-0 C-m-1 C-m-2 
job-3078,3,8,2,153482,153482,153838,0,356,153965,true,C-m-0 C-m-1 
job-3085,3,12,2,153835,153835,153852,0,17,153860,true,C-m-0 C-m-1 
job-3081,2,5,4,153624,153624,153852,0,228,154057,true,C-m-0 C-m-2 C-m-2 C-m-1 
job-3086,4,11,7,153886,153886,153902,0,16,154010,true,L-s-0 L-m-0 L-m-0 L-l-0 L-l-0 L-l-0 C-s-2 
job-3087,2,8,3,153943,153943,154005,0,62,154192,true,L-s-0 L-s-0 L-m-0 
job-3089,2,7,2,154050,154050,154122,0,72,154208,true,L-m-0 L-s-0 
job-3088,2,12,8,153995,153995,154147,0,152,154396,true,L-m-0 L-m-0 L-l-0 L-l-0 L-l-0 L-l-0 C-s-2 C-s-1 
job-3090,5,4,5,154108,154108,154163,0,55,154425,true,C-m-0 C-m-1 C-m-2 C-l-2 C-l-2 
job-3091,6,9,5,154162,154162,154219,0,57,154239,true,L-m-0 L-l-0 L-l-0 C-l-1 C-l-1 
job-3092,5,4,8,154215,154219,154341,4,122,154401,true,L-m-0 L-l-0 L-l-0 C-m-0 C-m-1 C-m-2 C-l-1 C-l-1 
job-3093,5,10,7,154263,154341,154461,78,120,154393,false,L-m-0 L-l-0 L-l-0 C-m-0 C-m-1 C-m-2 C-l-1 
job-3096,4,12,3,154404,154404,154484,0,80,154780,true,C-s-0 C-l-2 C-l-2 
job-3097,3,11,2,154465,154465,154546,0,81,154809,true,L-m-0 L-m-0 
job-3094,2,10,5,154311,154341,154586,30,245,154621,true,L-m-0 L-l-0 C-m-0 C-m-1 C-m-2 
job-3098,4,9,1,154518,154518,154604,0,86,154749,true,L-l-0 
job-3099,4,6,4,154569,154569,154632,0,63,154846,true,L-m-0 L-l-0 C-m-0 C-m-1 
job-3100,3,4,5,154623,154623,154685,0,62,154813,true,L-m-0 L-l-0 L-l-0 C-m-0 C-m-1 
job-3101,4,8,4,154673,154673,154688,0,15,154963,true,L-m-0 L-l-0 C-m-0 C-m-1 
job-3102,4,10,2,154720,154720,154736,0,16,154966,true,C-l-1 L-m-0 
job-3095,3,9,5,154357,154357,154738,0,381,155026,true,C-l-1 C-l-1 L-s-0 C-s-2 C-s-1 
job-3104,2,11,5,154818,154818,154901,0,83,154942,true,L-m-0 L-m-0 L-l-0 L-l-0 L-l-0 
job-3103,3,7,2,154764,154764,154907,0,143,155087,true,L-s-0 L-m-0 
job-3105,3,11,5,154877,154877,154929,0,52,155101,true,L-l-0 C-s-2 C-s-1 C-s-0 C-m-0 
job-3106,2,6,1,154930,154930,154960,0,30,155126,true,L-s-0 
job-3107,6,4,4,154980,154980,154992,0,12,155113,true,L-m-0 L-l-0 L-l-0 C-m-0 
job-3109,5,7,4,155068,155068,155081,0,13,155098,true,L-m-0 L-l-0 L-l-0 C-m-0 
job-3108,1,6,2,155023,155023,155170,0,147,155257,true,L-s-0 L-s-0 
job-3110,3,10,5,155130,155130,155179,0,49,155371,true,L-m-0 L-m-0 L-l-0 L-l-0 L-l-0 
job-3111,2,10,2,155186,155186,155199,0,13,155406,true,L-s-0 L-m-0 
job-3112,4,10,4,155238,155238,155301,0,63,155528,true,L-s-0 L-m-0 L-m-0 L-l-0 
job-3113,5,8,1,155291,155291,155336,0,45,155345,true,L-l-0 
job-3115,3,4,7,155412,155412,155520,0,108,155681,true,L-m-0 L-m-0 L-l-0 L-l-0 L-l-0 L-l-0 C-s-2 
job-3116,2,5,4,155472,155472,155555,0,83,155784,true,L-s-0 L-m-0 C-s-1 C-s-1 
job-3119,3,11,3,155624,155624,155650,0,26,155859,true,L-l-0 C-s-1 C-s-2 
job-3120,4,10,5,155674,155674,155716,0,42,155859,true,C-s-1 C-s-2 C-m-1 C-m-1 C-m-2 
job-3114,1,4,2,155351,155351,155720,0,369,155998,true,L-s-0 L-s-0 
job-3117,4,10,3,155518,155518,155726,0,208,155807,true,C-s-0 C-m-0 C-m-0 
job-3121,4,7,3,155728,155728,155765,0,37,155942,true,L-s-0 C-s-0 C-s-1 
job-3123,4,11,5,155828,155828,155847,0,19,155953,true,C-s-1 C-s-2 C-m-0 C-m-0 C-m-1 
job-3122,2,12,4,155779,155779,155855,0,76,155855,false,L-m-0 L-l-0 L-s-0 C-s-0 
job-3118,3,5,5,155573,155573,155858,0,285,155885,true,L-m-0 L-m-0 L-l-0 L-l-0 L-l-0 
job-3124,4,6,8,155876,155876,155908,0,32,155955,true,L-s-0 L-m-0 L-m-0 L-l-0 L-l-0 L-l-0 C-s-0 C-s-1 
job-3126,2,10,2,155978,155978,156024,0,46,156157,true,L-m-0 L-m-0 
job-3125,1,9,1,155927,155927,156048,0,121,156115,true,L-s-0 
job-3127,3,11,2,156017,156017,156071,0,54,156213,true,L-m-0 L-l-0 
job-3128,6,4,1,156080,156080,156162,0,82,156186,true,L-m-0 
job-3130,6,10,5,156195,156195,156210,0,15,156319,true,L-m-0 L-l-0 C-m-0 C-m-1 C-m-2 
job-3131,1,5,3,156243,156243,156274,0,31,156525,true,L-m-0 L-m-0 L-m-0 
job-3133,4,10,7,156323,156323,156338,0,15,156589,true,C-s-0 C-s-1 C-s-2 C-l-1 C-l-1 C-l-1 C-l-2 
job-3129,2,12,3,156130,156130,156356,0,226,156406,true,L-m-0 L-s-0 L-l-0 
job-3134,3,8,5,156372,156372,156407,0,35,156620,true,L-m-0 C-m-0 C-m-1 C-m-2 L-s-0 
job-3132,5,7,6,156281,156281,156411,0,130,156571,true,L-m-0 L-l-0 L-l-0 C-m-0 C-m-1 C-m-2 
job-3137,1,5,3,156519,156519,156530,0,11,156644,true,L-m-0 C-m-0 C-m-0 
job-3136,2,11,2,156464,156464,156539,0,75,156597,true,L-m-0 L-l-0 
job-3140,6,7,3,156658,156658,156727,0,69,157020,true,C-l-2 C-l-0 C-l-0 
job-3139,4,11,8,156613,156613,156731,0,118,156933,true,L-s-0 C-s-0 C-s-1 C-s-2 C-l-1 C-l-1 C-l-1 C-l-2 
job-3141,1,7,4,156703,156703,156767,0,64,157052,true,L-l-0 L-l-0 C-m-2 C-m-2 
job-3138,3,11,3,156569,156569,156860,0,291,157040,true,L-m-0 C-m-0 C-m-1 
job-3142,4,4,4,156761,156761,156927,0,166,157183,true,L-s-0 C-s-0 C-s-1 C-s-2 
job-3143,5,11,5,156806,156806,157008,0,202,157080,true,C-l-1 C-l-1 C-l-0 C-l-0 C-l-2 
job-3146,3,12,1,156945,157008,157024,63,16,157110,true,L-m-0 
job-3144,4,4,7,156854,157008,157029,154,21,157173,true,L-s-0 C-s-0 C-s-1 C-s-2 C-l-1 C-l-1 C-l-1 
job-3147,6,6,2,156997,157029,157101,32,72,157322,true,C-l-2 C-l-1 
job-3149,2,6,1,157106,157106,157140,0,34,157417,true,C-l-1 
job-3145,6,8,3,156905,157008,157209,103,201,157321,true,C-l-0 C-l-0 C-l-2 
job-3148,2,7,8,157045,157045,157212,0,167,157449,true,L-m-0 L-l-0 C-m-0 C-m-1 C-m-2 C-l-1 C-l-1 C-l-1 
job-3135,5,6,6,156417,156417,157220,0,803,157249,true,L-m-0 L-l-0 L-l-0 C-m-0 C-m-1 C-m-2 
job-3152,1,10,2,157269,157269,157327,0,58,157446,true,L-m-0 L-m-0 
job-3154,3,12,3,157375,157375,157459,0,84,157692,true,C-m-1 C-m-2 C-l-1 
job-3151,1,9,5,157210,157210,157472,0,262,157701,true,L-m-0 C-m-0 C-m-1 C-m-2 L-s-0 
job-3156,3,9,2,157480,157480,157506,0,26,157610,true,L-m-0 C-m-0 
job-3150,6,10,3,157161,157209,157523,48,314,157739,true,C-l-1 C-l-0 C-l-0 
job-3155,2,8,2,157421,157421,157539,0,118,157721,true,C-m-2 C-l-1 
job-3157,2,12,6,157538,157538,157597,0,59,157748,true,L-m-0 C-m-0 C-m-1 C-m-2 C-m-2 C-l-1 
job-3153,2,10,5,157328,157328,157599,0,271,157890,true,L-m-0 L-m-0 C-m-0 C-m-0 C-m-1 
job-3158,3,11,3,157575,157575,157654,0,79,157791,true,C-l-1 C-l-1 C-l-1 
job-3160,1,8,2,157661,157661,157736,0,75,157866,true,C-l-1 C-l-1 
job-3161,3,12,4,157708,157708,157744,0,36,157955,true,C-l-1 L-m-0 L-m-0 L-l-0 
job-3159,1,4,7,157621,157621,157755,0,134,157849,true,C-l-1 C-l-1 C-l-1 L-s-0 L-s-0 L-s-0 L-s-0 
job-3162,2,9,5,157755,157755,157824,0,69,158123,true,L-s-0 L-m-0 L-m-0 L-m-0 L-l-0 
job-3163,6,12,3,157802,157802,157897,0,95,157916,true,L-l-0 C-m-0 C-m-2 
job-3164,3,4,1,157850,157850,157916,0,66,157999,true,L-l-0 
job-3165,2,6,6,157907,157907,157970,0,63,158065,true,L-l-0 L-l-0 L-l-0 L-l-0 L-s-0 L-s-0 
job-3166,3,10,7,157956,157956,157981,0,25,158254,true,L-l-0 L-m-0 L-m-0 C-s-0 C-s-1 C-s-2 C-m-0 
job-3167,4,8,2,158012,158012,158060,0,48,158069,true,L-s-0 L-m-0 
job-3168,6,6,7,158065,158065,158078,0,13,158192,true,L-m-0 L-l-0 L-l-0 C-m-0 C-m-2 C-m-1 C-l-1 
job-3169,2,10,8,158122,158122,158147,0,25,158398,true,L-s-0 L-m-0 L-m-0 L-m-0 L-l-0 L-l-0 L-l-0 L-l-0 
job-3170,4,8,7,158169,158169,158193,0,24,158400,true,L-s-0 L-m-0 L-m-0 L-l-0 L-l-0 L-l-0 C-s-0 
job-3171,5,5,3,158223,158223,158261,0,38,158410,true,L-m-0 L-l-0 L-l-0 
job-3172,4,12,3,158264,158264,158363,0,99,158472,true,L-s-0 L-m-0 L-m-0 
job-3173,6,12,3,158315,158315,158363,0,48,158655,true,L-l-0 L-l-0 C-m-0 
job-3176,5,9,2,158466,158466,158535,0,69,158666,true,C-m-0 C-m-1 
job-3174,3,9,5,158359,158359,158549,0,190,158720,true,C-s-0 C-s-1 C-s-2 C-m-2 C-m-2 
job-3177,2,12,3,158516,158516,158605,0,89,158712,true,L-m-0 L-l-0 C-m-2 
job-3178,5,5,4,158554,158554,158611,0,57,158629,true,C-m-2 C-m-0 C-m-1 C-l-1 
job-3179,3,8,4,158612,158612,158634,0,22,158870,true,L-l-0 C-s-0 C-s-1 C-s-2 
job-3181,2,7,7,158723,158723,158756,0,33,158780,true,L-m-0 L-l-0 C-m-2 C-m-0 C-s-0 C-s-0 C-s-1 
job-3175,3,8,6,158411,158411,158775,0,364,158986,true,L-s-0 L-m-0 L-m-0 L-l-0 L-l-0 L-l-0 
job-3182,6,5,2,158765,158765,158821,0,56,159049,true,C-m-1 C-l-1 
job-3183,1,9,1,158832,158832,158864,0,32,159100,true,C-m-2 
job-3180,5,7,2,158669,158669,158969,0,300,158988,true,C-m-2 C-m-0 
job-3184,6,6,6,158882,158882,159013,0,131,159275,true,L-m-0 L-l-0 L-l-0 C-m-1 C-l-1 C-l-1 
job-3186,6,5,5,158966,158969,159029,3,60,159309,true,C-m-2 C-m-0 C-l-0 C-l-0 C-l-2 
job-3185,1,5,4,158917,158917,159047,0,130,159074,true,L-m-0 L-m-0 C-m-1 C-m-1 
job-3187,6,8,4,159012,159013,159093,1,80,159212,true,L-m-0 C-m-1 C-l-2 L-l-0 
job-3189,6,10,8,159102,159102,159113,0,11,159282,true,L-l-0 C-l-2 L-m-0 C-m-1 C-m-2 C-m-0 C-l-0 C-l-0 
job-3188,5,6,2,159061,159061,159137,0,76,159433,true,L-l-0 C-l-2 
job-3190,6,5,8,159146,159146,159285,0,139,159447,true,L-m-0 L-l-0 L-l-0 C-m-1 C-m-2 C-m-0 C-l-2 C-l-2 
job-3193,5,12,3,159304,159304,159320,0,16,159379,true,L-m-0 L-l-0 L-l-0 
job-3192,1,9,5,159250,159250,159345,0,95,159431,true,L-s-0 L-m-0 L-m-0 C-s-0 C-s-1 
job-3194,1,6,2,159359,159359,159400,0,41,159687,true,L-s-0 C-s-0 
job-3191,3,5,7,159201,159201,159434,0,233,159618,true,L-s-0 C-s-0 C-s-1 C-s-2 C-l-0 C-l-0 C-l-0 
job-3195,6,12,6,159422,159422,159470,0,48,159719,true,L-m-0 L-l-0 L-l-0 C-m-1 C-m-2 C-m-0 
job-3196,6,9,6,159480,159480,159531,0,51,159543,true,L-m-0 L-l-0 L-l-0 C-m-1 C-m-2 C-m-0 
job-3197,2,10,8,159533,159533,159608,0,75,159680,true,L-s-0 L-m-0 L-m-0 L-m-0 L-l-0 L-l-0 L-l-0 L-l-0 
job-3198,5,6,2,159579,159579,159645,0,66,159930,true,C-m-1 C-m-2 
job-3199,1,7,6,159635,159635,159688,0,53,159931,true,C-m-1 C-m-1 C-m-1 C-m-2 C-m-2 C-m-2 
job-3200,2,6,7,159672,159672,159758,0,86,159830,true,C-m-1 C-m-2 L-s-0 L-s-0 L-m-0 L-m-0 L-m-0 
job-3203,3,11,8,159819,159819,159831,0,12,159958,true,L-s-0 L-m-0 L-m-0 L-l-0 L-l-0 L-l-0 L-l-0 C-s-0 
job-3201,3,9,3,159720,159720,159838,0,118,159901,true,C-m-1 C-m-1 C-m-2 
job-3204,4,8,7,159876,159876,159905,0,29,160161,true,C-m-2 C-m-1 L-s-0 L-m-0 L-m-0 L-l-0 L-l-0 
job-3205,6,10,5,159920,159920,159947,0,27,159948,true,C-m-1 L-m-0 L-l-0 L-l-0 C-m-0 
job-3202,2,8,3,159774,159774,159963,0,189,160116,true,C-m-1 C-m-2 C-m-2 
job-3206,6,12,5,159967,159967,159981,0,14,159984,true,L-m-0 L-l-0 L-l-0 C-m-2 C-m-1 
job-3207,5,8,8,160024,160024,160135,0,111,160180,true,L-m-0 L-l-0 L-l-0 C-m-2 C-m-1 C-m-0 C-l-0 C-l-0 
job-3208,3,10,8,160073,160073,160152,0,79,160163,true,L-m-0 C-m-2 C-m-1 C-m-0 L-s-0 C-s-0 C-s-1 C-s-2 
job-3209,6,7,8,160128,160135,160287,7,152,160294,true,L-l-0 L-l-0 C-l-0 C-l-0 C-l-2 C-l-2 C-l-1 C-l-1 
job-3211,1,9,4,160236,160287,160324,51,37,160367,true,L-m-0 L-m-0 C-m-2 C-m-2 
job-3213,1,5,7,160321,160321,160341,0,20,160433,true,C-m-0 C-m-0 C-m-1 C-m-1 L-s-0 L-s-0 L-s-0 
job-3210,6,4,5,160182,160287,160383,105,96,160332,false,L-m-0 L-l-0 L-l-0 C-m-2 C-m-1 
job-3212,6,11,7,160275,160287,160408,12,121,160595,true,C-m-0 C-l-0 C-l-0 C-l-2 C-l-2 C-l-1 C-l-1 
job-3215,1,10,7,160430,160430,160500,0,70,160761,true,L-m-0 L-m-0 L-l-0 L-l-0 L-s-0 C-s-0 C-s-1 
job-3214,5,8,3,160369,160383,160543,14,160,160568,true,L-m-0 L-l-0 L-l-0 
job-3218,6,8,4,160588,160588,160620,0,32,160773,true,L-m-0 L-l-0 L-l-0 C-l-0 
job-3217,4,6,8,160541,160541,160624,0,83,160814,true,L-s-0 C-s-0 C-s-1 C-m-0 C-m-0 C-m-2 C-m-2 C-m-1 
job-3219,6,5,2,160633,160633,160718,0,85,160796,true,L-m-0 L-l-0 
job-3221,6,4,2,160722,160722,160757,0,35,160770,true,L-l-0 L-m-0 
job-3216,4,8,1,160482,160482,160766,0,284,161042,true,C-s-2 
job-3222,1,12,1,160773,160773,160814,0,41,161052,true,L-l-0 
job-3220,4,5,7,160678,160678,160905,0,227,160979,true,L-l-0 L-s-0 C-s-0 C-s-1 C-m-0 C-m-0 C-m-2 
job-3223,2,5,3,160821,160821,160905,0,84,161038,true,L-l-0 L-l-0 L-l-0 
job-3225,6,10,3,160915,160915,160955,0,40,161224,true,L-l-0 L-m-0 C-m-0 
job-3224,1,4,6,160867,160867,161001,0,134,161006,true,L-l-0 L-l-0 C-m-2 C-m-2 C-m-2 C-m-2 
job-3226,2,7,8,160969,160969,161025,0,56,161039,true,L-l-0 L-l-0 L-l-0 L-l-0 L-l-0 C-m-2 C-m-2 L-s-0 
job-3228,2,5,7,161083,161083,161102,0,19,161362,true,C-s-0 C-s-0 C-s-1 C-s-1 C-s-2 C-s-2 C-m-2 
job-3229,5,10,3,161132,161132,161201,0,69,161217,true,C-m-2 C-m-0 C-m-1 
job-3227,4,11,6,161027,161027,161208,0,181,161242,true,L-s-0 L-m-0 L-m-0 L-l-0 L-l-0 L-l-0 
job-3231,1,11,4,161237,161237,161254,0,17,161345,true,L-s-0 L-m-0 L-m-0 L-l-0 
job-3230,4,6,1,161179,161179,161280,0,101,161298,true,C-s-0 
job-3233,5,8,2,161335,161335,161377,0,42,161642,true,L-m-0 L-l-0 
job-3232,1,12,3,161281,161281,161407,0,126,161480,true,L-s-0 L-m-0 L-m-0 
job-3235,5,8,3,161448,161448,161470,0,22,161754,true,L-m-0 C-m-2 C-m-0 
job-3236,2,4,1,161496,161496,161569,0,73,161767,true,L-m-0 
job-3237,2,10,6,161551,161551,161578,0,27,161663,true,L-m-0 L-m-0 L-s-0 C-s-1 C-s-2 C-m-2 
job-3234,2,8,8,161384,161384,161583,0,199,161761,true,L-m-0 L-l-0 L-l-0 L-l-0 L-l-0 L-l-0 L-l-0 C-s-0 
job-3238,2,11,7,161609,161609,161653,0,44,161936,true,L-s-0 L-m-0 L-m-0 L-l-0 L-l-0 L-l-0 L-l-0 
job-3241,3,9,4,161773,161773,161817,0,44,161965,true,L-m-0 C-m-2 C-m-0 C-m-1 
job-3240,5,4,8,161727,161727,161837,0,110,161970,true,L-m-0 L-l-0 L-l-0 C-m-2 C-m-0 C-m-1 C-l-0 C-l-0 
job-3239,3,12,1,161671,161671,161859,0,188,162084,true,L-s-0 
job-3243,2,8,4,161885,161885,161910,0,25,162180,true,L-s-0 L-s-0 L-m-0 L-m-0 
job-3242,4,7,3,161834,161834,161941,0,107,162077,true,C-s-0 C-s-1 C-s-2 
job-3244,2,7,3,161933,161933,161985,0,52,162048,true,L-s-0 L-s-0 L-m-0 
job-3246,2,10,1,162037,162037,162128,0,91,162296,true,L-m-0 
job-3248,2,11,6,162131,162131,162156,0,25,162248,true,L-m-0 C-m-2 C-m-0 C-m-1 L-s-0 C-s-0 
job-3247,6,5,6,162084,162084,162158,0,74,162227,true,C-l-0 C-l-0 C-l-2 C-l-2 C-l-1 C-l-1 
job-3249,2,12,8,162186,162186,162239,0,53,162470,true,L-m-0 C-m-2 C-m-0 C-m-1 L-s-0 C-s-0 C-s-1 C-s-2 
job-3250,3,7,7,162236,162236,162251,0,15,162383,true,C-l-0 C-l-0 C-l-0 C-l-0 C-l-2 C-l-2 C-l-2 
job-3245,6,7,6,161981,161981,162299,0,318,162539,true,L-m-0 L-l-0 L-l-0 C-m-2 C-m-0 C-m-1 
job-3251,3,9,3,162296,162296,162344,0,48,162537,true,L-s-0 C-s-0 C-s-1 
job-3253,6,10,7,162402,162402,162449,0,47,162690,true,L-m-0 L-l-0 L-l-0 C-m-2 C-m-0 C-m-1 C-l-0 
job-3254,3,6,5,162457,162457,162541,0,84,162738,true,L-m-0 L-m-0 L-l-0 L-l-0 L-l-0 
job-3255,6,4,8,162493,162493,162616,0,123,162764,true,C-m-2 C-m-0 C-m-1 C-l-0 C-l-0 C-l-2 C-l-2 C-l-1 
job-3258,4,9,1,162629,162629,162644,0,15,162803,true,C-m-2 
job-3256,1,5,6,162547,162547,162675,0,128,162838,true,L-m-0 L-m-0 L-m-0 L-m-0 L-m-0 C-m-2 
job-3259,5,10,4,162681,162681,162714,0,33,162775,true,L-m-0 C-l-1 C-m-2 C-m-0 
job-3252,2,6,3,162344,162344,162821,0,477,163028,true,L-s-0 L-s-0 L-m-0 
job-3257,5,5,3,162579,162579,162836,0,257,163018,true,C-l-1 L-l-0 L-l-0 
job-3261,1,6,7,162786,162786,162844,0,58,163015,true,L-m-0 L-m-0 L-l-0 L-l-0 C-l-1 C-l-1 C-l-1 
job-3262,3,8,5,162836,162836,162947,0,111,163222,true,L-l-0 L-l-0 L-l-0 C-l-1 L-s-0 
job-3260,4,12,3,162724,162724,162947,0,223,163062,true,L-m-0 C-l-1 C-s-0 
job-3264,3,7,8,162943,162943,162956,0,13,163208,true,L-l-0 C-l-1 C-s-1 C-s-2 C-m-2 C-m-2 C-m-0 C-m-0 
job-3265,3,5,1,162988,162988,163006,0,18,163091,true,L-m-0 
job-3263,3,8,1,162888,162888,163081,0,193,163084,true,L-m-0 
job-3266,1,9,6,163027,163027,163098,0,71,163319,true,L-m-0 L-m-0 L-s-0 L-l-0 L-l-0 L-l-0 
job-3267,5,7,3,163086,163086,163104,0,18,163346,true,L-m-0 L-l-0 C-m-2 
job-3268,2,7,6,163132,163132,163184,0,52,163274,true,L-s-0 L-s-0 L-m-0 L-m-0 L-m-0 L-m-0 
job-3270,2,5,7,163215,163215,163235,0,20,163372,true,L-l-0 C-m-2 C-m-0 C-m-1 C-l-1 C-l-1 C-l-1 
job-3269,5,9,6,163169,163169,163281,0,112,163288,true,L-l-0 L-l-0 C-m-2 C-m-0 C-m-1 C-l-1 
job-3271,3,5,1,163262,163262,163291,0,29,163331,true,C-m-2 
job-3272,4,6,4,163324,163324,163481,0,157,163495,true,L-s-0 L-m-0 L-m-0 L-l-0 
job-3274,4,9,7,163420,163420,163573,0,153,163582,true,C-s-0 C-s-1 C-s-2 C-m-1 C-m-1 C-l-1 C-l-1 
job-3276,6,6,2,163508,163508,163578,0,70,163758,true,L-m-0 C-l-0 
job-3275,1,5,4,163467,163467,163652,0,185,163756,true,L-l-0 L-l-0 C-m-2 C-m-2 
job-3278,3,6,2,163601,163601,163669,0,68,163708,true,L-l-0 L-s-0 
job-3273,6,8,3,163374,163374,163674,0,300,163834,true,L-l-0 C-m-2 C-m-0 
job-3277,6,6,8,163546,163578,163692,32,114,163714,true,L-m-0 C-m-1 C-l-0 C-l-0 C-l-1 C-l-1 C-l-2 C-l-2 
job-3280,1,4,3,163707,163707,163725,0,18,163875,true,L-m-0 L-m-0 L-m-0 
job-3281,4,11,3,163749,163749,163770,0,21,163821,true,L-m-0 L-l-0 L-l-0 
job-3282,4,12,5,163793,163793,163822,0,29,164049,true,L-m-0 L-l-0 L-l-0 C-m-2 C-m-0 
job-3283,3,9,5,163837,163837,163875,0,38,163998,true,L-m-0 L-m-0 L-l-0 L-l-0 L-l-0 
job-3279,2,5,4,163661,163661,163890,0,229,164050,true,L-m-0 L-l-0 C-m-2 C-m-0 
job-3284,4,7,6,163877,163877,163969,0,92,164223,true,L-m-0 L-l-0 L-l-0 C-m-2 C-m-0 L-s-0 
job-3285,3,11,7,163918,163918,163998,0,80,164280,true,L-m-0 L-l-0 C-m-2 C-m-0 C-s-0 C-s-1 C-s-2 
job-3288,4,9,8,164073,164073,164084,0,11,164307,true,L-m-0 C-l-0 L-s-0 C-s-0 C-s-1 C-s-2 C-l-1 C-l-1 
job-3287,5,10,5,164029,164029,164107,0,78,164329,true,L-l-0 C-m-2 C-m-0 C-m-1 C-l-0 
job-3289,2,5,6,164121,164121,164146,0,25,164336,true,L-m-0 L-m-0 L-l-0 L-l-0 L-l-0 L-s-0 
job-3286,2,7,5,163982,163982,164187,0,205,164389,true,L-m-0 L-m-0 L-l-0 L-l-0 L-l-0 
job-3290,2,11,1,164172,164172,164210,0,38,164313,true,L-m-0 
job-3291,4,10,6,164224,164224,164410,0,186,164585,true,L-s-0 L-m-0 L-m-0 L-l-0 L-l-0 L-l-0 
job-3296,1,8,7,164490,164490,164500,0,10,164506,true,C-m-1 C-l-1 L-l-0 L-l-0 L-l-0 L-l-0 L-l-0 
job-3293,3,10,1,164334,164334,164582,0,248,164666,true,C-m-1 
job-3297,1,8,6,164540,164540,164709,0,169,164985,true,C-m-1 C-l-1 L-l-0 L-l-0 L-l-0 L-l-0 
job-3295,4,5,3,164436,164436,164792,0,356,164936,true,L-s-0 L-m-0 L-m-0 
job-3294,3,11,8,164388,164388,164855,0,467,165108,true,C-m-1 C-l-0 C-l-0 C-l-0 C-l-0 C-l-1 C-l-1 C-l-1 
job-3298,4,11,7,164580,164709,164878,129,169,164771,false,C-m-1 L-l-0 L-l-0 L-l-0 C-l-2 C-l-2 C-l-2 
job-3302,1,9,6,164780,164878,164898,98,20,165009,true,C-m-1 C-l-1 C-l-1 L-s-0 L-l-0 L-l-0 
job-3301,2,8,1,164737,164855,164937,118,82,164943,true,C-l-0 
job-3292,4,11,7,164278,164278,164938,0,660,165145,true,C-s-0 C-s-1 C-s-2 C-m-2 C-m-2 C-m-0 C-m-0 
job-3300,1,9,4,164696,164855,164953,159,98,164970,true,L-m-0 L-m-0 C-m-1 C-m-1 
job-3305,5,12,2,164940,164940,164960,0,20,165135,true,C-m-2 C-m-0 
job-3299,5,11,5,164640,164855,164991,215,136,164924,false,L-m-0 C-l-0 C-l-0 C-l-1 C-l-1 
job-3306,4,12,3,164990,164990,165005,0,15,165061,true,C-m-2 C-m-1 C-m-0 
job-3304,3,11,7,164885,164938,165046,53,108,165159,true,C-l-2 C-l-2 C-l-2 C-s-0 C-s-1 C-s-2 C-m-2 
job-3303,2,12,8,164836,164898,165070,62,172,165161,true,C-m-1 C-l-1 L-s-0 L-l-0 L-l-0 L-l-0 L-l-0 C-l-2 
job-3309,2,7,2,165157,165157,165180,0,23,165334,true,C-l-1 C-l-1 
job-3307,2,12,3,165044,165044,165249,0,205,165534,true,C-m-2 C-m-1 C-l-1 
job-3308,5,4,2,165107,165107,165312,0,205,165436,true,C-m-2 C-m-1 
job-3312,4,8,8,165304,165304,165395,0,91,165458,true,L-m-0 L-l-0 L-l-0 C-s-0 C-s-1 C-s-2 C-m-0 C-m-0 
job-3310,1,10,5,165210,165210,165433,0,223,165594,true,C-m-2 C-m-1 C-l-1 C-l-1 C-l-1 
job-3313,5,5,2,165358,165358,165453,0,95,165490,true,C-m-2 C-m-1 
job-3311,2,12,7,165258,165258,165472,0,214,165624,true,C-m-2 C-m-1 C-l-1 L-s-0 L-m-0 L-m-0 L-l-0 
job-3317,4,4,7,165552,165552,165603,0,51,165785,true,L-l-0 C-m-2 C-m-1 C-l-1 C-l-2 L-s-0 C-l-0 
job-3318,1,6,4,165596,165596,165627,0,31,165693,true,L-m-0 L-m-0 C-m-0 C-m-0 
job-3315,4,11,8,165459,165459,165652,0,193,165800,true,L-l-0 C-m-2 C-m-1 C-l-1 C-l-1 C-s-0 C-s-1 C-s-2 
job-3319,4,9,1,165636,165636,165686,0,50,165753,true,L-l-0 
job-3320,3,12,1,165679,165679,165724,0,45,165974,true,L-l-0 
job-3321,4,12,2,165721,165721,165757,0,36,165797,true,L-l-0 C-l-2 
job-3322,5,9,8,165768,165768,165799,0,31,166053,true,L-l-0 C-l-2 C-m-2 C-m-1 C-l-1 C-l-1 C-l-0 C-l-0 
job-3316,6,10,3,165510,165510,165839,0,329,166071,true,L-m-0 C-m-0 C-l-2 
job-3314,2,11,2,165405,165405,165854,0,449,166130,true,L-l-0 L-l-0 
job-3324,1,12,5,165878,165878,165899,0,21,165982,true,L-l-0 L-l-0 L-l-0 C-m-2 C-m-2 
job-3323,6,8,3,165819,165819,166013,0,194,166068,true,L-l-0 C-l-2 C-m-2 
job-3327,3,12,6,166023,166023,166218,0,195,166334,true,L-m-0 L-l-0 L-l-0 C-m-0 C-m-1 C-l-2 
job-3330,4,10,1,166171,166218,166228,47,10,166419,true,L-s-0 
job-3329,2,11,4,166120,166218,166240,98,22,166192,false,L-m-0 C-m-2 C-m-0 C-m-1 
job-3331,4,11,3,166211,166218,166247,7,29,166252,true,C-s-0 C-s-1 C-s-2 
job-3325,5,4,4,165930,165930,166250,0,320,166254,true,L-l-0 C-l-2 L-m-0 C-m-0 
job-3326,5,4,3,165975,165975,166277,0,302,166540,true,C-m-1 C-l-1 C-l-1 
job-3333,2,7,4,166314,166314,166342,0,28,166370,true,C-m-2 C-l-2 C-l-2 C-l-2 
job-3328,6,6,5,166071,166218,166345,147,127,166216,false,L-l-0 C-l-2 C-m-2 C-l-0 C-l-0 
job-3332,1,4,6,166264,166264,166377,0,113,166402,true,L-l-0 L-l-0 L-l-0 L-l-0 L-l-0 L-l-0 
job-3335,5,9,2,166416,166416,166442,0,26,166491,true,L-l-0 C-m-0 
job-3334,5,5,4,166361,166361,166553,0,192,166573,true,L-l-0 L-m-0 C-m-2 C-m-1 
job-3337,2,5,2,166509,166509,166632,0,123,166924,true,L-m-0 L-l-0 
job-3336,5,8,7,166458,166458,166634,0,176,166845,true,L-l-0 C-m-0 C-l-0 C-l-0 C-l-2 C-l-2 C-l-1 
job-3340,2,5,6,166653,166653,166684,0,31,166723,true,L-m-0 L-m-0 L-l-0 L-l-0 L-l-0 C-m-0 
job-3338,1,11,6,166555,166555,166769,0,214,166994,true,L-m-0 L-m-0 L-l-0 L-l-0 L-l-0 C-m-0 
job-3339,4,12,2,166605,166605,166782,0,177,167023,true,C-l-1 L-s-0 
job-3341,3,10,7,166716,166716,166822,0,106,166903,true,L-m-0 L-l-0 C-m-0 C-m-0 C-l-1 C-l-1 C-s-0 
job-3342,6,5,8,166763,166782,166867,19,85,167142,true,L-l-0 C-l-1 C-m-2 C-m-1 C-l-0 C-l-0 C-l-2 C-l-2 
job-3344,1,11,5,166869,166869,167089,0,220,167379,true,L-s-0 L-m-0 L-m-0 L-l-0 L-l-0 
job-3345,6,5,5,166914,166914,167189,0,275,167447,true,C-l-1 C-m-2 C-m-1 C-m-0 C-l-0 
job-3347,3,9,1,167012,167189,167226,177,37,167308,true,C-s-1 
job-3346,6,5,7,166965,167189,167334,224,145,167281,false,L-l-0 C-l-1 C-m-2 C-m-1 C-m-0 C-l-0 C-l-0 
job-3343,3,5,8,166821,166822,167376,1,554,167519,true,L-l-0 L-l-0 C-l-1 C-l-1 L-s-0 L-m-0 L-m-0 C-s-0 
job-3348,6,11,6,167060,167334,167413,274,79,167275,false,L-l-0 C-l-1 C-m-2 C-m-1 C-m-0 C-l-0 
job-3349,4,8,5,167105,167334,167430,229,96,167446,true,C-l-0 C-s-1 C-s-2 C-l-2 C-l-2 
job-3357,2,4,5,167484,167484,167497,0,13,167619,true,C-l-1 C-s-1 C-s-1 C-s-2 C-s-2 
job-3353,4,7,1,167302,167413,167506,111,93,167667,true,C-m-1 
job-3354,6,8,1,167345,167413,167506,68,93,167653,true,C-m-0 
job-3352,3,5,4,167248,167413,167509,165,96,167379,false,C-l-0 C-s-0 C-m-2 C-m-2 
job-3350,3,11,8,167147,167376,167522,229,146,167409,false,L-l-0 L-l-0 C-l-2 C-l-1 C-l-1 L-s-0 L-m-0 L-m-0 
job-3358,4,8,5,167535,167535,167599,0,64,167653,true,L-m-0 L-l-0 C-m-1 C-m-2 C-m-0 
job-3355,4,8,4,167382,167430,167624,48,194,167850,true,C-m-1 C-l-0 C-l-2 C-l-2 
job-3359,5,7,4,167583,167599,167645,16,46,167912,true,L-m-0 L-l-0 C-m-2 C-m-0 
job-3351,4,9,3,167197,167413,167670,216,257,167664,false,L-l-0 C-l-1 C-l-0 
job-3360,1,9,2,167627,167627,167741,0,114,167817,true,L-m-0 L-m-0 
job-3356,1,7,7,167431,167431,167764,0,333,167781,true,L-m-0 L-l-0 L-l-0 C-s-0 C-m-2 C-m-2 C-m-0 
job-3363,5,5,1,167768,167768,167813,0,45,167919,true,L-l-0 
job-3362,6,4,5,167707,167707,167873,0,166,167986,true,L-l-0 C-m-2 C-m-0 C-m-1 C-l-0 
job-3361,4,7,1,167669,167669,167890,0,221,168164,true,L-m-0 
job-3364,6,6,7,167818,167873,168039,55,166,168125,true,L-l-0 L-l-0 C-m-2 C-m-0 C-m-1 C-l-0 C-l-0 
job-3367,1,11,6,167974,168039,168058,65,19,168124,true,L-m-0 L-m-0 C-m-2 C-m-2 C-m-0 C-m-0 
job-3366,6,5,2,167923,168039,168084,116,45,168169,true,C-l-1 C-l-1 
job-3369,4,7,5,168079,168084,168111,5,27,168237,true,C-l-2 C-l-2 C-l-1 C-l-1 C-l-1 
job-3365,6,8,8,167869,168039,168125,170,86,168248,true,L-m-0 L-l-0 L-l-0 C-m-2 C-m-0 C-m-1 C-l-0 C-l-0 
job-3368,3,7,5,168023,168039,168172,16,133,168224,true,L-s-0 C-s-0 C-s-1 C-s-2 C-l-2 
job-3370,4,11,2,168126,168126,168191,0,65,168241,true,C-l-2 C-l-2 
job-3372,4,11,1,168220,168220,168308,0,88,168472,true,L-s-0 
job-3371,5,9,6,168180,168180,168326,0,146,168357,true,L-m-0 L-l-0 L-l-0 C-m-2 C-m-0 C-m-1 
job-3373,2,12,5,168276,168276,168330,0,54,168373,true,L-m-0 L-l-0 C-m-2 C-m-0 C-m-1 
job-3375,6,5,2,168363,168363,168408,0,45,168450,true,L-m-0 L-l-0 
job-3374,3,5,4,168323,168323,168417,0,94,168486,true,L-s-0 C-s-0 C-s-1 C-s-2 
job-3378,2,4,8,168531,168531,168549,0,18,168830,true,L-m-0 C-m-2 C-m-0 C-s-0 C-s-0 C-s-1 C-s-1 C-s-2 
job-3379,5,10,2,168565,168565,168606,0,41,168715,true,C-m-1 C-l-2 
job-3380,1,6,8,168614,168614,168662,0,48,168677,true,L-m-0 L-m-0 C-m-2 C-m-2 C-m-0 C-m-0 C-s-0 C-s-0 
job-3377,4,12,1,168477,168477,168691,0,214,168812,true,L-s-0 
job-3381,6,7,1,168671,168671,168747,0,76,169025,true,C-m-1 
job-3383,6,5,6,168762,168762,168798,0,36,168953,true,C-m-1 C-l-2 C-l-2 C-l-0 C-l-0 C-l-1 
job-3376,6,8,5,168421,168421,168808,0,387,169012,true,L-m-0 L-l-0 L-l-0 C-m-2 C-m-0 
job-3384,2,6,1,168807,168807,168820,0,13,169086,true,C-m-2 
job-3382,1,5,2,168716,168716,168935,0,219,169107,true,L-m-0 L-m-0 
job-3385,5,6,5,168853,168853,169267,0,414,169386,true,L-m-0 L-l-0 L-l-0 C-m-2 C-m-0 
job-3388,3,12,8,168986,169267,169325,281,58,169337,true,C-s-0 C-s-1 C-s-2 C-l-0 C-l-0 C-l-0 C-l-0 C-l-1 
job-3389,4,9,3,169034,169325,169343,291,18,169131,false,C-s-0 C-s-1 C-s-2 
job-3390,3,6,2,169076,169325,169343,249,18,169179,false,C-l-0 C-l-0 
job-3391,5,4,3,169123,169325,169372,202,47,169442,true,C-l-0 C-l-1 C-l-1 
job-3387,3,4,1,168943,169267,169443,324,176,169406,false,L-s-0 
job-3386,6,6,8,168900,169267,169647,367,380,169338,false,L-m-0 L-l-0 L-l-0 C-m-2 C-m-0 C-m-1 C-l-2 C-l-2 
job-3393,2,9,7,169231,169647,169668,416,21,169372,false,L-m-0 C-m-2 C-m-0 C-m-1 L-s-0 C-s-0 C-s-1 
job-3395,1,5,1,169326,169647,169701,321,54,169443,false,L-s-0 
job-3396,3,12,4,169371,169701,169719,330,18,169676,false,C-l-0 L-s-0 C-s-0 C-s-1 
job-3392,6,6,8,169186,169647,169730,461,83,169367,false,L-m-0 L-l-0 L-l-0 C-m-2 C-m-0 C-m-1 C-l-2 C-l-2 
job-3398,3,4,7,169471,169730,169752,259,22,169598,false,C-l-0 L-s-0 L-l-0 L-l-0 L-l-0 L-l-0 C-s-0 
job-3394,3,4,8,169270,169647,169848,377,201,169525,false,C-s-2 C-l-1 C-l-1 C-l-1 C-l-1 C-l-0 C-l-0 C-l-0 
job-3399,2,11,8,169527,169730,169850,203,120,169714,false,L-m-0 C-s-1 C-m-2 C-m-2 C-m-0 C-m-0 C-m-1 C-m-1 
job-3400,6,7,7,169572,169848,169895,276,47,169765,false,L-l-0 L-l-0 C-l-1 C-l-1 C-l-0 C-l-0 C-l-2 
job-3403,4,6,3,169725,169895,169939,170,44,169973,true,C-m-2 C-m-0 C-m-1 
job-3402,6,12,5,169673,169895,170036,222,141,169822,false,C-l-2 L-l-0 L-l-0 C-l-1 C-l-1 
job-3404,6,7,4,169778,170036,170054,258,18,170052,false,C-l-2 L-l-0 L-l-0 C-l-1 
job-3406,6,10,1,169874,170054,170117,180,63,170095,false,C-l-0 
job-3401,4,10,4,169621,169848,170118,227,270,170017,false,C-m-2 C-m-0 C-m-1 C-l-2 
job-3411,3,10,1,170128,170128,170154,0,26,170363,true,C-m-2 
job-3409,3,7,5,170030,170118,170164,88,46,170279,true,L-s-0 C-s-1 C-s-2 C-s-0 C-m-2 
job-3408,6,9,2,169983,170118,170198,135,80,170128,false,C-l-2 C-l-0 
job-3397,6,8,1,169420,169730,170204,310,474,170120,false,L-m-0 
job-3405,6,8,5,169831,170054,170215,223,161,170255,true,C-l-2 L-l-0 L-l-0 C-l-1 C-l-1 
job-3412,2,11,2,170176,170176,170222,0,46,170498,true,C-s-1 C-s-2 
job-3407,5,8,1,169924,170054,170228,130,174,170316,true,C-l-0 
job-3414,2,4,3,170258,170258,170304,0,46,170420,true,L-m-0 L-m-0 L-m-0 
job-3413,3,5,1,170217,170217,170351,0,134,170440,true,L-s-0 
job-3410,1,6,3,170086,170118,170353,32,235,170486,true,L-s-0 L-m-0 L-m-0 
job-3415,1,7,7,170307,170307,170373,0,66,170532,true,L-m-0 L-m-0 L-l-0 L-l-0 L-l-0 L-l-0 L-l-0 
job-3416,5,9,4,170360,170360,170409,0,49,170453,true,L-m-0 L-l-0 C-m-2 C-m-0 
job-3418,6,7,6,170469,170469,170535,0,66,170579,true,L-l-0 C-m-2 C-m-0 C-m-1 C-l-0 C-l-0 
job-3417,3,7,4,170410,170410,170573,0,163,170725,true,L-s-0 L-m-0 L-m-0 L-l-0 
job-3420,5,8,1,170580,170580,170592,0,12,170760,true,L-l-0 
job-3421,4,9,2,170631,170631,170664,0,33,170906,true,L-l-0 C-l-2 
job-3419,6,8,7,170529,170535,170703,6,168,170972,true,L-l-0 C-m-2 C-m-0 C-m-1 C-l-0 C-l-0 C-l-2 
job-3423,1,9,1,170727,170727,170760,0,33,170935,true,L-m-0 
job-3422,3,9,8,170689,170689,170785,0,96,170870,true,L-l-0 L-l-0 C-l-2 C-l-2 L-s-0 L-m-0 L-m-0 C-s-1 
job-3424,6,4,6,170779,170779,170833,0,54,171070,true,L-l-0 C-l-2 C-m-2 C-m-0 C-m-1 C-l-0 
job-3426,5,12,4,170879,170879,170889,0,10,171187,true,L-l-0 L-m-0 C-m-2 C-m-0 
job-3427,5,7,8,170927,170927,170975,0,48,171141,true,L-l-0 L-m-0 C-m-2 C-m-0 C-m-1 C-l-2 C-l-2 C-l-0 
job-3425,6,10,1,170832,170832,171006,0,174,171267,true,L-l-0 
job-3429,1,12,3,171038,171038,171108,0,70,171156,true,L-l-0 L-l-0 L-s-0 
job-3431,1,5,2,171120,171120,171137,0,17,171220,true,L-s-0 L-s-0 
job-3428,1,5,4,170979,170979,171145,0,166,171304,true,L-l-0 L-l-0 L-l-0 L-l-0 
job-3430,2,4,6,171079,171079,171165,0,86,171245,true,L-s-0 L-l-0 L-m-0 L-m-0 L-m-0 L-m-0 
job-3433,3,9,2,171232,171232,171280,0,48,171350,true,L-l-0 L-l-0 
job-3434,3,12,6,171278,171278,171292,0,14,171498,true,C-s-1 C-s-2 C-s-0 C-m-2 C-m-2 C-m-0 
job-3435,1,5,5,171326,171326,171401,0,75,171580,true,L-s-0 L-l-0 L-l-0 L-l-0 L-l-0 
job-3437,2,8,8,171411,171411,171425,0,14,171546,true,L-l-0 L-l-0 L-l-0 C-m-2 C-m-0 C-m-1 C-m-1 C-l-2 
job-3436,3,12,8,171365,171365,171436,0,71,171538,true,C-s-1 C-s-2 C-s-0 C-m-2 C-m-2 C-m-0 C-m-0 C-m-1 
job-3432,1,10,6,171178,171178,171488,0,310,171532,true,L-s-0 L-m-0 L-m-0 L-m-0 L-l-0 L-l-0 
job-3439,3,12,8,171504,171504,171587,0,83,171844,true,L-l-0 L-s-0 L-m-0 L-m-0 C-m-2 C-m-2 C-m-0 C-m-0 
job-3440,4,12,6,171546,171546,171607,0,61,171890,true,C-m-1 C-m-1 C-l-2 C-l-2 C-l-2 C-l-0 
job-3441,1,8,5,171596,171596,171610,0,14,171613,true,L-l-0 L-l-0 L-l-0 C-l-0 C-l-0 
job-3438,4,9,5,171467,171467,171637,0,170,171687,true,L-l-0 L-l-0 C-s-1 C-s-2 C-s-0 
job-3442,1,4,4,171647,171647,171663,0,16,171667,true,L-s-0 L-s-0 L-s-0 L-s-0 
job-3444,6,4,8,171745,171745,171818,0,73,171998,true,L-m-0 L-l-0 L-l-0 C-m-1 C-m-2 C-m-0 C-l-2 C-l-2 
job-3443,1,7,4,171697,171697,171860,0,163,172124,true,L-s-0 L-s-0 L-m-0 L-m-0 
job-3446,5,4,6,171854,171854,171890,0,36,172095,true,L-m-0 C-m-1 C-m-2 C-m-0 L-l-0 L-l-0 
job-3447,2,5,7,171901,171901,171925,0,24,172163,true,C-m-1 C-m-1 C-m-1 C-m-2 C-m-2 C-m-2 C-m-0 
job-3448,6,12,4,171953,171953,172009,0,56,172170,true,C-m-1 C-m-2 C-m-0 L-m-0 
job-3445,1,6,8,171804,171804,172033,0,229,172316,true,C-m-1 C-m-1 C-m-2 C-m-2 C-m-0 C-m-0 C-s-1 C-s-1 
job-3450,3,10,4,172052,172052,172074,0,22,172363,true,C-l-0 C-l-0 L-s-0 L-m-0 
job-3449,5,10,5,172003,172003,172211,0,208,172383,true,L-l-0 L-l-0 C-l-2 C-l-2 C-l-0 
job-3452,4,5,7,172161,172161,172238,0,77,172279,true,L-s-0 L-m-0 L-m-0 C-s-1 C-s-2 C-s-0 C-m-1 
job-3451,4,10,1,172109,172109,172254,0,145,172300,true,C-l-0 
job-3455,3,7,7,172304,172304,172337,0,33,172471,true,L-s-0 L-m-0 L-m-0 L-l-0 L-l-0 L-l-0 L-l-0 
job-3453,4,6,7,172206,172206,172357,0,151,172473,true,C-m-1 C-m-2 C-m-2 C-m-0 C-m-0 C-l-1 C-l-1 
job-3454,1,8,6,172258,172258,172421,0,163,172510,true,C-m-1 C-m-1 C-m-1 C-l-1 C-l-1 C-l-1 
job-3457,1,7,6,172407,172407,172504,0,97,172765,true,C-l-1 C-l-1 L-s-0 L-s-0 L-m-0 L-m-0 
job-3459,2,7,6,172508,172508,172519,0,11,172815,true,L-m-0 L-m-0 C-l-1 L-s-0 L-s-0 C-s-2 
job-3458,4,5,7,172465,172465,172671,0,206,172751,true,L-m-0 C-m-1 C-l-1 L-l-0 L-l-0 L-l-0 C-s-1 
job-3456,3,5,3,172359,172359,172706,0,347,172729,true,C-m-1 C-l-1 C-l-1 
job-3462,1,6,2,172652,172671,172729,19,58,172946,true,C-m-2 C-m-2 
job-3460,5,7,8,172567,172671,172732,104,61,172778,true,C-m-1 C-l-1 L-m-0 L-l-0 L-l-0 C-m-2 C-m-0 C-l-2 
job-3463,6,12,6,172709,172732,172744,23,12,172725,false,L-l-0 C-m-2 C-m-1 C-m-0 C-l-1 C-l-1 
job-3464,6,5,6,172750,172750,172767,0,17,172814,true,L-l-0 C-m-2 C-m-1 C-m-0 C-l-1 C-l-1 
job-3465,5,10,3,172796,172796,172907,0,111,173116,true,L-m-0 L-l-0 L-l-0 
job-3467,1,10,2,172908,172908,172921,0,13,172969,true,L-m-0 L-l-0 
job-3461,1,6,6,172613,172671,172984,58,313,172932,false,L-m-0 L-m-0 L-m-0 L-l-0 L-l-0 C-m-2 
job-3469,3,6,5,173001,173001,173048,0,47,173106,true,L-m-0 L-m-0 L-l-0 L-l-0 L-s-0 
job-3470,1,4,1,173052,173052,173137,0,85,173150,true,L-m-0 
job-3468,2,11,8,172951,172951,173146,0,195,173392,true,L-m-0 L-l-0 L-l-0 L-l-0 C-m-1 C-m-0 C-l-2 C-l-2 
job-3466,6,8,6,172848,172848,173226,0,378,173315,true,C-m-2 C-m-1 C-m-0 C-l-1 C-l-1 C-l-2 
job-3473,5,10,2,173209,173226,173241,17,15,173310,true,C-l-2 C-m-1 
job-3472,3,5,7,173155,173155,173267,0,112,173524,true,L-m-0 L-l-0 L-l-0 C-l-2 C-l-2 C-l-0 C-l-0 
job-3474,1,8,5,173262,173262,173303,0,41,173308,true,L-m-0 L-l-0 L-l-0 C-l-0 C-l-0 
job-3471,4,10,7,173104,173104,173325,0,221,173559,true,L-m-0 L-l-0 L-s-0 C-s-1 C-s-2 C-s-0 C-l-0 
job-3476,3,11,6,173368,173368,173408,0,40,173694,true,L-l-0 L-l-0 C-l-0 C-l-0 L-s-0 L-m-0 
job-3477,5,8,4,173426,173426,173486,0,60,173490,true,L-l-0 C-l-0 L-m-0 C-l-2 
job-3478,6,12,7,173479,173486,173501,7,15,173695,true,L-l-0 C-l-0 L-m-0 C-l-2 C-l-2 C-l-1 C-l-1 
job-3475,4,6,8,173299,173299,173503,0,204,173532,true,L-l-0 C-l-0 C-m-1 C-m-1 C-m-0 C-m-0 C-m-2 C-m-2 
job-3480,4,8,5,173577,173577,173623,0,46,173679,true,L-l-0 L-l-0 C-s-1 C-s-2 C-s-0 
job-3482,6,12,1,173675,173675,173735,0,60,173971,true,C-m-1 
job-3479,3,5,4,173533,173533,173740,0,207,173947,true,L-s-0 L-m-0 L-m-0 L-l-0 
job-3483,6,4,7,173719,173719,173741,0,22,173819,true,C-m-0 C-m-2 C-l-0 C-l-0 C-l-2 C-l-2 C-l-1 
job-3484,6,12,4,173778,173778,173816,0,38,173949,true,L-l-0 L-m-0 C-m-1 C-m-0 
job-3485,5,9,7,173831,173831,173843,0,12,174023,true,L-l-0 L-m-0 C-m-1 C-m-0 C-m-2 C-l-0 C-l-0 
job-3481,3,10,2,173629,173629,173935,0,306,174145,true,L-l-0 L-l-0 
job-3486,6,10,8,173875,173875,173963,0,88,174005,true,L-l-0 L-m-0 C-m-1 C-m-0 C-m-2 C-l-0 C-l-0 C-l-2 
job-3487,6,12,8,173923,173963,173981,40,18,174235,true,L-m-0 L-l-0 L-l-0 C-m-1 C-m-0 C-m-2 C-l-0 C-l-0 
job-3489,5,11,6,174025,174025,174048,0,23,174071,true,L-m-0 L-l-0 L-l-0 C-m-1 C-m-0 C-m-2 
job-3490,1,8,5,174076,174076,174121,0,45,174373,true,C-l-2 C-l-2 C-l-2 C-l-2 L-m-0 
job-3488,4,5,6,173968,173968,174180,0,212,174396,true,L-s-0 C-s-1 C-s-2 C-s-0 C-l-2 C-l-2 
job-3493,3,4,1,174236,174236,174250,0,14,174352,true,C-m-1 
job-3492,5,4,4,174180,174180,174320,0,140,174343,true,C-m-1 C-m-0 C-m-2 C-l-2 
job-3494,1,9,2,174293,174293,174331,0,38,174359,true,L-m-0 L-m-0 
job-3495,4,12,8,174345,174345,174431,0,86,174492,true,L-s-0 C-s-1 C-s-2 C-s-0 C-m-1 C-m-1 C-m-0 C-m-0 
job-3491,6,8,3,174125,174125,174446,0,321,174675,true,L-m-0 L-l-0 L-l-0 
job-3496,5,10,6,174393,174393,174498,0,105,174560,true,C-m-2 C-l-2 C-l-2 C-l-0 C-l-0 C-l-1 
job-3497,6,8,8,174437,174498,174520,61,22,174754,true,L-m-0 L-l-0 L-l-0 C-m-2 C-m-1 C-m-0 C-l-2 C-l-2 
job-3498,5,9,1,174488,174498,174522,10,24,174679,true,C-l-0 
job-3499,4,6,7,174526,174526,174634,0,108,174806,true,L-s-0 L-m-0 L-m-0 L-l-0 L-l-0 L-l-0 C-s-1 
job-3501,6,8,2,174624,174624,174642,0,18,174847,true,C-m-1 C-m-0 
job-3502,2,10,1,174683,174683,174698,0,15,174964,true,C-m-2 
job-3505,1,6,6,174823,174823,174834,0,11,175113,true,L-s-0 L-l-0 L-l-0 C-s-0 C-s-0 C-m-1 
job-3500,6,7,1,174577,174577,174894,0,317,175103,true,C-m-2 
job-3504,4,6,4,174782,174782,174917,0,135,174986,true,L-l-0 L-l-0 C-s-1 C-s-2 
job-3503,1,10,8,174741,174741,175017,0,276,175251,true,C-m-2 C-m-2 L-s-0 L-m-0 L-m-0 L-m-0 L-l-0 L-l-0 
job-3507,2,5,1,174913,174913,175023,0,110,175171,true,L-s-0 
job-3510,5,5,1,175067,175067,175101,0,34,175333,true,C-l-1 
job-3508,3,10,3,174959,174959,175116,0,157,175255,true,L-l-0 L-l-0 C-m-2 
job-3509,5,4,5,175001,175017,175141,16,124,175256,true,L-l-0 C-m-2 C-l-0 L-m-0 C-l-1 
job-3506,6,8,5,174870,174870,175246,0,376,175487,true,C-m-1 C-m-0 C-l-2 C-l-2 C-l-0 
job-3514,4,11,2,175281,175281,175320,0,39,175549,true,C-m-1 C-l-0 
job-3513,2,5,2,175223,175223,175329,0,106,175548,true,L-m-0 C-m-1 
job-3512,4,8,5,175175,175175,175330,0,155,175383,true,L-s-0 C-s-1 C-s-2 C-s-0 C-l-1 
job-3511,6,5,5,175120,175141,175358,21,217,175515,true,C-l-0 L-m-0 L-l-0 L-l-0 C-m-2 
job-3515,6,12,7,175341,175341,175454,0,113,175468,true,C-l-0 C-m-1 C-m-0 C-l-1 C-l-1 C-l-2 C-l-2 
job-3516,6,7,1,175395,175395,175459,0,64,175598,true,C-l-0 
job-3517,1,6,5,175464,175464,175501,0,37,175539,true,L-s-0 L-s-0 L-m-0 L-m-0 L-m-0 
job-3518,1,7,3,175513,175513,175627,0,114,175914,true,L-s-0 L-s-0 L-m-0 
job-3519,1,4,7,175560,175560,175648,0,88,175693,true,L-m-0 L-m-0 L-m-0 L-m-0 L-m-0 L-m-0 L-l-0 
job-3521,1,10,1,175668,175668,175693,0,25,175928,true,L-l-0 
job-3520,1,7,4,175619,175619,175751,0,132,175786,true,L-l-0 L-l-0 L-l-0 L-l-0 
job-3522,4,5,2,175715,175715,175825,0,110,175892,true,L-l-0 L-l-0 
job-3524,4,11,5,175824,175824,175852,0,28,175935,true,C-s-0 C-m-1 C-m-1 C-m-0 C-m-0 
job-3523,3,11,6,175768,175768,175899,0,131,175927,true,L-l-0 L-s-0 L-m-0 L-m-0 C-s-1 C-s-2 
job-3526,1,6,2,175937,175937,176008,0,71,176114,true,L-l-0 L-l-0 
job-3527,4,4,3,175970,175970,176017,0,47,176140,true,L-l-0 L-s-0 L-m-0 
job-3525,6,12,4,175878,175878,176172,0,294,176428,true,L-l-0 C-m-1 C-m-0 C-m-2 
job-3529,5,5,3,176049,176172,176182,123,10,176078,false,L-m-0 L-l-0 L-l-0 
job-3528,5,4,6,176015,176015,176204,0,189,176235,true,C-l-1 C-l-1 C-l-2 C-l-2 C-l-0 C-l-0 
job-3532,2,8,8,176202,176202,176241,0,39,176444,true,L-l-0 C-l-1 C-l-2 C-l-0 C-m-0 C-m-0 C-m-0 C-m-0 
job-3531,3,11,6,176149,176182,176253,33,71,176395,true,L-m-0 C-m-1 L-s-0 C-s-1 C-s-2 C-s-0 
job-3530,5,5,4,176103,176182,176305,79,123,176258,false,L-m-0 L-l-0 L-l-0 C-m-1 
job-3533,6,10,6,176254,176254,176399,0,145,176694,true,C-m-0 C-m-2 C-l-1 C-l-1 C-l-2 C-l-2 
job-3535,2,4,2,176355,176399,176487,44,88,176571,true,L-m-0 L-l-0 
job-3534,5,12,8,176315,176399,176582,84,183,176703,true,L-m-0 L-l-0 L-l-0 C-m-0 C-m-2 C-m-1 C-l-1 C-l-1 
job-3537,5,4,4,176438,176582,176624,144,42,176599,false,C-l-1 C-l-2 C-l-2 C-l-0 
job-3539,4,8,5,176535,176624,176647,89,23,176613,false,L-s-0 C-s-1 C-s-2 C-s-0 C-l-0 
job-3538,5,10,3,176482,176624,176730,142,106,176787,true,C-l-1 C-l-2 C-l-2 
job-3536,6,8,7,176393,176582,176734,189,152,176820,true,L-m-0 L-l-0 L-l-0 C-m-0 C-m-2 C-m-1 C-l-1 
job-3542,1,4,8,176682,176730,176753,48,23,176826,true,C-m-2 C-m-1 C-m-1 L-s-0 L-s-0 L-s-0 L-s-0 C-s-1 
job-3544,1,6,3,176791,176791,176902,0,111,177123,true,L-m-0 C-m-0 C-m-2 
job-3545,6,8,8,176838,176902,176954,64,52,176961,true,L-m-0 C-m-0 C-m-2 C-l-1 L-l-0 L-l-0 C-m-1 C-l-0 
job-3540,1,11,5,176590,176624,176955,34,331,176955,false,L-m-0 L-m-0 C-m-0 C-m-0 C-m-2 
job-3547,4,4,1,176931,176931,176963,0,32,177166,true,C-s-0 
job-3541,6,12,3,176635,176730,177003,95,273,177084,true,C-l-1 C-l-2 C-l-2 
job-3548,6,12,7,176990,176990,177006,0,16,177078,true,C-l-1 C-l-0 L-m-0 L-l-0 L-l-0 C-m-0 C-m-2 
job-3543,2,11,1,176737,176737,177030,0,293,177186,true,C-s-1 
job-3546,4,9,3,176890,176902,177039,12,137,177204,true,C-l-0 L-s-0 C-s-2 
job-3551,3,6,8,177130,177130,177182,0,52,177297,true,L-m-0 C-s-1 C-s-0 C-m-0 C-m-0 C-m-2 C-m-2 C-m-1 
job-3550,3,12,4,177075,177075,177221,0,146,177282,true,L-l-0 C-l-0 L-s-0 C-s-2 
job-3552,1,11,7,177187,177187,177271,0,84,177296,true,C-s-1 C-s-0 C-m-0 C-m-0 C-m-2 C-m-2 C-m-1 
job-3553,6,11,2,177241,177241,177292,0,51,177354,true,L-l-0 C-m-1 
job-3549,1,11,8,177029,177029,177332,0,303,177344,true,C-l-0 C-l-0 C-l-0 L-m-0 L-m-0 L-l-0 L-l-0 L-l-0 
job-3554,3,12,1,177295,177295,177430,0,135,177459,true,L-l-0 
job-3555,6,8,3,177347,177347,177441,0,94,177682,true,L-l-0 L-m-0 C-m-0 
job-3557,1,5,8,177440,177440,177518,0,78,177603,true,L-m-0 L-m-0 L-l-0 L-l-0 L-l-0 L-l-0 L-l-0 L-l-0 
job-3559,3,7,8,177546,177546,177574,0,28,177830,true,L-m-0 L-l-0 L-l-0 C-m-0 C-m-1 C-m-1 C-l-0 C-l-0 
job-3556,4,8,6,177405,177405,177577,0,172,177623,true,L-s-0 C-s-1 C-s-0 C-s-2 C-m-2 C-m-2 
job-3558,4,10,3,177494,177494,177596,0,102,177746,true,L-m-0 L-l-0 C-m-0 
job-3560,4,12,8,177597,177597,177619,0,22,177721,true,L-s-0 L-m-0 L-m-0 L-l-0 L-l-0 L-l-0 C-s-1 C-s-0 
job-3563,2,4,4,177769,177769,177840,0,71,178076,true,L-l-0 L-l-0 C-s-1 C-s-1 
job-3564,5,11,1,177814,177814,177843,0,29,177950,true,C-m-2 
job-3561,1,5,6,177655,177655,177864,0,209,178130,true,L-s-0 L-s-0 L-s-0 L-m-0 L-m-0 L-m-0 
job-3565,2,10,3,177850,177850,177900,0,50,178148,true,L-l-0 L-l-0 C-s-1 
job-3566,1,11,1,177901,177901,177911,0,10,178082,true,L-m-0 
job-3567,2,10,7,177949,177949,177979,0,30,178156,true,L-m-0 L-m-0 L-l-0 L-l-0 L-s-0 C-s-1 C-s-0 
job-3568,2,7,8,178003,178003,178105,0,102,178321,true,L-m-0 L-m-0 L-l-0 L-l-0 L-s-0 L-s-0 C-s-1 C-s-1 
job-3569,4,8,5,178038,178038,178128,0,90,178269,true,C-s-0 C-s-2 C-m-2 C-m-2 C-m-0 
job-3562,4,5,3,177710,177710,178155,0,445,178386,true,L-m-0 L-l-0 L-l-0 
job-3570,6,10,8,178103,178128,178341,25,213,178592,true,C-m-2 C-m-0 C-m-1 C-l-0 C-l-0 C-l-2 C-l-2 C-l-1 
job-3573,5,5,2,178250,178341,178367,91,26,178505,true,C-l-2 C-l-2 
job-3571,5,4,7,178152,178341,178451,189,110,178421,false,L-m-0 L-l-0 L-l-0 C-m-2 C-m-0 C-m-1 C-l-0 
job-3577,2,5,5,178450,178451,178520,1,69,178767,true,C-l-2 C-l-2 L-s-0 L-s-0 C-s-0 
job-3572,5,9,1,178210,178341,178529,131,188,178486,false,C-l-0 
job-3575,1,10,6,178361,178451,178542,90,91,178489,false,L-m-0 L-m-0 C-m-2 C-m-2 C-m-0 C-m-0 
job-3579,3,9,5,178534,178534,178562,0,28,178618,true,C-s-2 C-l-2 C-l-0 L-s-0 C-s-1 
job-3574,6,12,8,178308,178451,178588,143,137,178494,false,C-l-0 L-m-0 L-l-0 L-l-0 C-m-2 C-m-0 C-m-1 C-l-2 
job-3578,1,4,4,178497,178497,178601,0,104,178732,true,C-s-0 C-s-0 C-l-2 C-s-2 
job-3580,3,5,3,178580,178580,178610,0,30,178722,true,C-s-2 C-l-2 C-l-0 
job-3576,1,7,4,178418,178451,178679,33,228,178790,true,C-m-1 C-m-1 C-l-0 C-l-2 
job-3582,5,5,4,178694,178694,178792,0,98,178939,true,C-m-1 C-l-2 C-l-2 L-m-0 
job-3581,1,12,3,178642,178642,178904,0,262,179035,true,C-m-1 C-l-2 C-l-2 
job-3584,4,9,1,178794,178794,178988,0,194,179117,true,L-m-0 
job-3586,1,9,7,178903,178903,178989,0,86,179166,true,L-m-0 L-m-0 L-l-0 L-l-0 L-l-0 L-l-0 C-m-1 
job-3585,5,7,4,178846,178846,179043,0,197,179043,false,C-m-1 C-l-2 C-l-2 L-l-0 
job-3588,4,10,7,179013,179013,179044,0,31,179303,true,L-m-0 L-l-0 C-l-0 C-l-0 C-l-0 C-l-1 C-l-1 
job-3583,1,5,1,178746,178746,179047,0,301,179270,true,L-m-0 
job-3587,3,6,8,178959,178959,179110,0,151,179303,true,L-s-0 C-s-0 C-s-2 C-s-1 C-m-2 C-m-2 C-m-0 C-m-0 
job-3590,2,7,1,179105,179105,179130,0,25,179271,true,L-m-0 
job-3591,1,11,2,179158,179158,179173,0,15,179277,true,L-m-0 L-l-0 
job-3589,5,12,5,179051,179051,179187,0,136,179443,true,L-m-0 L-l-0 L-l-0 C-m-1 C-l-2 
job-3592,6,12,8,179200,179200,179224,0,24,179428,true,L-m-0 L-l-0 L-l-0 C-m-1 C-m-2 C-m-0 C-l-2 C-l-2 
job-3593,5,9,6,179261,179261,179284,0,23,179291,true,L-m-0 L-l-0 L-l-0 C-m-1 C-m-2 C-m-0 
job-3594,1,7,4,179314,179314,179344,0,30,179481,true,L-s-0 L-s-0 L-m-0 L-m-0 
job-3596,2,7,6,179418,179418,179443,0,25,179585,true,L-l-0 L-l-0 L-l-0 L-l-0 L-l-0 L-l-0 
job-3595,4,12,3,179364,179364,179472,0,108,179559,true,L-s-0 L-m-0 L-m-0 
job-3597,3,12,2,179475,179475,179564,0,89,179787,true,L-s-0 L-m-0 
job-3598,4,5,3,179529,179529,179576,0,47,179792,true,L-m-0 L-l-0 L-l-0 
job-3599,5,10,4,179589,179589,179664,0,75,179792,true,L-m-0 L-l-0 L-l-0 C-m-1 
job-3600,3,9,6,179653,179653,179725,0,72,179965,true,L-m-0 C-m-1 L-s-0 C-s-0 C-s-2 C-s-1 
job-3602,6,6,3,179751,179751,179829,0,78,179852,true,C-m-0 C-l-2 C-l-2 
job-3603,4,6,7,179797,179797,179846,0,49,180096,true,L-m-0 C-m-1 L-s-0 C-s-0 C-s-2 C-s-1 C-l-0 
job-3601,3,11,8,179706,179706,179855,0,149,180133,true,L-m-0 C-m-1 L-l-0 L-l-0 L-l-0 L-l-0 C-m-2 C-m-2 
job-3604,5,12,6,179849,179849,179896,0,47,180100,true,L-m-0 C-m-1 C-m-0 C-l-2 C-l-2 C-l-0 
job-3606,4,6,3,179952,179952,179987,0,35,180218,true,L-s-0 C-s-0 C-s-2 
job-3607,1,7,7,179991,179991,180022,0,31,180113,true,L-m-0 L-m-0 L-m-0 L-l-0 L-l-0 C-m-2 C-m-2 
job-3608,1,4,3,180043,180043,180088,0,45,180333,true,L-m-0 L-m-0 L-m-0 
job-3610,4,10,2,180122,180122,180142,0,20,180294,true,L-s-0 C-s-0 
job-3605,5,4,6,179896,179896,180176,0,280,180475,true,L-m-0 L-l-0 L-l-0 C-m-2 C-m-1 C-m-0 
job-3609,2,6,2,180084,180084,180218,0,134,180463,true,L-l-0 C-m-2 
job-3611,6,6,3,180166,180166,180241,0,75,180519,true,C-l-2 C-l-2 C-l-0 
job-3612,6,10,2,180208,180208,180263,0,55,180352,true,L-l-0 C-m-2 
job-3613,6,8,8,180267,180267,180363,0,96,180504,true,L-m-0 L-l-0 L-l-0 C-m-2 C-m-1 C-m-0 C-l-2 C-l-2 
job-3614,4,4,2,180334,180334,180372,0,38,180634,true,L-s-0 C-s-0 
job-3617,2,5,1,180481,180481,180504,0,23,180660,true,L-m-0 
job-3615,6,6,7,180382,180382,180509,0,127,180622,true,L-m-0 L-l-0 L-l-0 C-m-2 C-m-1 C-m-0 C-l-2 
job-3618,1,6,2,180526,180526,180661,0,135,180665,true,L-s-0 C-s-0 
job-3620,3,12,5,180642,180642,180667,0,25,180681,true,L-l-0 C-m-2 C-m-2 C-m-1 C-m-1 
job-3616,3,6,7,180427,180427,180714,0,287,180922,true,C-l-2 C-l-2 L-s-0 C-s-0 C-s-2 C-s-1 C-l-0 
job-3621,3,12,3,180690,180690,180752,0,62,181038,true,L-l-0 C-m-2 C-m-2 
job-3622,4,10,3,180737,180737,180814,0,77,180932,true,C-l-0 C-l-2 C-l-2 
job-3619,4,6,7,180584,180584,180825,0,241,181012,true,C-l-2 C-l-0 C-l-0 L-m-0 L-m-0 L-l-0 L-l-0 
job-3626,6,9,5,180919,180919,180973,0,54,181234,true,L-l-0 L-m-0 C-m-2 C-m-1 C-m-0 
job-3627,2,7,8,180970,180970,181015,0,45,181176,true,L-m-0 C-s-0 C-m-2 C-m-1 C-m-0 C-l-2 C-l-2 C-l-2 
job-3624,4,10,2,180808,180808,181029,0,221,181237,true,C-s-2 C-s-1 
job-3628,2,12,1,181030,181030,181136,0,106,181163,true,L-l-0 
job-3623,1,9,6,180772,180772,181153,0,381,181295,true,L-l-0 L-l-0 L-l-0 L-l-0 L-s-0 C-s-0 
job-3625,2,6,1,180875,180875,181154,0,279,181200,true,L-s-0 
job-3630,1,9,1,181135,181135,181201,0,66,181376,true,L-m-0 
job-3629,2,8,1,181083,181083,181257,0,174,181513,true,L-m-0 
job-3632,2,7,1,181244,181244,181267,0,23,181344,true,L-m-0 
job-3631,6,8,8,181191,181191,181368,0,177,181422,true,L-l-0 L-l-0 C-m-2 C-m-1 C-m-0 C-l-2 C-l-2 C-l-0 
job-3633,5,4,6,181294,181368,181387,74,19,181470,true,L-m-0 L-l-0 L-l-0 C-m-2 C-m-1 C-m-0 
job-3634,3,10,1,181337,181368,181411,31,43,181465,true,L-m-0 
job-3636,4,6,1,181430,181430,181448,0,18,181503,true,C-l-2 
job-3635,5,7,7,181381,181387,181473,6,86,181611,true,L-m-0 L-l-0 L-l-0 C-m-2 C-m-1 C-m-0 C-l-2 
job-3637,1,4,2,181489,181489,181544,0,55,181608,true,L-s-0 L-s-0 
job-3639,3,5,7,181611,181611,181653,0,42,181826,true,L-m-0 L-m-0 L-l-0 L-l-0 L-l-0 L-l-0 C-s-0 
job-3638,2,6,1,181557,181557,181743,0,186,181874,true,L-s-0 
job-3640,5,8,6,181664,181664,181895,0,231,182047,true,L-m-0 L-l-0 L-l-0 C-m-2 C-m-1 C-m-0 
job-3641,5,6,8,181715,181895,181930,180,35,181862,false,L-m-0 L-l-0 L-l-0 C-m-2 C-m-1 C-m-0 C-l-2 C-l-2 
job-3642,5,10,6,181758,181930,182007,172,77,182059,true,L-m-0 L-l-0 L-l-0 C-m-2 C-m-1 C-m-0 
job-3643,4,5,5,181810,181930,182011,120,81,181915,false,L-s-0 C-s-0 C-s-2 C-s-1 C-l-2 
job-3644,4,5,5,181864,181930,182029,66,99,182165,true,C-l-2 C-l-2 C-l-0 C-l-0 C-l-0 
job-3646,3,12,5,181973,181973,182100,0,127,182153,true,L-m-0 C-m-2 C-m-1 C-m-0 C-l-1 
job-3648,3,7,3,182076,182076,182108,0,32,182165,true,C-m-0 C-l-1 L-s-0 
job-3645,6,10,1,181917,181930,182228,13,298,182249,true,C-l-1 
job-3647,5,7,3,182023,182023,182237,0,214,182352,true,L-m-0 C-m-2 C-m-1 
job-3649,6,11,4,182136,182136,182261,0,125,182523,true,C-l-1 L-l-0 L-l-0 C-m-0 
job-3650,4,11,1,182183,182183,182266,0,83,182539,true,L-s-0 
job-3651,4,10,8,182233,182233,182329,0,96,182573,true,C-l-1 C-s-0 C-s-2 C-s-1 C-l-0 C-l-0 C-l-0 C-l-2 
job-3653,5,4,8,182346,182346,182410,0,64,182436,true,L-m-0 L-l-0 L-l-0 C-m-0 C-m-2 C-m-1 C-l-0 C-l-0 
job-3652,4,5,5,182287,182287,182457,0,170,182645,true,C-l-1 C-l-1 C-l-2 C-l-2 L-s-0 
job-3654,2,5,6,182389,182389,182506,0,117,182720,true,L-m-0 L-l-0 C-m-0 C-m-2 C-m-1 C-l-0 
job-3655,3,6,3,182430,182430,182516,0,86,182643,true,L-m-0 L-m-0 L-l-0 
job-3656,1,9,2,182475,182475,182592,0,117,182699,true,L-l-0 L-l-0 
job-3657,5,6,2,182532,182532,182613,0,81,182674,true,L-l-0 L-l-0 
job-3659,5,12,2,182649,182649,182659,0,10,182945,true,L-l-0 L-l-0 
job-3658,4,9,3,182586,182586,182763,0,177,182847,true,L-s-0 L-m-0 L-m-0 
job-3660,4,4,7,182693,182693,182775,0,82,182937,true,L-l-0 L-l-0 L-l-0 C-s-0 C-s-2 C-s-1 C-m-0 
job-3662,6,12,5,182794,182794,182860,0,66,182900,true,L-m-0 L-l-0 L-l-0 C-l-0 C-l-0 
job-3661,4,9,5,182743,182743,182911,0,168,183171,true,C-m-0 C-m-2 C-m-2 C-m-1 C-m-1 
job-3664,6,6,5,182891,182891,182940,0,49,183138,true,C-l-2 L-m-0 L-l-0 L-l-0 C-l-0 
job-3663,5,4,3,182845,182845,182988,0,143,183091,true,C-l-1 C-l-1 C-l-2 
job-3666,2,4,8,183001,183001,183017,0,16,183279,true,C-l-1 C-l-1 C-l-1 C-l-1 C-l-1 C-l-2 C-l-2 C-l-2 
job-3667,3,12,2,183063,183063,183155,0,92,183271,true,C-l-1 C-l-1 
job-3665,1,6,4,182946,182946,183253,0,307,183296,true,C-l-1 C-l-1 C-l-2 C-l-2 
job-3668,1,4,3,183117,183117,183260,0,143,183496,true,C-l-1 C-l-1 C-l-1 
job-3669,6,10,4,183159,183159,183278,0,119,183290,true,C-l-1 C-l-2 L-m-0 L-l-0 
job-3670,3,12,3,183218,183218,183308,0,90,183499,true,L-l-0 L-l-0 C-l-2 
job-3672,4,9,4,183317,183317,183347,0,30,183525,true,C-m-1 C-l-1 C-l-1 L-m-0 
job-3671,4,9,8,183265,183265,183462,0,197,183671,true,C-l-1 L-s-0 C-s-0 C-s-2 C-s-1 C-m-2 C-m-2 C-m-1 
job-3673,4,5,5,183374,183374,183462,0,88,183703,true,C-m-1 C-l-1 C-l-1 L-m-0 L-m-0 
job-3675,6,8,7,183481,183481,183530,0,49,183821,true,L-m-0 C-m-2 C-m-1 C-l-1 C-l-1 C-l-0 C-l-0 
job-3676,5,12,4,183542,183542,183574,0,32,183807,true,L-m-0 C-m-2 C-m-1 C-l-1 
job-3677,6,6,5,183588,183588,183605,0,17,183810,true,L-m-0 C-m-2 C-m-1 C-l-1 C-l-1 
job-3679,1,11,3,183686,183686,183708,0,22,183778,true,C-m-2 C-m-1 C-m-1 
job-3678,1,11,7,183631,183631,183747,0,116,183948,true,L-s-0 L-m-0 L-m-0 C-s-0 C-s-2 C-s-1 C-m-2 
job-3680,1,8,6,183742,183742,183787,0,45,184024,true,L-m-0 C-m-2 C-m-2 C-m-1 C-m-1 C-m-1 
job-3674,4,4,8,183425,183425,183899,0,474,183989,true,L-l-0 L-l-0 L-l-0 C-m-0 C-m-0 C-l-2 C-l-2 C-l-2 
job-3682,3,12,1,183842,183899,183949,57,50,184128,true,L-m-0 
job-3683,4,5,1,183885,183899,183971,14,72,184109,true,L-s-0 
job-3681,5,9,8,183799,183899,184202,100,303,184157,false,L-m-0 L-l-0 L-l-0 C-m-0 C-m-2 C-m-1 C-l-2 C-l-2 
job-3685,2,8,3,183999,184202,184220,203,18,184282,true,L-m-0 C-m-0 C-m-2 
job-3687,2,4,4,184106,184202,184239,96,37,184269,true,C-m-1 C-l-2 C-l-2 C-l-2 
job-3686,3,7,6,184043,184202,184282,159,80,184392,true,L-s-0 C-s-0 C-s-2 C-s-1 C-l-2 C-l-2 
job-3689,3,12,8,184228,184282,184330,54,48,184477,true,C-l-0 C-l-0 C-l-0 L-s-0 C-s-0 C-s-2 C-s-1 C-l-2 
job-3690,4,8,2,184280,184282,184380,2,98,184499,true,C-l-2 C-l-2 
job-3691,5,10,4,184317,184380,184405,63,25,184563,true,C-l-0 C-l-0 C-l-2 C-l-2 
job-3692,5,5,4,184363,184405,184428,42,23,184482,true,C-l-0 C-l-0 C-l-2 C-l-2 
job-3684,6,6,6,183947,184202,184438,255,236,184368,false,L-m-0 L-l-0 L-l-0 C-m-0 C-m-2 C-m-1 
job-3693,2,9,2,184415,184415,184560,0,145,184582,true,L-m-0 C-m-1 
job-3694,5,8,4,184470,184470,184661,0,191,184889,true,L-m-0 C-m-1 C-l-0 C-l-0 
job-3697,2,12,4,184617,184617,184671,0,54,184906,true,L-m-0 L-l-0 C-m-1 C-m-2 
job-3688,2,12,5,184162,184202,184674,40,472,184666,false,C-l-1 C-l-1 C-l-1 C-l-1 C-l-0 
job-3696,4,10,7,184568,184568,184700,0,132,184749,true,L-l-0 L-s-0 C-s-0 C-s-2 C-s-1 C-m-0 C-m-0 
job-3698,4,5,1,184669,184669,184730,0,61,184910,true,L-m-0 
job-3695,5,10,1,184520,184520,184731,0,211,184824,true,L-l-0 
job-3700,3,5,1,184763,184763,184795,0,32,184850,true,L-m-0 
job-3699,2,9,2,184717,184717,184812,0,95,185023,true,L-m-0 L-m-0 
job-3701,2,4,7,184815,184815,184843,0,28,185137,true,L-s-0 L-s-0 L-m-0 L-m-0 L-m-0 L-m-0 L-l-0 
job-3702,6,11,5,184877,184877,184891,0,14,185027,true,L-m-0 L-l-0 L-l-0 C-m-0 C-m-1 
job-3705,4,7,5,185024,185024,185034,0,10,185263,true,L-l-0 L-l-0 C-s-0 C-s-2 C-s-1 
job-3706,4,5,7,185064,185064,185074,0,10,185276,true,L-l-0 L-l-0 C-s-0 C-s-2 C-s-1 C-m-0 C-m-0 
job-3704,1,8,4,184986,184986,185107,0,121,185286,true,L-m-0 L-m-0 L-l-0 L-l-0 
job-3707,5,4,7,185123,185123,185175,0,52,185285,true,L-m-0 L-l-0 L-l-0 C-m-0 C-m-1 C-m-2 C-l-1 
job-3703,1,6,4,184941,184941,185180,0,239,185371,true,L-s-0 L-s-0 L-m-0 L-m-0 
job-3709,4,12,8,185218,185218,185257,0,39,185500,true,C-l-1 C-l-1 C-l-2 C-l-2 L-s-0 L-m-0 L-m-0 L-l-0 
job-3708,4,5,8,185170,185170,185301,0,131,185319,true,C-l-1 C-s-0 C-s-2 C-s-1 C-l-0 C-l-0 C-l-0 C-l-2 
job-3711,3,11,7,185314,185314,185326,0,12,185422,true,L-m-0 C-m-0 C-l-1 C-l-1 C-l-2 C-l-2 L-s-0 
job-3710,5,9,6,185261,185261,185373,0,112,185622,true,C-l-1 C-l-2 L-m-0 L-l-0 L-l-0 C-m-0 
job-3712,3,8,2,185367,185367,185433,0,66,185712,true,L-m-0 C-m-0 
job-3713,4,7,2,185425,185425,185435,0,10,185714,true,L-m-0 C-m-0 
job-3714,1,4,4,185470,185470,185486,0,16,185748,true,L-s-0 L-s-0 L-s-0 L-s-0 
job-3715,3,9,6,185519,185519,185562,0,43,185667,true,L-s-0 L-m-0 L-m-0 L-l-0 L-l-0 L-l-0 
job-3716,4,5,8,185565,185565,185584,0,19,185768,true,L-s-0 L-m-0 L-m-0 L-l-0 L-l-0 L-l-0 C-s-0 C-s-2 
job-3717,6,8,6,185618,185618,185654,0,36,185824,true,L-m-0 L-l-0 L-l-0 C-m-0 C-m-1 C-m-2 
job-3719,1,8,1,185732,185732,185775,0,43,186059,true,L-m-0 
job-3720,6,8,1,185778,185778,185833,0,55,186057,true,L-m-0 
job-3718,2,12,2,185675,185675,185890,0,215,185935,true,L-s-0 L-m-0 
job-3721,3,10,8,185826,185826,185906,0,80,185946,true,L-l-0 L-l-0 L-l-0 L-l-0 C-s-0 C-s-2 C-s-1 C-m-0 
job-3723,5,7,3,185928,185928,185950,0,22,186220,true,C-m-0 C-m-2 L-l-0 
job-3724,4,8,3,185967,185967,185994,0,27,186287,true,C-m-0 C-m-2 L-s-0 
job-3722,3,4,6,185882,185882,186015,0,133,186056,true,L-m-0 L-m-0 C-m-0 C-m-1 C-m-1 C-m-2 
job-3725,5,11,8,186004,186004,186077,0,73,186172,true,C-m-0 C-m-2 L-l-0 L-l-0 C-l-1 C-l-1 C-l-2 C-l-2 
job-3728,1,5,1,186151,186151,186181,0,30,186191,true,L-s-0 
job-3729,1,9,7,186211,186211,186224,0,13,186486,true,L-m-0 C-m-1 C-m-1 C-m-0 C-m-0 C-m-2 C-m-2 
job-3726,3,9,7,186043,186043,186244,0,201,186395,true,C-m-0 C-m-2 L-s-0 L-m-0 L-m-0 C-s-0 C-s-2 
job-3730,6,4,4,186261,186261,186315,0,54,186533,true,L-m-0 C-m-0 C-m-2 C-l-1 
job-3732,1,8,2,186349,186349,186382,0,33,186664,true,L-s-0 C-s-0 
job-3731,3,5,7,186302,186302,186408,0,106,186584,true,C-l-1 C-l-1 L-s-0 C-s-0 C-s-2 C-s-1 C-l-2 
job-3727,6,8,3,186087,186087,186436,0,349,186595,true,L-l-0 L-l-0 C-m-1 
job-3734,2,5,8,186448,186448,186512,0,64,186676,true,C-m-1 C-m-1 C-m-1 C-l-1 C-l-1 C-l-1 C-l-2 C-l-2 
job-3736,5,11,3,186544,186544,186590,0,46,186868,true,L-l-0 C-m-1 C-l-1 
job-3737,5,10,6,186592,186592,186620,0,28,186723,true,L-l-0 C-m-1 C-l-1 C-l-2 C-m-0 C-m-2 
job-3735,5,10,2,186500,186500,186679,0,179,186959,true,L-m-0 L-l-0 
job-3733,2,11,6,186391,186391,186717,0,326,186975,true,C-m-1 C-l-1 C-l-1 C-l-1 C-l-2 C-l-2 
job-3740,3,7,2,186722,186722,186759,0,37,186941,true,C-m-1 C-l-2 
job-3739,4,4,8,186684,186684,186838,0,154,186932,true,L-l-0 L-l-0 L-m-0 L-m-0 C-s-2 C-s-1 C-m-0 C-m-0 
job-3742,2,12,8,186841,186841,186888,0,47,186958,true,L-l-0 L-l-0 L-l-0 C-m-2 C-l-1 L-m-0 L-m-0 C-s-2 
job-3738,4,5,7,186640,186640,186900,0,260,187113,true,L-l-0 C-m-1 C-l-1 C-l-2 C-l-2 L-s-0 C-s-0 
job-3741,3,9,5,186776,186776,186902,0,126,186977,true,C-m-1 C-l-2 C-l-1 C-l-1 C-m-2 
job-3743,4,12,7,186887,186888,186915,1,27,187131,true,L-l-0 L-l-0 C-m-2 L-m-0 L-m-0 C-s-2 C-s-1 
job-3744,6,7,6,186939,186939,186955,0,16,187174,true,L-m-0 L-l-0 L-l-0 C-m-1 C-m-2 C-m-0 
job-3745,6,5,6,186990,186990,187027,0,37,187208,true,L-m-0 L-l-0 L-l-0 C-m-1 C-m-2 C-m-0 
job-3747,2,7,2,187091,187091,187113,0,22,187171,true,L-m-0 L-l-0 
job-3746,5,11,5,187041,187041,187114,0,73,187169,true,L-m-0 L-l-0 L-l-0 C-m-1 C-m-2 
job-3748,4,11,7,187151,187151,187166,0,15,187403,true,L-s-0 L-m-0 L-m-0 L-l-0 L-l-0 L-l-0 C-s-0 
job-3749,4,5,2,187201,187201,187226,0,25,187464,true,L-s-0 L-m-0 
job-3751,1,6,7,187277,187277,187308,0,31,187556,true,C-s-2 C-s-2 C-s-1 C-s-1 C-m-1 C-m-1 C-m-1 
job-3753,4,10,4,187385,187385,187469,0,84,187475,true,C-m-0 C-l-1 C-l-1 C-l-1 
job-3750,4,10,7,187234,187234,187503,0,269,187760,true,L-s-0 L-m-0 L-m-0 L-l-0 L-l-0 L-l-0 C-s-0 
job-3755,1,6,4,187484,187484,187521,0,37,187579,true,C-m-0 C-m-0 C-m-0 C-l-0 
job-3752,4,9,7,187323,187323,187545,0,222,187591,true,C-s-2 C-s-1 C-m-1 C-m-1 C-m-2 C-m-2 C-m-0 
job-3756,6,10,1,187539,187539,187568,0,29,187620,true,C-l-0 
job-3754,3,5,6,187428,187428,187570,0,142,187857,true,C-l-2 C-l-2 C-l-2 C-l-2 C-l-0 C-l-0 
job-3757,4,9,3,187604,187604,187682,0,78,187925,true,L-s-0 L-m-0 L-m-0 
job-3758,4,9,2,187646,187646,187703,0,57,187739,true,L-l-0 L-l-0 
job-3759,1,7,1,187681,187681,187721,0,40,187864,true,L-l-0 
job-3760,6,12,1,187745,187745,187840,0,95,188014,true,L-m-0 
job-3761,5,7,2,187795,187795,187902,0,107,188073,true,L-l-0 L-l-0 
job-3763,3,7,4,187888,187888,187908,0,20,188128,true,L-m-0 L-m-0 C-s-0 C-m-1 
job-3764,6,12,3,187934,187934,187966,0,32,188204,true,L-m-0 L-l-0 C-m-1 
job-3762,2,7,7,187838,187838,188085,0,247,188103,true,L-m-0 L-l-0 L-s-0 L-s-0 C-s-2 C-s-2 C-s-1 
job-3766,6,4,6,188033,188033,188177,0,144,188328,true,C-l-2 C-l-2 C-l-0 C-l-0 C-l-1 C-l-1 
job-3768,4,5,4,188128,188177,188223,49,46,188318,true,C-l-2 C-l-2 C-l-0 C-l-0 
job-3765,6,4,5,187978,187978,188226,0,248,188383,true,L-m-0 L-l-0 C-m-1 C-m-2 C-m-0 
job-3769,4,4,8,188185,188223,188253,38,30,188251,false,C-l-2 C-l-2 C-l-0 C-l-0 C-l-0 C-l-1 C-l-1 C-l-1 
job-3770,5,9,1,188251,188251,188313,0,62,188444,true,L-l-0 
job-3771,2,4,2,188303,188303,188324,0,21,188362,true,C-l-2 C-l-2 
job-3767,3,10,7,188082,188177,188326,95,149,188475,true,L-l-0 L-l-0 L-s-0 C-s-2 C-s-1 C-s-0 C-l-2 
job-3772,3,8,5,188353,188353,188388,0,35,188524,true,L-s-0 L-m-0 L-m-0 L-l-0 L-l-0 
job-3774,5,10,2,188439,188439,188496,0,57,188735,true,L-l-0 L-l-0 
job-3773,5,12,1,188400,188400,188509,0,109,188623,true,L-m-0 
job-3776,2,10,4,188548,188548,188565,0,17,188675,true,L-m-0 L-s-0 L-l-0 L-l-0 
job-3775,1,5,3,188498,188498,188594,0,96,188814,true,L-m-0 L-m-0 L-m-0 
job-3779,2,12,5,188698,188698,188780,0,82,188993,true,L-l-0 C-s-1 C-s-0 C-m-1 C-m-1 
job-3780,5,11,3,188746,188746,188785,0,39,188942,true,C-m-2 C-m-0 C-l-2 
job-3778,4,7,3,188654,188654,188791,0,137,189005,true,L-l-0 L-l-0 C-s-2 
job-3781,1,6,7,188806,188806,188890,0,84,189122,true,L-s-0 L-l-0 L-l-0 L-l-0 L-l-0 L-l-0 L-l-0 
job-3777,2,9,5,188603,188603,188947,0,344,189200,true,L-s-0 L-m-0 L-m-0 L-m-0 L-l-0 
job-3782,1,7,6,188866,188866,188968,0,102,189007,true,C-s-2 C-s-2 C-s-1 C-s-1 C-s-0 C-s-0 
job-3784,5,9,3,188963,188963,189025,0,62,189144,true,L-l-0 L-m-0 C-m-0 
job-3783,2,10,8,188916,188916,189059,0,143,189338,true,L-l-0 L-l-0 L-l-0 C-m-1 C-m-1 C-m-1 C-m-2 C-m-2 
job-3786,3,5,5,189061,189061,189110,0,49,189214,true,L-s-0 L-m-0 L-m-0 C-m-0 C-m-0 
job-3785,1,10,6,189018,189018,189148,0,130,189186,true,L-m-0 L-m-0 C-m-2 C-m-0 C-m-0 L-s-0 
job-3787,6,10,7,189098,189098,189157,0,59,189198,true,C-m-2 L-l-0 L-l-0 C-m-1 C-l-2 C-l-2 C-l-0 
job-3788,4,4,6,189142,189142,189168,0,26,189254,true,L-m-0 C-m-0 C-l-0 C-s-2 C-s-1 C-s-0 
job-3790,2,8,5,189258,189258,189351,0,93,189398,true,L-m-0 C-m-2 C-m-1 C-m-0 C-l-2 
job-3789,6,11,7,189199,189199,189405,0,206,189590,true,L-m-0 L-l-0 L-l-0 C-m-2 C-m-1 C-m-0 C-l-2 
job-3792,4,5,3,189363,189363,189427,0,64,189636,true,C-s-0 C-l-0 C-l-0 
job-3791,4,10,4,189310,189310,189464,0,154,189509,true,C-l-2 L-s-0 C-s-2 C-s-1 
job-3793,3,12,6,189403,189405,189516,2,111,189797,true,C-l-0 C-l-2 C-l-2 L-m-0 L-m-0 L-l-0 
job-3794,5,10,5,189449,189449,189573,0,124,189833,true,L-l-0 C-l-0 C-m-2 C-m-1 C-m-0 
job-3797,5,10,3,189589,189589,189638,0,49,189821,true,C-m-2 C-m-1 C-m-0 
job-3795,5,10,6,189486,189516,189642,30,126,189854,true,L-l-0 C-l-0 L-m-0 C-l-2 C-l-2 C-l-1 
job-3798,2,8,2,189645,189645,189747,0,102,189823,true,L-l-0 L-l-0 
job-3799,2,8,6,189689,189689,189775,0,86,189977,true,L-l-0 L-l-0 C-l-0 C-l-0 C-l-0 C-l-0 
job-3796,4,5,7,189535,189573,189802,38,229,189966,true,L-l-0 C-l-0 C-l-1 L-s-0 C-s-2 C-s-1 C-s-0 
job-3800,5,5,1,189743,189743,189814,0,71,189814,false,C-l-1 
job-3801,5,4,6,189796,189796,189842,0,46,189965,true,L-l-0 C-l-0 L-m-0 C-m-2 C-m-1 C-m-0 
job-3802,3,12,6,189844,189844,189960,0,116,190154,true,L-s-0 L-m-0 L-m-0 L-l-0 L-l-0 L-l-0 
job-3804,6,9,5,189942,189942,190048,0,106,190313,true,C-m-1 C-m-0 C-l-1 C-l-1 C-l-0 
job-3806,3,8,1,190042,190048,190085,6,37,190228,true,L-m-0 
job-3805,5,7,8,189982,190048,190112,66,64,190297,true,L-m-0 L-l-0 L-l-0 C-m-1 C-m-0 C-l-1 C-l-1 C-l-0 
job-3803,5,9,1,189899,189899,190147,0,248,190150,true,C-m-2 
job-3809,2,12,3,190197,190197,190291,0,94,190371,true,C-l-2 L-s-0 L-m-0 
job-3807,5,10,3,190095,190095,190296,0,201,190385,true,C-l-0 C-l-2 C-l-2 
job-3810,1,6,2,190244,190244,190325,0,81,190596,true,L-m-0 L-m-0 
job-3812,3,8,1,190355,190355,190366,0,11,190490,true,L-l-0 
job-3811,6,4,3,190318,190318,190407,0,89,190429,true,L-m-0 C-l-0 L-l-0 
job-3808,6,12,1,190148,190148,190464,0,316,190608,true,C-l-0 
job-3814,3,12,3,190468,190468,190479,0,11,190738,true,L-l-0 C-l-0 C-l-0 
job-3816,2,9,5,190578,190578,190668,0,90,190946,true,L-l-0 C-l-0 C-l-0 C-l-0 C-l-0 
job-3815,1,11,1,190516,190516,190688,0,172,190972,true,L-l-0 
job-3813,4,10,6,190412,190412,190736,0,324,190925,true,C-l-0 L-s-0 L-m-0 L-m-0 L-l-0 L-l-0 
job-3820,5,9,2,190787,190787,190811,0,24,191041,true,L-m-0 C-m-1 
job-3819,2,8,5,190738,190738,190851,0,113,191093,true,L-l-0 L-l-0 L-l-0 L-l-0 C-m-2 
job-3817,5,11,1,190633,190633,190866,0,233,190899,true,C-m-2 
job-3821,6,10,8,190840,190840,191078,0,238,191327,true,L-m-0 C-m-1 C-m-0 C-l-0 C-l-0 C-l-2 C-l-2 C-l-1 
job-3823,5,6,1,190940,191078,191100,138,22,191128,true,C-l-2 
job-3818,1,5,4,190678,190678,191124,0,446,191367,true,L-l-0 L-l-0 L-l-0 C-m-2 
job-3825,6,7,2,191041,191078,191175,37,97,191375,true,C-l-1 C-l-1 
job-3824,1,7,8,190993,191078,191235,85,157,191335,true,L-m-0 L-m-0 L-l-0 L-l-0 L-l-0 C-m-2 C-m-1 C-m-1 
job-3826,1,5,1,191085,191085,191276,0,191,191413,true,C-m-0 
job-3828,3,12,5,191177,191177,191282,0,105,191369,true,C-l-2 C-l-2 L-s-0 C-s-2 C-s-1 
job-3827,1,4,3,191125,191125,191284,0,159,191522,true,L-l-0 L-l-0 L-l-0 
job-3822,6,10,8,190889,191078,191352,189,274,191416,true,L-l-0 C-m-2 L-m-0 C-m-1 C-m-0 C-l-0 C-l-0 C-l-2 
job-3831,3,5,8,191321,191352,191364,31,12,191359,false,C-l-2 C-l-2 L-s-0 C-s-2 C-s-1 C-s-0 C-l-1 C-l-1 
job-3829,6,9,6,191225,191352,191369,127,17,191409,true,L-m-0 L-l-0 L-l-0 C-m-0 C-m-1 C-m-2 
job-3832,4,8,7,191377,191377,191403,0,26,191449,true,C-l-2 L-s-0 L-m-0 L-m-0 L-l-0 L-l-0 L-l-0 
job-3830,6,11,3,191267,191352,191478,85,126,191437,false,C-l-0 C-l-0 C-l-2 
job-3833,3,8,5,191422,191422,191514,0,92,191651,true,C-l-2 C-l-2 L-s-0 L-m-0 L-m-0 
job-3836,1,12,6,191552,191552,191578,0,26,191670,true,C-m-0 C-m-1 C-m-2 C-l-2 C-l-2 C-l-2 
job-3834,6,11,8,191458,191478,191655,20,177,191880,true,C-l-2 L-l-0 L-l-0 C-m-0 C-m-1 C-m-2 C-l-0 C-l-0 
job-3837,1,4,8,191608,191608,191670,0,62,191777,true,C-s-2 C-s-1 C-s-0 C-m-0 C-m-0 C-m-1 C-m-1 C-m-2 
job-3835,3,11,3,191507,191507,191677,0,170,191901,true,C-s-2 C-s-1 C-s-0 
job-3838,1,12,2,191655,191655,191774,0,119,191813,true,C-m-0 C-m-0 
job-3840,6,5,4,191755,191755,191774,0,19,191846,true,C-m-0 L-l-0 L-l-0 C-m-1 
job-3839,5,11,1,191706,191706,191824,0,118,192038,true,L-m-0 
job-3843,3,6,5,191895,191895,191960,0,65,192038,true,L-l-0 L-l-0 L-l-0 C-s-2 C-s-1 
job-3842,1,12,3,191855,191855,191988,0,133,192032,true,L-m-0 L-s-0 L-l-0 
job-3844,1,8,3,191956,191956,192002,0,46,192015,true,L-l-0 L-l-0 C-s-2 
job-3846,1,5,4,192056,192056,192066,0,10,192212,true,L-m-0 L-s-0 L-s-0 L-s-0 
job-3845,4,7,1,192011,192011,192123,0,112,192123,false,L-m-0 
job-3841,1,8,2,191805,191805,192135,0,330,192221,true,L-m-0 L-m-0 
job-3847,4,7,2,192111,192111,192237,0,126,192357,true,L-s-0 L-l-0 
job-3851,6,8,7,192320,192320,192331,0,11,192480,true,C-m-2 C-l-0 C-l-0 C-l-2 C-l-2 C-l-1 C-l-1 
job-3850,2,10,7,192274,192274,192345,0,71,192498,true,L-l-0 L-s-0 C-m-0 C-m-0 C-m-0 C-m-1 C-m-1 
job-3849,1,11,7,192223,192223,192386,0,163,192464,true,L-m-0 L-m-0 L-l-0 L-l-0 C-s-2 C-s-1 C-s-0 
job-3852,4,8,5,192362,192362,192503,0,141,192527,true,L-l-0 L-s-0 C-m-0 C-m-0 C-m-1 
job-3848,5,9,2,192164,192164,192552,0,388,192552,false,L-l-0 L-m-0 
job-3854,2,12,3,192466,192503,192571,37,68,192632,true,L-m-0 L-l-0 C-m-0 
job-3856,3,4,4,192548,192548,192580,0,32,192621,true,C-l-1 C-l-1 C-l-1 C-l-1 
job-3853,5,8,8,192412,192503,192693,91,190,192710,true,L-l-0 C-m-0 C-m-1 C-m-2 C-l-0 C-l-0 C-l-2 C-l-2 
job-3857,5,7,7,192610,192693,192745,83,52,192688,false,C-m-1 C-m-2 L-m-0 L-l-0 L-l-0 C-m-0 C-l-0 
job-3858,3,12,1,192659,192693,192745,34,52,192927,true,L-m-0 
job-3859,6,11,6,192712,192745,192777,33,32,192941,true,L-l-0 L-l-0 C-m-0 C-l-0 C-l-0 C-l-2 
job-3860,2,6,8,192763,192763,192831,0,68,192995,true,C-m-0 C-m-1 C-m-1 C-m-2 C-m-2 C-l-2 C-l-2 C-l-2 
job-3861,2,6,5,192810,192810,192862,0,52,192991,true,C-m-0 C-m-0 C-m-0 C-l-2 C-l-2 
job-3862,1,11,6,192859,192859,192874,0,15,193072,true,C-m-0 C-m-1 C-m-1 C-m-2 C-m-2 C-l-2 
job-3864,6,6,4,192977,192977,193004,0,27,193247,true,C-l-0 C-l-0 C-l-1 C-l-1 
job-3865,1,8,3,193027,193027,193092,0,65,193270,true,L-m-0 L-m-0 C-m-0 
job-3863,6,5,6,192918,192918,193108,0,190,193141,true,L-m-0 L-l-0 L-l-0 C-m-0 C-l-2 C-l-2 
job-3855,3,9,6,192508,192508,193127,0,619,193228,true,C-m-1 C-m-2 L-s-0 C-s-2 C-s-1 C-s-0 
job-3866,1,11,6,193080,193080,193199,0,119,193397,true,C-m-0 C-m-1 C-m-1 C-m-2 C-m-2 C-l-0 
job-3867,3,11,2,193142,193142,193212,0,70,193307,true,C-m-0 C-l-0 
job-3869,6,4,6,193238,193238,193282,0,44,193551,true,L-m-0 L-l-0 L-l-0 C-l-0 C-l-0 C-l-2 
job-3870,2,9,6,193287,193287,193373,0,86,193527,true,C-m-0 C-m-0 C-m-1 C-m-1 C-m-2 C-m-2 
job-3871,6,10,1,193347,193347,193393,0,46,193617,true,L-m-0 
job-3872,3,5,6,193395,193395,193412,0,17,193539,true,C-m-0 C-m-1 C-m-2 L-s-0 L-m-0 L-m-0 
job-3868,4,9,3,193183,193183,193478,0,295,193776,true,C-m-0 C-m-1 C-m-2 
job-3874,6,10,6,193520,193520,193558,0,38,193728,true,C-l-0 C-m-0 C-m-1 C-m-2 C-l-2 C-l-2 
job-3875,3,11,3,193567,193567,193629,0,62,193785,true,L-m-0 C-l-0 C-l-0 
job-3873,5,7,4,193460,193460,193632,0,172,193654,true,L-m-0 L-l-0 L-l-0 C-l-0 
job-3878,1,12,6,193708,193708,193741,0,33,193852,true,L-m-0 L-l-0 L-l-0 L-l-0 L-l-0 C-s-2 
job-3876,6,9,1,193612,193612,193785,0,173,193801,true,C-m-0 
job-3879,2,8,8,193745,193745,193792,0,47,193982,true,L-m-0 L-m-0 L-l-0 L-l-0 L-l-0 L-l-0 L-l-0 L-l-0 
job-3877,2,9,3,193661,193661,193801,0,140,193867,true,C-m-0 L-s-0 L-m-0 
job-3880,2,11,8,193791,193791,193857,0,66,194129,true,C-m-0 C-m-0 C-s-2 C-s-1 C-s-0 C-m-1 C-m-1 C-m-2 
job-3881,5,12,6,193842,193842,193882,0,40,193943,true,C-m-2 L-m-0 L-l-0 L-l-0 C-l-0 C-l-0 
job-3884,2,10,3,193984,193984,194017,0,33,194291,true,C-m-0 C-m-0 C-m-0 
job-3885,4,7,5,194036,194036,194057,0,21,194334,true,C-m-0 C-m-0 C-m-1 C-m-1 C-m-2 
job-3882,4,4,4,193899,193899,194088,0,189,194369,true,L-s-0 L-m-0 L-m-0 L-l-0 
job-3883,4,7,5,193946,193946,194094,0,148,194309,true,L-l-0 L-l-0 C-s-2 C-s-1 C-s-0 
job-3886,1,11,1,194081,194081,194158,0,77,194183,true,C-m-0 
job-3888,1,4,7,194176,194176,194234,0,58,194245,true,L-m-0 L-m-0 L-l-0 L-l-0 L-l-0 L-l-0 L-l-0 
job-3890,1,9,1,194259,194259,194270,0,11,194540,true,L-m-0 
job-3889,1,6,8,194221,194221,194430,0,209,194631,true,L-l-0 C-m-0 C-m-0 L-s-0 L-s-0 C-s-2 C-s-2 C-s-1 
job-3891,6,5,7,194311,194311,194472,0,161,194663,true,C-m-1 C-m-2 C-l-0 C-l-0 C-l-2 C-l-2 C-l-1 
job-3892,5,10,8,194362,194472,194515,110,43,194627,true,L-l-0 C-m-1 C-m-2 C-l-0 C-l-0 C-l-2 C-l-2 C-l-1 
job-3894,3,12,3,194476,194515,194543,39,28,194711,true,L-s-0 C-s-2 C-s-1 
job-3893,6,9,7,194416,194515,194570,99,55,194634,true,L-l-0 C-m-1 C-m-2 C-l-0 C-l-0 C-l-2 C-l-2 
job-3887,6,8,3,194139,194139,194584,0,445,194723,true,C-m-0 L-m-0 L-l-0 
job-3896,6,6,7,194569,194570,194785,1,215,194895,true,L-l-0 C-l-1 C-m-1 C-m-2 C-l-0 C-l-0 C-l-2 
job-3897,6,12,8,194628,194785,194802,157,17,194798,false,C-l-1 L-m-0 L-l-0 L-l-0 C-m-1 C-m-2 C-m-0 C-l-0 
job-3898,3,7,5,194676,194785,194840,109,55,194836,false,C-l-0 C-l-0 C-l-2 C-l-2 C-l-2 
job-3901,6,8,3,194831,194831,194871,0,40,195013,true,L-l-0 L-l-0 C-m-1 
job-3895,3,12,6,194524,194543,194872,19,329,194884,true,L-s-0 C-s-2 C-s-1 C-s-0 C-l-1 C-l-1 
job-3903,3,8,4,194929,194929,194947,0,18,195184,true,L-l-0 L-l-0 L-l-0 C-s-2 
job-3900,6,9,1,194782,194802,194951,20,149,195126,true,L-m-0 
job-3904,1,5,2,194977,194977,195039,0,62,195231,true,L-s-0 L-l-0 
job-3905,1,7,2,195014,195014,195081,0,67,195105,true,L-l-0 L-l-0 
job-3902,3,4,6,194897,194897,195126,0,229,195303,true,C-l-1 C-l-1 C-l-0 C-l-0 L-s-0 L-l-0 
job-3908,3,4,6,195173,195173,195211,0,38,195417,true,L-s-0 L-l-0 L-l-0 C-l-1 C-l-1 C-l-0 
job-3906,2,6,8,195054,195054,195266,0,212,195433,true,L-l-0 L-l-0 L-l-0 C-l-1 C-l-0 L-m-0 L-m-0 L-m-0 
job-3907,1,4,3,195118,195118,195273,0,155,195546,true,L-s-0 L-m-0 L-m-0 
job-3899,4,7,2,194726,194802,195302,76,500,195294,false,C-l-1 C-l-0 
job-3910,5,11,4,195285,195285,195369,0,84,195380,true,L-l-0 C-l-0 L-m-0 C-m-1 
job-3911,6,11,3,195342,195342,195376,0,34,195455,true,C-l-0 C-l-1 C-m-2 
job-3909,4,11,2,195226,195226,195442,0,216,195733,true,L-l-0 C-l-1 
job-3913,3,7,8,195449,195449,195492,0,43,195751,true,L-l-0 C-l-1 C-s-2 C-s-1 C-s-0 C-m-1 C-m-1 C-m-2 
job-3912,4,7,7,195388,195388,195524,0,136,195735,true,L-l-0 L-l-0 C-l-1 C-l-1 L-s-0 L-m-0 L-m-0 
job-3914,6,5,5,195512,195512,195544,0,32,195747,true,C-m-1 C-m-2 C-m-0 C-l-0 C-l-0 
job-3915,3,8,2,195554,195554,195643,0,89,195687,true,L-s-0 L-m-0 
job-3916,2,6,4,195610,195610,195667,0,57,195888,true,L-m-0 L-m-0 L-l-0 L-l-0 
job-3917,4,5,6,195660,195660,195736,0,76,195897,true,L-m-0 L-l-0 L-l-0 L-s-0 C-s-2 C-s-1 
job-3918,5,12,1,195696,195696,195785,0,89,196031,true,C-m-1 
job-3919,6,8,2,195750,195750,195869,0,119,196072,true,L-m-0 L-l-0 
job-3920,6,11,6,195795,195795,196048,0,253,196127,true,L-l-0 C-m-1 C-m-2 C-m-0 C-l-1 C-l-1 
job-3923,4,12,2,195961,196048,196070,87,22,196202,true,L-s-0 C-s-2 
job-3924,4,12,8,196010,196048,196074,38,26,196236,true,C-s-1 C-s-0 C-l-0 C-l-0 C-l-0 C-l-2 C-l-2 C-l-2 
job-3922,3,8,1,195896,196048,196106,152,58,196188,true,C-l-1 
job-3926,2,9,1,196120,196120,196136,0,16,196398,true,C-m-1 
job-3925,1,6,1,196065,196065,196144,0,79,196286,true,L-m-0 
job-3921,6,6,7,195845,196048,196283,203,235,196195,false,L-m-0 L-l-0 L-l-0 C-m-1 C-m-2 C-m-0 C-l-1 
job-3927,5,5,8,196168,196283,196354,115,71,196250,false,L-m-0 L-l-0 L-l-0 C-m-1 C-m-2 C-m-0 C-l-1 C-l-1 
job-3929,4,6,5,196279,196354,196401,75,47,196416,true,L-s-0 C-s-2 C-s-1 C-s-0 C-m-0 
job-3928,5,11,5,196232,196354,196454,122,100,196449,false,L-m-0 L-l-0 L-l-0 C-m-1 C-m-2 
job-3932,3,12,8,196440,196440,196506,0,66,196547,true,C-m-0 L-s-0 C-s-2 C-s-1 C-s-0 C-l-1 C-l-1 C-l-1 
job-3931,3,9,3,196383,196383,196600,0,217,196804,true,C-m-1 C-m-2 C-m-0 
job-3934,3,4,2,196555,196555,196651,0,96,196736,true,L-m-0 C-m-0 
job-3933,4,12,2,196494,196494,196700,0,206,196993,true,C-m-1 C-m-2 
job-3937,3,5,4,196698,196698,196717,0,19,196914,true,L-l-0 L-l-0 L-l-0 C-m-1 
job-3930,1,7,3,196328,196354,196721,26,367,196882,true,L-m-0 L-m-0 L-m-0 
job-3939,3,7,4,196810,196810,196852,0,42,197017,true,L-l-0 L-l-0 L-l-0 C-m-0 
job-3936,3,5,2,196654,196654,196911,0,257,196983,true,L-s-0 L-m-0 
job-3935,1,11,6,196605,196605,196937,0,332,197098,true,C-m-1 C-m-2 C-m-0 C-m-0 L-s-0 L-l-0 
job-3941,1,9,3,196917,196917,196967,0,50,197244,true,L-l-0 L-l-0 C-m-1 
job-3942,4,4,4,196982,196982,197016,0,34,197290,true,L-m-0 L-l-0 L-s-0 C-s-2 
job-3938,2,12,3,196754,196754,197019,0,265,197082,true,L-m-0 L-m-0 L-l-0 
job-3940,6,5,2,196873,196873,197076,0,203,197187,true,L-l-0 C-m-0 
job-3944,2,10,4,197082,197082,197106,0,24,197342,true,L-l-0 L-l-0 L-l-0 L-l-0 
job-3945,2,11,5,197131,197131,197143,0,12,197371,true,L-l-0 L-l-0 L-l-0 L-s-0 L-m-0 
job-3943,3,8,1,197039,197039,197166,0,127,197424,true,L-l-0 
job-3946,6,12,8,197180,197180,197273,0,93,197470,true,L-m-0 L-l-0 L-l-0 C-m-0 C-m-1 C-m-2 C-l-1 C-l-1 
job-3947,5,11,3,197236,197236,197300,0,64,197595,true,C-l-0 C-l-0 C-l-2 
job-3948,1,6,6,197282,197282,197341,0,59,197364,true,C-l-0 C-l-0 C-l-2 C-l-2 C-l-2 C-l-2 
job-3949,4,7,4,197325,197325,197354,0,29,197454,true,C-l-2 C-l-2 C-l-0 C-l-0 
job-3951,6,11,4,197410,197410,197485,0,75,197587,true,L-l-0 C-m-0 C-m-1 C-m-2 
job-3952,1,11,7,197455,197455,197546,0,91,197568,true,L-l-0 C-m-0 C-m-1 C-m-2 C-s-2 C-s-1 C-s-0 
job-3950,1,12,5,197374,197374,197580,0,206,197586,true,L-s-0 L-m-0 L-m-0 L-l-0 L-l-0 
job-3953,2,10,4,197515,197515,197615,0,100,197726,true,L-l-0 C-m-0 C-m-0 C-m-1 
job-3954,6,9,7,197567,197567,197750,0,183,197939,true,L-l-0 C-m-1 C-m-2 C-l-2 C-l-2 C-l-0 C-l-0 
job-3957,3,5,2,197708,197708,197778,0,70,197886,true,L-m-0 C-s-2 
job-3956,2,6,4,197666,197666,197781,0,115,197976,true,C-m-1 C-m-2 L-m-0 L-m-0 
job-3955,3,4,3,197618,197618,197782,0,164,197888,true,L-l-0 L-l-0 L-s-0 
job-3958,3,8,8,197746,197746,197793,0,47,197860,true,C-s-1 C-s-0 C-m-0 C-m-0 C-l-1 C-l-1 C-l-1 C-l-1 
job-3959,2,5,7,197790,197790,197845,0,55,197994,true,C-m-0 L-s-0 L-s-0 L-m-0 L-m-0 L-m-0 L-m-0 
job-3960,3,7,5,197849,197849,197925,0,76,198110,true,L-s-0 L-m-0 L-m-0 L-l-0 L-l-0 
job-3962,6,12,1,197963,197963,197984,0,21,198224,true,L-l-0 
job-3961,4,9,1,197899,197899,198020,0,121,198290,true,L-l-0 
job-3964,6,10,2,198071,198071,198082,0,11,198249,true,L-l-0 L-m-0 
job-3966,3,7,5,198144,198144,198158,0,14,198247,true,L-m-0 L-m-0 C-s-1 C-s-0 C-s-2 
job-3963,3,7,2,198012,198012,198264,0,252,198422,true,L-l-0 L-l-0 
job-3967,3,7,7,198206,198206,198368,0,162,198443,true,L-m-0 L-m-0 C-s-1 C-s-0 C-s-2 C-m-0 C-m-0 
job-3968,2,11,5,198267,198267,198372,0,105,198430,true,L-m-0 L-l-0 L-l-0 C-m-0 C-m-1 
job-3965,2,8,5,198108,198108,198389,0,281,198535,true,L-l-0 L-l-0 L-l-0 L-s-0 L-s-0 
job-3971,4,11,5,198416,198416,198455,0,39,198550,true,L-m-0 C-m-0 C-m-1 L-s-0 L-l-0 
job-3970,4,6,4,198369,198369,198518,0,149,198675,true,L-m-0 C-m-0 C-l-2 C-s-1 
job-3969,4,5,8,198330,198330,198621,0,291,198738,true,C-m-1 C-m-2 C-m-2 C-l-1 C-l-1 C-l-1 C-l-2 C-l-2 
job-3972,5,9,8,198466,198621,198662,155,41,198793,true,L-m-0 L-l-0 L-l-0 C-m-2 C-m-1 C-m-0 C-l-1 C-l-1 
job-3976,1,10,3,198667,198667,198713,0,46,198797,true,L-m-0 L-m-0 L-l-0 
job-3974,1,11,2,198573,198621,198724,48,103,198743,true,L-l-0 L-l-0 
job-3975,1,4,8,198622,198622,198727,0,105,198807,true,C-l-1 C-l-1 L-s-0 L-s-0 L-s-0 L-s-0 C-s-1 C-s-1 
job-3977,4,8,2,198718,198718,198769,0,51,198980,true,L-m-0 L-l-0 
job-3978,3,6,1,198759,198759,198808,0,49,199060,true,L-l-0 
job-3979,5,4,8,198810,198810,198860,0,50,199132,true,L-m-0 C-m-2 C-m-1 C-m-0 L-l-0 L-l-0 C-l-1 C-l-1 
job-3980,6,4,5,198864,198864,198886,0,22,198950,true,L-l-0 L-l-0 C-l-1 C-l-1 C-l-2 
job-3973,3,7,4,198516,198621,198890,105,269,199004,true,L-m-0 C-m-2 C-m-1 C-m-0 
job-3983,4,7,5,199014,199014,199046,0,32,199317,true,C-s-1 C-s-0 C-s-2 C-l-1 C-l-1 
job-3982,3,11,5,198956,198956,199063,0,107,199324,true,L-m-0 C-m-2 C-m-1 C-m-0 L-s-0 
job-3985,6,11,2,199121,199121,199142,0,21,199324,true,C-l-1 C-l-1 
job-3984,2,11,2,199074,199074,199163,0,89,199322,true,L-m-0 L-l-0 
job-3986,4,11,1,199172,199172,199288,0,116,199510,true,L-s-0 
job-3988,2,8,6,199272,199272,199303,0,31,199548,true,L-m-0 L-l-0 C-m-2 C-m-1 C-m-0 C-l-1 
job-3981,5,12,6,198912,198912,199311,0,399,199324,true,L-m-0 L-l-0 L-l-0 C-m-2 C-m-1 C-m-0 
job-3989,3,12,5,199326,199326,199336,0,10,199405,true,C-l-1 L-s-0 L-m-0 L-m-0 L-l-0 
job-3987,4,9,5,199222,199222,199398,0,176,199549,true,C-s-1 C-s-0 C-s-2 C-l-1 C-l-1 
job-3991,2,7,4,199413,199413,199453,0,40,199647,true,L-m-0 L-l-0 C-m-2 C-m-1 
job-3990,5,10,5,199376,199376,199519,0,143,199670,true,L-m-0 L-l-0 L-l-0 C-m-2 C-m-1 
job-3993,2,12,6,199511,199511,199582,0,71,199606,true,L-l-0 C-s-0 C-s-2 C-m-0 C-m-0 C-l-1 
job-3995,1,10,2,199603,199603,199614,0,11,199697,true,L-l-0 C-m-1 
job-3996,1,6,6,199659,199659,199679,0,20,199870,true,L-m-0 L-l-0 L-l-0 C-m-2 C-m-1 C-m-1 
job-3994,3,12,5,199555,199555,199712,0,157,199979,true,L-m-0 L-l-0 L-l-0 L-l-0 C-m-2 
job-3992,3,12,5,199453,199453,199734,0,281,199958,true,L-m-0 C-m-2 C-m-1 L-s-0 C-s-1 
job-3997,5,5,7,199713,199713,199794,0,81,199969,true,L-m-0 C-m-2 C-m-1 L-l-0 L-l-0 C-m-0 C-l-1 
job-3998,2,9,6,199774,199774,199883,0,109,199965,true,L-m-0 L-l-0 C-m-2 C-m-1 C-m-0 C-l-1 
job-4000,3,9,6,199867,199867,199887,0,20,200146,true,L-l-0 L-l-0 L-l-0 C-m-2 C-m-2 C-m-1 
job-4001,6,6,1,199910,199910,199969,0,59,200040,true,L-l-0 
job-3999,2,7,3,199816,199816,199996,0,180,200187,true,L-m-0 L-m-0 L-m-0 
job-4002,4,12,8,199972,199972,200014,0,42,200207,true,L-s-0 L-l-0 L-l-0 L-l-0 C-s-1 C-s-0 C-s-2 C-m-2 
job-4003,5,10,7,200027,200027,200150,0,123,200393,true,L-m-0 L-l-0 L-l-0 C-m-2 C-m-1 C-m-0 C-l-1 
job-4004,1,10,5,200071,200071,200210,0,139,200237,true,L-m-0 L-m-0 L-l-0 L-l-0 C-m-2 
job-4005,3,6,2,200133,200133,200228,0,95,200274,true,C-m-1 C-m-0 
job-4007,5,8,3,200232,200232,200246,0,14,200514,true,L-m-0 L-l-0 L-l-0 
job-4006,1,4,5,200178,200178,200272,0,94,200342,true,L-m-0 L-m-0 L-m-0 L-l-0 L-l-0 
job-4008,3,6,8,200285,200285,200309,0,24,200347,true,L-s-0 L-m-0 L-m-0 L-l-0 L-l-0 L-l-0 L-l-0 C-s-1 
job-4009,3,7,3,200332,200332,200388,0,56,200409,true,L-s-0 L-m-0 L-m-0 
job-4011,1,9,7,200442,200442,200478,0,36,200750,true,L-m-0 L-m-0 L-s-0 C-s-1 C-s-0 C-s-2 C-m-1 
job-4010,6,12,3,200389,200389,200480,0,91,200579,true,L-m-0 L-l-0 L-l-0 
job-4012,2,5,5,200488,200488,200552,0,64,200731,true,L-s-0 L-s-0 L-m-0 L-m-0 L-m-0 
job-4014,4,12,8,200586,200586,200659,0,73,200901,true,L-s-0 L-m-0 L-m-0 C-m-0 C-m-0 C-m-2 C-m-2 C-l-1 
job-4015,5,8,7,200645,200659,200674,14,15,200727,true,L-m-0 C-m-0 C-m-2 C-l-1 C-l-1 C-l-2 C-l-2 
job-4016,5,8,4,200690,200690,200701,0,11,200888,true,L-m-0 C-m-0 C-m-2 C-l-1 
job-4013,4,5,8,200538,200538,200735,0,197,200775,true,L-l-0 L-l-0 L-l-0 C-s-1 C-s-0 C-s-2 C-m-1 C-m-1 
job-4017,4,9,1,200733,200733,200826,0,93,200977,true,L-s-0 
job-4018,1,7,4,200787,200787,200871,0,84,201073,true,L-m-0 L-m-0 L-m-0 L-m-0 
job-4020,1,9,8,200873,200873,200892,0,19,200986,true,L-m-0 L-m-0 L-m-0 L-s-0 L-l-0 L-l-0 L-l-0 L-l-0 
job-4021,1,7,3,200921,200921,200952,0,31,201044,true,L-m-0 L-m-0 L-m-0 
job-4019,3,4,1,200831,200831,200956,0,125,201175,true,L-m-0 
job-4022,1,7,8,200973,200973,200985,0,12,201019,true,L-s-0 L-s-0 L-m-0 L-m-0 L-m-0 L-m-0 L-l-0 L-l-0 
job-4023,6,5,6,201027,201027,201138,0,111,201255,true,L-m-0 L-l-0 L-l-0 C-m-1 C-m-0 C-m-2 
job-4024,1,7,2,201069,201069,201138,0,69,201180,true,L-m-0 L-m-0 
job-4025,3,6,3,201120,201120,201166,0,46,201355,true,L-s-0 C-s-1 C-s-0 
job-4026,3,6,4,201164,201164,201221,0,57,201265,true,L-m-0 L-m-0 L-l-0 L-l-0 
job-4028,3,12,8,201273,201273,201293,0,20,201486,true,L-l-0 L-l-0 C-m-1 L-m-0 L-m-0 C-m-0 C-m-0 C-m-2 
job-4029,3,11,7,201328,201328,201422,0,94,201623,true,L-l-0 L-l-0 C-m-1 L-m-0 L-m-0 C-m-0 C-m-0 
job-4030,5,11,7,201372,201372,201459,0,87,201586,true,C-m-2 C-l-1 C-l-1 C-l-2 C-l-2 C-l-0 C-l-0 
job-4031,5,12,4,201404,201459,201506,55,47,201642,true,L-l-0 L-m-0 C-m-2 C-m-0 
job-4032,6,10,1,201449,201459,201561,10,102,201661,true,C-l-1 
job-4034,5,10,3,201561,201561,201591,0,30,201623,true,L-m-0 L-l-0 C-m-2 
job-4027,4,10,6,201210,201210,201597,0,387,201767,true,L-l-0 L-s-0 C-s-1 C-s-0 C-s-2 C-m-1 
job-4033,2,9,7,201501,201501,201663,0,162,201770,true,L-m-0 L-l-0 C-m-2 C-m-0 C-m-1 C-m-1 C-l-1 
job-4036,6,5,2,201657,201657,201783,0,126,201834,true,C-l-1 C-l-2 
job-4037,4,11,1,201709,201709,201832,0,123,202061,true,L-m-0 
job-4038,2,4,6,201764,201764,201877,0,113,201921,true,L-l-0 C-m-1 C-m-1 C-m-2 C-m-2 C-m-0 
job-4039,3,6,6,201814,201814,201968,0,154,202031,true,C-m-0 L-s-0 C-s-1 C-s-0 C-s-2 C-l-1 
job-4042,4,6,5,201971,201971,202004,0,33,202031,true,C-m-0 C-l-1 C-l-0 C-l-0 L-s-0 
job-4041,4,5,5,201922,201922,202028,0,106,202121,true,C-m-1 C-m-2 C-l-2 C-l-2 C-l-0 
job-4043,6,12,2,202027,202028,202138,1,110,202168,true,C-l-2 C-l-0 
job-4040,4,5,4,201876,201876,202139,0,263,202426,true,L-m-0 C-l-1 C-l-1 C-l-2 
job-4035,3,12,7,201600,201600,202238,0,638,202344,true,L-m-0 L-l-0 L-l-0 L-l-0 C-m-1 C-m-2 C-m-0 
job-4044,2,12,1,202081,202081,202299,0,218,202524,true,L-l-0 
job-4048,3,11,8,202295,202299,202397,4,98,202635,true,L-l-0 C-s-1 C-s-0 C-s-2 C-l-0 C-l-0 C-l-0 C-l-0 
job-4047,3,6,3,202228,202238,202421,10,183,202577,true,C-l-2 C-l-2 L-s-0 
job-4045,6,11,8,202126,202238,202566,112,328,202500,false,L-l-0 L-m-0 C-m-1 C-m-2 C-m-0 C-l-1 C-l-1 C-l-2 
job-4046,2,9,2,202178,202238,202620,60,382,202593,false,L-m-0 L-l-0 
job-4049,6,5,6,202359,202566,202694,207,128,202514,false,L-m-0 L-l-0 C-m-1 C-m-2 C-m-0 C-l-1 
job-4051,4,9,6,202450,202566,202717,116,151,202730,true,C-l-1 L-s-0 C-s-1 C-s-0 C-s-2 C-l-2 
job-4053,2,11,5,202538,202694,202744,156,50,202593,false,L-l-0 L-l-0 C-m-1 C-m-2 C-l-1 
job-4054,6,12,3,202584,202694,202786,110,92,202931,true,C-l-1 L-m-0 C-m-0 
job-4050,2,11,4,202403,202566,202799,163,233,202888,true,L-l-0 L-l-0 C-m-1 C-m-2 
job-4055,3,9,3,202630,202717,202832,87,115,202952,true,C-m-1 C-m-2 C-l-1 
job-4057,1,4,7,202724,202832,202909,108,77,203037,true,L-m-0 L-m-0 C-m-1 C-m-1 C-m-2 C-m-2 C-m-0 
job-4056,6,11,6,202676,202832,202979,156,147,202893,false,L-m-0 L-l-0 L-l-0 C-m-1 C-m-2 C-m-0 
job-4052,4,9,5,202498,202566,203029,68,463,203114,true,C-l-2 C-l-2 C-l-0 C-l-0 C-l-0 
job-4058,5,10,5,202768,202979,203047,211,68,202876,false,L-m-0 L-l-0 L-l-0 C-m-1 C-m-2 
job-4061,5,10,3,202880,203047,203067,167,20,203190,true,C-l-2 C-l-1 C-l-1 
job-4060,6,5,8,202849,203047,203072,198,25,203060,false,L-m-0 L-l-0 C-m-1 C-m-2 C-m-0 C-l-0 C-l-0 C-l-2 
job-4064,2,7,3,203041,203072,203106,31,34,203126,true,L-m-0 L-l-0 C-m-1 
job-4059,1,11,7,202807,202979,203120,172,141,203092,false,L-m-0 L-m-0 L-l-0 L-l-0 C-m-1 C-m-1 C-m-2 
job-4063,5,11,4,202984,203072,203144,88,72,203320,true,C-m-2 C-m-0 C-l-1 C-l-1 
job-4062,1,9,6,202940,203047,203214,107,167,203272,true,L-l-0 L-l-0 C-m-2 C-m-0 C-m-0 C-l-1 
job-4065,3,9,3,203098,203098,203260,0,162,203490,true,L-s-0 C-s-1 C-s-0 
job-4068,2,10,2,203260,203260,203274,0,14,203479,true,L-m-0 L-l-0 
job-4066,6,7,7,203153,203153,203337,0,184,203411,true,L-l-0 C-m-0 C-m-2 C-l-1 L-m-0 C-m-1 C-l-0 
job-4067,5,5,4,203196,203196,203362,0,166,203645,true,C-l-1 C-l-0 C-l-2 C-l-2 
job-4070,5,8,4,203349,203349,203398,0,49,203694,true,L-l-0 C-l-1 C-l-0 L-m-0 
job-4071,4,6,1,203395,203395,203431,0,36,203507,true,C-l-1 
job-4072,1,7,4,203454,203454,203525,0,71,203735,true,L-s-0 L-l-0 L-l-0 L-l-0 
job-4069,3,5,5,203302,203302,203544,0,242,203606,true,L-l-0 L-l-0 L-s-0 C-s-1 C-s-0 
job-4073,2,6,6,203516,203516,203563,0,47,203643,true,L-l-0 L-m-0 L-m-0 L-m-0 L-m-0 C-s-2 
job-4074,3,7,2,203566,203566,203596,0,30,203650,true,L-s-0 L-m-0 
job-4075,2,9,8,203615,203615,203769,0,154,203785,true,L-s-0 L-m-0 L-m-0 L-m-0 L-l-0 L-l-0 L-l-0 L-l-0 
job-4078,4,7,8,203768,203769,203790,1,21,203820,true,L-l-0 L-l-0 C-l-0 L-s-0 L-m-0 L-m-0 C-s-1 C-s-0 
job-4076,5,7,6,203669,203669,203811,0,142,204104,true,C-m-0 C-m-2 C-m-1 C-l-1 C-l-1 C-l-0 
job-4077,4,8,1,203719,203719,203860,0,141,203922,true,L-l-0 
job-4080,1,8,5,203864,203864,203895,0,31,203914,true,L-l-0 L-l-0 L-s-0 L-s-0 L-m-0 
job-4079,1,5,5,203826,203826,204004,0,178,204258,true,L-l-0 L-l-0 L-l-0 L-l-0 L-l-0 
job-4082,5,5,2,203976,203976,204010,0,34,204223,true,L-m-0 C-m-0 
job-4081,1,11,8,203920,203920,204036,0,116,204077,true,L-l-0 L-l-0 L-s-0 L-m-0 L-m-0 C-s-1 C-s-0 C-s-2 
job-4085,3,4,8,204115,204115,204217,0,102,204502,true,L-l-0 L-l-0 C-s-1 C-s-0 C-s-2 C-m-0 C-m-0 C-m-2 
job-4083,4,4,1,204015,204015,204228,0,213,204445,true,L-m-0 
job-4087,2,6,7,204223,204223,204236,0,13,204404,true,L-l-0 L-l-0 L-l-0 C-s-1 C-s-1 C-s-0 C-s-0 
job-4084,2,9,6,204066,204066,204321,0,255,204460,true,L-m-0 L-m-0 L-s-0 L-l-0 L-l-0 L-l-0 
job-4089,5,8,8,204331,204331,204477,0,146,204707,true,L-l-0 L-m-0 C-l-1 C-l-1 C-l-0 C-l-0 C-l-2 C-l-2 
job-4088,5,10,4,204274,204274,204511,0,237,204643,true,L-l-0 C-m-0 C-m-2 C-m-1 
job-4092,3,5,1,204502,204502,204533,0,31,204562,true,C-s-2 
job-4086,1,4,1,204167,204167,204545,0,378,204736,true,L-s-0 
job-4090,6,5,3,204396,204477,204559,81,82,204516,false,L-l-0 L-m-0 C-l-1 
job-4091,3,11,8,204453,204477,204587,24,110,204775,true,L-s-0 C-m-0 C-m-2 C-m-1 C-l-1 C-l-1 C-s-1 C-s-0 
job-4094,1,9,1,204606,204606,204629,0,23,204728,true,L-m-0 
job-4093,1,7,1,204557,204557,204701,0,144,204899,true,L-m-0 
job-4095,3,12,4,204662,204662,204949,0,287,205021,true,L-m-0 L-m-0 L-s-0 L-l-0 
job-4097,6,4,5,204765,204949,204982,184,33,204937,false,L-l-0 C-l-0 L-m-0 C-l-2 C-l-2 
job-4099,2,11,2,204853,204949,204986,96,37,205125,true,L-m-0 C-m-0 
job-4096,5,8,7,204714,204714,204994,0,280,205290,true,L-l-0 C-m-0 C-m-2 C-m-1 C-l-1 C-l-1 C-l-0 
job-4102,2,8,6,204992,204992,205022,0,30,205133,true,L-m-0 C-m-0 C-l-0 C-l-0 C-l-0 C-s-1 
job-4100,6,11,2,204895,204982,205037,87,55,205196,true,L-m-0 L-l-0 
job-4101,1,12,8,204940,204982,205097,42,115,205216,true,L-l-0 C-m-0 C-m-2 C-m-2 C-m-1 C-m-1 C-l-1 C-l-1 
job-4105,6,5,3,205134,205134,205173,0,39,205366,true,C-m-2 C-m-1 C-m-0 
job-4106,4,6,4,205176,205176,205211,0,35,205307,true,C-m-2 C-m-2 C-m-1 C-m-1 
job-4104,3,4,7,205097,205097,205225,0,128,205453,true,L-l-0 L-l-0 L-m-0 L-m-0 C-s-1 C-s-0 C-s-2 
job-4107,3,8,3,205232,205232,205251,0,19,205322,true,L-l-0 L-l-0 L-m-0 
job-4098,4,7,1,204816,204949,205302,133,353,205339,true,L-s-0 
job-4103,3,11,2,205047,205047,205324,0,277,205348,true,L-l-0 L-l-0 
job-4109,5,4,1,205340,205340,205386,0,46,205559,true,L-l-0 
job-4108,6,7,3,205291,205291,205391,0,100,205586,true,L-l-0 L-m-0 C-m-2 
job-4111,1,10,4,205438,205438,205477,0,39,205659,true,L-l-0 L-l-0 L-l-0 L-l-0 
job-4112,6,9,2,205478,205478,205576,0,98,205674,true,L-l-0 L-m-0 
job-4114,6,6,1,205589,205589,205615,0,26,205680,true,C-l-2 
job-4110,4,6,8,205388,205388,205625,0,237,205753,true,L-l-0 L-s-0 C-s-1 C-s-0 C-s-2 C-m-1 C-m-1 C-m-0 
job-4113,6,12,8,205539,205576,205739,37,163,205804,true,L-l-0 L-m-0 C-m-2 C-l-1 C-l-1 C-l-0 C-l-0 C-l-2 
job-4115,5,6,4,205640,205640,205754,0,114,205867,true,L-l-0 C-l-2 C-m-1 C-m-0 
job-4117,1,8,6,205751,205751,205773,0,22,205977,true,L-s-0 L-l-0 L-l-0 L-l-0 L-l-0 L-l-0 
job-4118,6,4,2,205799,205799,205822,0,23,205943,true,L-m-0 L-l-0 
job-4119,6,4,2,205843,205843,205906,0,63,206109,true,L-m-0 L-l-0 
job-4120,3,9,1,205884,205884,205913,0,29,206174,true,L-l-0 
job-4121,1,10,2,205931,205931,205996,0,65,206067,true,L-s-0 C-s-1 
job-4123,5,10,4,206034,206034,206064,0,30,206323,true,C-l-1 C-l-1 C-l-0 C-l-0 
job-4122,5,5,8,205979,205979,206070,0,91,206325,true,C-m-1 C-m-0 L-m-0 L-l-0 L-l-0 C-m-2 C-l-2 C-l-2 
job-4124,4,6,3,206089,206089,206107,0,18,206262,true,C-m-1 C-m-0 L-m-0 
job-4125,2,7,2,206138,206138,206153,0,15,206361,true,C-m-1 C-m-1 
job-4116,3,6,6,205698,205698,206226,0,528,206505,true,C-m-1 C-m-0 L-s-0 C-s-1 C-s-0 C-s-2 
job-4127,2,8,3,206237,206237,206254,0,17,206329,true,L-m-0 L-l-0 L-l-0 
job-4126,6,8,2,206189,206189,206311,0,122,206609,true,L-m-0 L-l-0 
job-4128,4,8,6,206283,206283,206394,0,111,206640,true,L-l-0 L-s-0 C-s-1 C-s-0 C-s-2 C-m-1 
job-4131,1,4,5,206424,206424,206485,0,61,206503,true,L-l-0 L-l-0 L-l-0 C-m-1 C-m-1 
job-4132,1,7,7,206472,206472,206526,0,54,206632,true,C-m-1 C-l-2 C-l-2 C-l-2 C-l-2 C-l-2 C-l-2 
job-4133,5,9,2,206515,206515,206570,0,55,206841,true,L-l-0 C-m-1 
job-4129,1,12,4,206335,206335,206597,0,262,206832,true,L-l-0 L-l-0 L-l-0 C-m-1 
job-4134,4,10,8,206563,206563,206613,0,50,206873,true,C-l-2 C-l-2 L-s-0 C-s-1 C-s-0 C-s-2 C-l-1 C-l-1 
job-4130,4,5,7,206384,206384,206654,0,270,206703,true,L-m-0 L-m-0 C-m-0 C-m-0 C-m-2 C-m-2 C-l-2 
job-4135,3,7,5,206623,206623,206658,0,35,206936,true,C-l-2 C-l-2 L-s-0 L-l-0 L-l-0 
job-4136,3,8,5,206678,206678,206735,0,57,206831,true,L-s-0 L-m-0 L-m-0 L-l-0 L-l-0 
job-4137,5,8,8,206737,206737,206757,0,20,207009,true,L-m-0 L-l-0 L-l-0 C-m-0 C-m-2 C-m-1 C-l-2 C-l-2 
job-4138,3,12,7,206781,206781,206805,0,24,207041,true,L-s-0 L-m-0 L-m-0 L-l-0 L-l-0 L-l-0 L-l-0 
job-4140,2,10,3,206876,206876,206919,0,43,207187,true,L-m-0 L-m-0 L-m-0 
job-4141,6,4,1,206922,206922,206932,0,10,207159,true,L-m-0 
job-4139,2,8,2,206837,206837,207032,0,195,207298,true,L-s-0 L-s-0 
job-4142,3,7,1,206976,206976,207041,0,65,207308,true,L-m-0 
job-4145,2,7,4,207117,207117,207155,0,38,207340,true,L-m-0 L-m-0 L-l-0 C-m-0 
job-4146,4,10,5,207171,207171,207222,0,51,207428,true,L-m-0 L-s-0 C-s-1 C-s-0 C-s-2 
job-4143,2,9,4,207022,207022,207304,0,282,207404,true,L-m-0 L-m-0 L-l-0 L-l-0 
job-4149,3,7,5,207313,207313,207328,0,15,207557,true,L-l-0 C-m-1 L-s-0 C-s-1 C-s-0 
job-4144,5,6,6,207074,207074,207399,0,325,207615,true,L-l-0 C-m-0 C-m-2 C-m-1 C-l-2 C-l-2 
job-4147,3,9,3,207212,207212,207423,0,211,207721,true,L-l-0 C-m-0 C-m-2 
job-4150,4,4,4,207359,207359,207440,0,81,207646,true,L-l-0 L-s-0 C-s-1 C-s-0 
job-4152,4,4,3,207436,207436,207473,0,37,207602,true,L-l-0 C-s-2 C-m-0 
job-4154,1,10,5,207531,207531,207556,0,25,207819,true,C-s-0 C-s-2 C-m-0 C-m-0 C-m-0 
job-4155,6,4,3,207583,207583,207615,0,32,207851,true,C-m-0 C-m-2 C-m-1 
job-4151,2,4,2,207401,207401,207647,0,246,207775,true,L-m-0 L-l-0 
job-4153,2,9,6,207491,207491,207680,0,189,207813,true,L-l-0 L-l-0 L-l-0 L-l-0 L-s-0 C-s-1 
job-4156,6,6,7,207640,207680,207703,40,23,207906,true,L-l-0 L-l-0 C-m-0 C-m-2 C-m-1 C-l-2 C-l-2 
job-4157,6,10,4,207693,207703,207831,10,128,207858,true,L-l-0 L-l-0 C-m-0 C-m-2 
job-4158,3,6,3,207748,207748,207915,0,167,208044,true,L-s-0 C-s-1 C-s-0 
job-4148,6,12,5,207264,207304,207958,40,654,208208,true,L-m-0 C-l-1 C-l-1 C-l-0 C-l-0 
job-4159,6,9,7,207794,207831,207972,37,141,208123,true,L-l-0 L-l-0 C-m-0 C-m-2 C-m-1 C-l-2 C-l-2 
job-4162,3,6,8,207954,207972,208009,18,37,208133,true,C-l-1 L-l-0 L-l-0 L-l-0 L-l-0 C-m-0 C-m-0 C-m-2 
job-4161,5,10,3,207912,207958,208075,46,117,208031,false,C-l-1 C-l-0 C-l-0 
job-4160,3,5,7,207848,207958,208129,110,171,208038,false,L-s-0 L-m-0 L-m-0 C-s-1 C-s-0 C-s-2 C-l-1 
job-4164,4,8,1,208058,208058,208172,0,114,208436,true,C-l-1 
job-4166,6,5,4,208170,208170,208194,0,24,208374,true,L-m-0 C-m-1 C-l-0 C-l-0 
job-4165,3,6,7,208109,208109,208210,0,101,208453,true,C-m-2 C-l-1 L-l-0 L-l-0 L-l-0 L-l-0 C-m-0 
job-4163,5,11,1,208007,208007,208235,0,228,208270,true,C-m-2 
job-4168,2,12,2,208258,208258,208279,0,21,208330,true,L-m-0 L-l-0 
job-4170,5,10,3,208360,208360,208373,0,13,208376,true,C-m-0 C-m-1 C-l-1 
job-4169,4,5,8,208310,208310,208393,0,83,208419,true,L-m-0 L-l-0 L-l-0 L-l-0 C-s-1 C-s-0 C-s-2 C-m-2 
job-4171,3,10,5,208408,208408,208451,0,43,208689,true,L-m-0 L-l-0 L-l-0 L-l-0 L-l-0 
job-4167,4,10,2,208212,208212,208499,0,287,208513,true,L-s-0 L-m-0 
job-4173,6,7,8,208520,208520,208595,0,75,208862,true,L-l-0 L-m-0 C-m-2 C-m-0 C-m-1 C-l-1 C-l-1 C-l-0 
job-4176,3,11,6,208674,208674,208688,0,14,208964,true,C-l-1 L-s-0 C-s-1 C-s-0 C-s-2 C-l-0 
job-4174,5,8,6,208574,208595,208717,21,122,208728,true,L-l-0 L-m-0 C-m-2 C-m-0 C-m-1 C-l-1 
job-4172,6,11,1,208461,208461,208748,0,287,208952,true,L-l-0 
job-4178,1,9,1,208773,208773,208787,0,14,208950,true,C-m-2 
job-4175,2,6,6,208618,208618,208802,0,184,208862,true,L-m-0 C-m-2 C-m-0 C-m-1 C-l-1 C-l-1 
job-4177,2,12,2,208720,208720,208809,0,89,208936,true,L-m-0 L-m-0 
job-4180,1,11,3,208860,208860,208883,0,23,209074,true,L-m-0 L-m-0 L-l-0 
job-4179,5,4,2,208817,208817,208921,0,104,209067,true,L-m-0 L-l-0 
job-4181,2,5,8,208914,208914,208924,0,10,209137,true,L-m-0 L-l-0 L-l-0 L-l-0 L-s-0 L-s-0 C-s-1 C-s-1 
job-4182,1,10,8,208963,208963,208998,0,35,209047,true,L-s-0 L-m-0 L-m-0 L-m-0 L-l-0 L-l-0 L-l-0 L-l-0 
job-4183,2,8,1,209013,209013,209069,0,56,209069,false,L-s-0 
job-4184,5,9,3,209064,209064,209126,0,62,209381,true,L-m-0 L-l-0 L-l-0 
job-4185,1,9,4,209118,209118,209128,0,10,209147,true,L-m-0 L-m-0 L-l-0 L-l-0 
job-4186,5,5,5,209181,209181,209244,0,63,209349,true,L-m-0 L-l-0 L-l-0 C-m-2 C-m-0 
job-4188,5,10,7,209289,209289,209321,0,32,209595,true,L-l-0 L-l-0 C-m-2 C-m-0 C-m-1 C-l-1 C-l-1 
job-4187,1,6,7,209244,209244,209331,0,87,209495,true,L-s-0 L-s-0 L-m-0 L-m-0 L-m-0 L-m-0 L-m-0 
job-4192,5,8,2,209493,209493,209504,0,11,209771,true,C-l-1 C-l-1 
job-4189,4,10,5,209333,209333,209511,0,178,209583,true,L-s-0 L-m-0 L-m-0 L-l-0 L-l-0 
job-4193,4,8,7,209553,209553,209573,0,20,209692,true,L-l-0 L-l-0 L-s-0 L-m-0 L-m-0 C-s-0 C-s-2 
job-4191,5,9,3,209442,209442,209577,0,135,209700,true,C-m-2 C-m-0 C-m-1 
job-4195,6,8,1,209664,209664,209691,0,27,209765,true,L-l-0 
job-4196,3,6,7,209709,209709,209755,0,46,209971,true,L-l-0 L-l-0 L-s-0 L-m-0 L-m-0 C-s-0 C-s-2 
job-4190,3,4,2,209391,209391,209793,0,402,210066,true,L-l-0 C-s-1 
job-4194,2,8,1,209607,209607,209832,0,225,210121,true,L-l-0 
job-4199,6,12,4,209843,209843,209909,0,66,210059,true,C-l-1 C-l-1 C-l-0 C-l-0 
job-4197,4,5,5,209750,209750,209923,0,173,210013,true,C-m-2 C-m-2 C-m-0 C-m-0 C-m-1 
job-4200,3,5,8,209884,209909,209924,25,15,209904,false,L-l-0 C-s-2 C-s-1 C-l-1 C-l-1 C-l-1 C-l-1 C-l-0 
job-4202,4,10,4,209992,209992,210003,0,11,210179,true,C-m-1 C-l-2 C-s-2 C-s-1 
job-4201,6,10,7,209938,209938,210022,0,84,210309,true,C-m-2 C-m-0 C-l-1 C-l-1 C-l-0 C-l-0 C-l-2 
job-4198,3,10,8,209796,209796,210113,0,317,210152,true,L-l-0 L-l-0 L-l-0 C-m-1 L-s-0 L-m-0 L-m-0 C-s-0 
job-4203,6,7,7,210030,210030,210147,0,117,210184,true,C-m-2 C-m-0 C-l-1 C-l-1 C-l-0 C-l-0 C-l-2 
job-4206,1,9,5,210163,210163,210181,0,18,210377,true,L-m-0 L-m-0 C-m-2 C-m-2 C-m-0 
job-4204,5,8,1,210077,210077,210271,0,194,210385,true,C-m-1 
job-4207,4,8,1,210205,210205,210302,0,97,210409,true,C-l-1 
job-4208,1,12,5,210258,210258,210325,0,67,210356,true,L-m-0 L-m-0 C-m-2 C-m-2 C-m-0 
job-4209,5,9,3,210311,210311,210404,0,93,210627,true,C-l-1 C-m-1 C-l-0 
job-4210,5,11,5,210366,210404,210433,38,29,210509,true,C-l-1 C-m-1 C-l-0 C-l-0 C-l-2 
job-4211,3,7,7,210416,210416,210487,0,71,210752,true,C-m-1 C-l-2 C-l-2 L-s-0 C-s-0 C-s-2 C-s-1 
job-4205,6,5,6,210107,210147,210552,40,405,210601,true,L-m-0 L-l-0 L-l-0 C-m-2 C-m-0 C-l-1 
job-4215,6,8,6,210631,210631,210647,0,16,210722,true,C-l-1 C-l-0 L-l-0 L-l-0 C-m-2 C-m-0 
job-4214,2,9,7,210570,210570,210654,0,84,210676,true,L-s-0 L-m-0 L-m-0 C-s-0 C-s-2 C-s-1 C-m-1 
job-4212,1,5,6,210465,210465,210672,0,207,210959,true,L-s-0 L-m-0 L-m-0 C-s-0 C-s-2 C-s-1 
job-4213,6,9,5,210519,210519,210706,0,187,210749,true,C-l-1 C-m-1 C-l-2 C-l-2 C-l-0 
job-4216,2,7,7,210692,210692,210723,0,31,210807,true,C-m-1 C-l-1 C-l-1 C-l-1 C-l-0 C-l-0 C-l-0 
job-4218,2,10,4,210823,210823,210866,0,43,211091,true,L-m-0 C-s-2 C-s-1 C-m-1 
job-4217,3,5,8,210759,210759,210873,0,114,211172,true,L-s-0 L-m-0 L-m-0 L-l-0 L-l-0 L-l-0 L-l-0 C-s-0 
job-4219,3,9,6,210887,210887,210903,0,16,210929,true,L-s-0 L-m-0 L-m-0 L-l-0 L-l-0 L-l-0 
job-4221,2,9,3,210966,210966,210994,0,28,211116,true,L-m-0 L-s-0 C-s-0 
job-4222,1,5,8,211026,211026,211071,0,45,211220,true,L-m-0 L-m-0 L-s-0 L-s-0 L-s-0 C-s-0 C-s-0 C-s-0 
job-4220,6,12,3,210920,210920,211121,0,201,211340,true,L-m-0 L-l-0 L-l-0 
job-4223,2,11,8,211069,211069,211140,0,71,211326,true,C-s-2 C-s-1 C-m-1 C-m-1 C-m-2 C-m-2 C-m-0 C-m-0 
job-4225,1,9,8,211157,211157,211223,0,66,211509,true,L-m-0 L-m-0 L-m-0 C-s-2 C-s-1 C-m-1 C-m-1 C-m-2 
job-4224,2,4,6,211110,211110,211227,0,117,211468,true,L-m-0 C-s-2 C-s-1 C-m-1 C-m-1 C-m-2 
job-4226,6,5,4,211215,211215,211380,0,165,211555,true,L-l-0 L-l-0 C-m-0 C-l-2 
job-4229,2,11,2,211355,211355,211386,0,31,211421,true,C-s-1 C-s-0 
job-4228,1,5,7,211312,211312,211438,0,126,211681,true,C-m-0 C-m-0 C-l-2 C-l-2 C-s-2 C-s-2 C-s-2 
job-4230,6,9,3,211411,211411,211439,0,28,211647,true,C-m-0 C-l-2 L-l-0 
job-4227,4,9,4,211267,211267,211528,0,261,211696,true,C-l-2 L-s-0 L-m-0 L-m-0 
job-4231,4,12,4,211454,211454,211569,0,115,211868,true,C-l-2 C-l-2 L-l-0 L-l-0 
job-4234,5,12,7,211598,211598,211693,0,95,211917,true,L-l-0 C-m-2 C-l-2 C-l-2 C-l-1 C-l-1 C-l-0 
job-4233,6,8,3,211551,211551,211718,0,167,212012,true,L-m-0 C-m-0 C-m-1 
job-4236,6,11,3,211706,211706,211723,0,17,211726,true,C-l-2 C-l-2 C-l-1 
job-4238,5,4,7,211811,211811,211830,0,19,212089,true,L-m-0 C-m-0 C-m-1 C-l-2 C-l-2 C-l-1 C-l-1 
job-4237,1,12,7,211764,211764,211843,0,79,212117,true,C-s-2 C-m-2 C-m-2 L-m-0 L-m-0 C-m-0 C-m-0 
job-4235,4,5,6,211643,211693,211858,50,165,211835,false,L-l-0 L-l-0 L-s-0 C-s-1 C-s-0 C-m-2 
job-4232,1,4,5,211492,211492,211906,0,414,212046,true,L-l-0 L-l-0 L-l-0 L-l-0 C-s-2 
job-4239,6,12,4,211855,211855,211959,0,104,211987,true,L-m-0 C-m-0 C-m-1 C-l-2 
job-4241,6,11,2,211932,211932,211978,0,46,212204,true,L-l-0 C-l-0 
job-4240,6,5,5,211893,211893,212112,0,219,212153,true,L-l-0 C-l-2 C-m-2 C-l-1 C-l-1 
job-4243,3,9,3,212046,212046,212178,0,132,212328,true,L-m-0 L-m-0 C-s-2 
job-4244,1,5,4,212096,212096,212324,0,228,212493,true,L-m-0 L-m-0 C-s-2 C-m-2 
job-4246,6,5,1,212201,212201,212371,0,170,212561,true,L-m-0 
job-4245,6,4,5,212142,212142,212423,0,281,212654,true,L-l-0 C-m-2 C-l-2 C-m-0 C-m-1 
job-4247,5,5,2,212246,212246,212496,0,250,212588,true,C-l-1 C-l-1 
job-4248,4,6,6,212298,212324,212552,26,228,212629,true,C-s-2 C-s-1 C-s-0 C-l-0 C-l-0 C-l-0 
job-4242,3,12,5,211986,211986,212597,0,611,212756,true,L-l-0 L-l-0 C-l-2 C-l-2 L-s-0 
job-4251,1,8,3,212465,212552,212628,87,76,212600,false,L-l-0 C-s-2 C-s-1 
job-4252,3,4,1,212511,212552,212635,41,83,212645,true,C-l-0 
job-4253,3,5,3,212560,212560,212640,0,80,212850,true,C-l-1 C-l-1 C-l-1 
job-4250,3,4,8,212396,212552,212644,156,92,212568,false,C-s-2 C-s-1 C-s-0 C-m-1 C-m-1 C-l-0 C-l-0 C-l-0 
job-4256,1,10,6,212715,212715,212776,0,61,212950,true,C-l-2 C-l-2 C-l-1 C-l-1 C-l-1 C-l-1 
job-4249,4,10,8,212348,212423,212790,75,367,212924,true,L-l-0 C-l-2 L-m-0 L-m-0 C-m-2 C-m-2 C-m-0 C-m-0 
job-4255,2,6,2,212673,212673,212826,0,153,213040,true,L-l-0 C-m-1 
job-4257,3,6,2,212768,212768,212859,0,91,212995,true,L-s-0 C-s-2 
job-4258,3,6,3,212822,212822,212876,0,54,212916,true,L-l-0 C-l-1 C-l-1 
job-4254,6,5,6,212622,212644,212878,22,234,212982,true,L-l-0 C-l-2 C-m-1 C-l-0 C-l-0 C-l-1 
job-4261,6,5,2,212973,212973,213041,0,68,213088,true,C-m-1 C-m-2 
job-4259,6,6,2,212876,212876,213058,0,182,213130,true,L-l-0 C-l-1 
job-4262,2,12,3,213019,213019,213070,0,51,213349,true,L-m-0 L-l-0 C-m-1 
job-4263,6,4,6,213078,213078,213200,0,122,213456,true,L-l-0 C-l-1 C-m-1 C-m-2 C-m-0 C-l-0 
job-4260,4,9,4,212928,212928,213261,0,333,213450,true,L-l-0 C-l-1 L-s-0 L-m-0 
job-4264,5,7,7,213123,213200,213305,77,105,213483,true,L-l-0 C-l-1 C-m-1 C-m-2 C-m-0 C-l-0 C-l-0 
job-4266,6,9,3,213237,213261,213307,24,46,213445,true,L-l-0 C-l-2 C-l-1 
job-4267,5,5,3,213293,213305,213369,12,64,213528,true,L-l-0 C-l-1 L-m-0 
job-4269,4,9,1,213381,213381,213446,0,65,213544,true,L-l-0 
job-4265,5,9,1,213182,213200,213499,18,299,213573,true,C-l-2 
job-4271,1,7,4,213489,213489,213499,0,10,213743,true,L-m-0 L-m-0 L-l-0 L-l-0 
job-4270,6,7,3,213430,213430,213548,0,118,213608,true,C-l-1 C-l-0 L-m-0 
job-4268,6,10,7,213335,213335,213548,0,213,213738,true,L-l-0 C-l-2 C-l-1 C-m-1 C-m-2 C-m-0 C-l-0 
job-4272,3,6,4,213534,213534,213564,0,30,213769,true,L-l-0 L-l-0 C-l-2 C-l-2 
job-4274,1,5,7,213622,213622,213637,0,15,213936,true,L-m-0 L-m-0 L-m-0 L-m-0 L-m-0 L-m-0 L-l-0 
job-4273,2,5,2,213586,213586,213668,0,82,213951,true,L-s-0 L-s-0 
job-4275,4,10,3,213672,213672,213705,0,33,213979,true,L-s-0 L-m-0 L-m-0 
job-4276,2,9,3,213722,213722,213797,0,75,213851,true,L-s-0 L-m-0 L-m-0 
job-4278,4,4,5,213810,213810,213830,0,20,213899,true,L-m-0 L-l-0 C-s-2 C-s-1 C-s-0 
job-4277,2,6,7,213762,213762,213845,0,83,214115,true,L-s-0 L-m-0 L-m-0 L-l-0 L-l-0 L-l-0 L-l-0 
job-4279,5,12,3,213866,213866,214013,0,147,214292,true,L-m-0 L-l-0 L-l-0 
job-4280,5,12,1,213911,213911,214022,0,111,214190,true,C-m-1 
job-4281,1,4,4,213971,213971,214029,0,58,214275,true,L-m-0 L-m-0 L-m-0 L-l-0 
job-4282,5,7,5,214025,214025,214085,0,60,214095,true,L-m-0 L-l-0 L-l-0 C-m-1 C-m-2 
job-4283,2,11,1,214066,214066,214138,0,72,214144,true,L-m-0 
job-4285,1,11,3,214175,214175,214273,0,98,214290,true,L-m-0 C-s-1 C-s-0 
job-4284,3,12,7,214128,214128,214322,0,194,214436,true,L-m-0 L-s-0 L-l-0 L-l-0 L-l-0 L-l-0 C-s-2 
job-4288,3,9,5,214336,214336,214387,0,51,214668,true,L-s-0 C-s-2 C-s-1 C-s-0 C-l-2 
job-4286,6,11,6,214224,214224,214393,0,169,214396,true,C-m-1 C-m-2 C-m-0 C-l-1 C-l-1 C-l-0 
job-4287,6,5,4,214282,214322,214432,40,110,214577,true,C-l-0 L-m-0 L-l-0 L-l-0 
job-4290,5,8,7,214432,214432,214478,0,46,214629,true,L-m-0 L-l-0 L-l-0 C-m-1 C-m-2 C-m-0 C-l-1 
job-4289,1,12,1,214384,214384,214584,0,200,214809,true,L-m-0 
job-4292,1,6,2,214545,214545,214729,0,184,214850,true,L-m-0 C-m-1 
job-4293,1,12,5,214600,214600,214732,0,132,215025,true,L-m-0 C-m-1 C-m-2 C-m-0 L-s-0 
job-4291,6,11,6,214494,214494,214788,0,294,214811,true,L-m-0 L-l-0 L-l-0 C-m-1 C-m-2 C-m-0 
job-4294,5,7,7,214646,214788,214824,142,36,214771,false,L-m-0 L-l-0 L-l-0 C-m-1 C-m-2 C-m-0 C-l-1 
job-4296,3,7,4,214740,214824,214835,84,11,214814,false,L-s-0 C-s-2 C-s-1 C-s-0 
job-4295,6,11,8,214688,214824,214912,136,88,214826,false,L-m-0 L-l-0 L-l-0 C-m-1 C-m-2 C-m-0 C-l-1 C-l-1 
job-4298,4,8,5,214827,214912,214926,85,14,214868,false,C-l-1 L-s-0 C-s-2 C-s-1 C-s-0 
job-4299,4,4,3,214875,214912,214934,37,22,214982,true,C-l-0 C-l-0 C-l-0 
job-4297,6,7,7,214784,214912,215095,128,183,215083,false,L-m-0 L-l-0 L-l-0 C-m-1 C-m-2 C-m-0 C-l-1 
job-4304,3,12,5,215112,215112,215126,0,14,215249,true,C-s-1 C-s-0 C-l-0 C-l-0 C-l-0 
job-4303,1,9,1,215062,215095,215140,33,45,215165,true,C-s-2 
job-4301,2,5,4,214973,215095,215183,122,88,215124,false,L-m-0 C-m-1 C-m-2 C-m-0 
job-4302,2,6,2,215011,215095,215228,84,133,215191,false,L-s-0 L-s-0 
job-4306,5,11,2,215202,215202,215281,0,79,215370,true,C-l-0 C-l-2 
job-4300,6,7,8,214923,215095,215306,172,211,215357,true,L-m-0 L-l-0 L-l-0 C-m-1 C-m-2 C-m-0 C-l-1 C-l-1 
job-4307,4,8,6,215240,215281,215410,41,129,215549,true,C-l-0 C-l-0 L-s-0 C-l-2 C-l-2 C-l-2 
job-4308,3,4,5,215274,215306,215434,32,128,215499,true,L-m-0 L-m-0 L-l-0 L-l-0 L-l-0 
job-4305,4,4,4,215155,215155,215537,0,382,215576,true,C-s-2 C-s-1 C-s-0 C-l-0 
job-4310,3,10,7,215366,215434,215550,68,116,215588,true,C-m-1 C-m-2 C-m-0 C-l-0 L-s-0 L-m-0 L-m-0 
job-4313,4,10,3,215524,215550,215570,26,20,215557,false,L-s-0 L-m-0 L-m-0 
job-4312,3,4,7,215461,215550,215587,89,37,215662,true,L-l-0 L-l-0 C-m-1 C-m-2 C-m-0 C-l-0 C-l-0 
job-4309,5,10,8,215324,215410,215673,86,263,215799,true,C-l-0 C-m-1 C-m-2 C-m-0 C-l-2 C-l-2 C-l-1 C-l-1 
job-4311,4,11,1,215410,215434,215714,24,280,215831,true,L-l-0 
job-4315,3,10,8,215621,215621,215714,0,93,215866,true,L-l-0 L-l-0 C-m-1 C-m-2 C-m-0 C-l-0 C-l-0 L-s-0 
job-4317,1,10,7,215725,215725,215803,0,78,215933,true,L-l-0 L-l-0 L-l-0 C-l-2 C-l-2 C-l-2 C-l-0 
job-4314,1,7,6,215578,215578,215824,0,246,216038,true,L-l-0 L-l-0 C-l-0 C-l-2 C-l-2 C-l-1 
job-4318,3,6,6,215770,215770,215828,0,58,215902,true,C-l-0 C-l-0 C-l-0 C-l-1 C-l-1 C-l-1 
job-4319,3,8,4,215814,215814,215832,0,18,216083,true,L-l-0 L-l-0 L-l-0 C-l-2 
job-4316,4,9,2,215664,215664,215985,0,321,216228,true,L-m-0 L-m-0 
job-4322,3,11,8,215969,215969,215987,0,18,216264,true,C-s-2 C-s-1 C-s-0 C-m-0 C-m-0 C-l-0 C-l-0 C-l-0 
job-4323,6,9,8,216011,216011,216170,0,159,216295,true,L-m-0 C-m-0 C-l-0 C-l-0 C-l-1 C-l-1 C-l-2 C-l-2 
job-4324,3,12,7,216064,216170,216239,106,69,216288,true,L-m-0 L-m-0 C-s-2 C-s-1 C-s-0 C-m-0 C-m-0 
job-4327,3,9,4,216190,216239,216252,49,13,216342,true,C-m-0 C-m-0 C-l-2 C-l-2 
job-4326,4,9,7,216148,216239,216266,91,27,216316,true,C-l-1 C-l-1 L-m-0 L-m-0 C-s-2 C-s-1 C-s-0 
job-4325,2,10,7,216110,216170,216280,60,110,216502,true,L-l-0 C-l-0 C-l-0 C-l-0 C-l-0 C-l-1 C-l-1 
job-4320,5,5,4,215871,215871,216287,0,416,216442,true,L-l-0 L-l-0 C-m-1 C-m-2 
job-4329,2,4,2,216279,216279,216293,0,14,216367,true,C-l-0 C-l-0 
job-4321,3,8,3,215919,215919,216348,0,429,216568,true,C-m-1 C-m-2 L-s-0 
job-4328,1,10,6,216229,216252,216390,23,138,216646,true,C-m-0 C-m-0 C-m-0 C-l-2 C-l-2 C-l-2 
job-4330,5,6,6,216332,216332,216496,0,164,216690,true,C-m-1 C-m-2 C-l-2 L-m-0 L-l-0 L-l-0 
job-4331,5,10,3,216378,216378,216515,0,137,216545,true,C-l-0 C-l-0 C-l-1 
job-4333,6,8,6,216482,216496,216538,14,42,216524,false,L-m-0 C-l-1 L-l-0 L-l-0 C-m-1 C-m-2 
job-4334,6,4,7,216538,216538,216555,0,17,216704,true,L-m-0 L-l-0 L-l-0 C-m-1 C-m-2 C-m-0 C-l-0 
job-4335,5,4,5,216582,216582,216651,0,69,216946,true,L-m-0 L-l-0 L-l-0 C-m-1 C-m-2 
job-4332,1,6,1,216440,216440,216785,0,345,216844,true,L-m-0 
job-4338,6,11,1,216745,216745,216882,0,137,217004,true,L-l-0 
job-4336,3,5,2,216642,216642,216888,0,246,217112,true,C-m-1 C-m-2 
job-4341,4,8,7,216901,216901,216934,0,33,217066,true,L-l-0 L-s-0 C-s-2 C-s-1 C-s-0 C-m-0 C-m-0 
job-4340,5,10,3,216856,216856,216977,0,121,217184,true,L-l-0 C-m-1 C-m-2 
job-4337,1,4,5,216694,216694,217030,0,336,217307,true,L-m-0 L-m-0 L-m-0 L-m-0 L-m-0 
job-4339,1,4,4,216814,216814,217033,0,219,217070,true,L-m-0 L-m-0 L-m-0 L-l-0 
job-4342,2,8,2,216959,216959,217072,0,113,217222,true,L-l-0 L-l-0 
job-4343,3,8,4,217011,217011,217154,0,143,217411,true,L-l-0 L-l-0 L-s-0 C-s-2 
job-4344,3,6,2,217065,217065,217235,0,170,217270,true,L-m-0 L-m-0 
job-4345,6,5,8,217116,217116,217378,0,262,217441,true,L-l-0 C-m-1 C-m-2 C-m-0 C-l-0 C-l-0 C-l-1 C-l-1 
job-4347,3,6,1,217219,217378,217406,159,28,217379,false,L-m-0 
job-4349,5,9,1,217312,217378,217455,66,77,217479,true,C-l-1 
job-4346,5,9,8,217164,217378,217467,214,89,217269,false,L-m-0 L-l-0 L-l-0 C-m-1 C-m-2 C-m-0 C-l-0 C-l-0 
job-4348,3,10,1,217261,217378,217473,117,95,217494,true,C-m-1 
job-4352,3,11,6,217467,217467,217498,0,31,217561,true,L-l-0 L-l-0 L-l-0 C-m-1 C-m-2 C-m-2 
job-4351,2,8,4,217402,217402,217519,0,117,217658,true,L-l-0 C-m-2 C-m-0 C-l-0 
job-4353,4,7,2,217510,217510,217524,0,14,217677,true,L-l-0 L-l-0 
job-4350,4,7,8,217364,217378,217548,14,170,217581,true,C-l-1 L-s-0 C-s-2 C-s-1 C-s-0 C-l-2 C-l-2 C-l-2 
job-4355,1,5,7,217604,217604,217623,0,19,217775,true,L-s-0 L-m-0 L-m-0 L-l-0 L-l-0 L-l-0 L-l-0 
job-4354,3,8,4,217561,217561,217647,0,86,217848,true,L-s-0 L-m-0 L-m-0 L-l-0 
job-4356,5,9,7,217656,217656,217675,0,19,217903,true,L-m-0 L-l-0 L-l-0 C-m-2 C-m-0 C-m-1 C-l-2 
job-4358,3,6,6,217766,217766,217792,0,26,217908,true,L-l-0 L-l-0 L-l-0 L-l-0 C-s-2 C-s-1 
job-4357,2,5,5,217711,217711,217877,0,166,218134,true,L-s-0 L-s-0 L-m-0 L-m-0 L-m-0 
job-4360,4,4,5,217862,217862,217892,0,30,218172,true,C-s-2 C-s-1 C-s-0 C-m-1 C-m-1 
job-4361,4,12,6,217914,217914,217982,0,68,218234,true,L-s-0 L-m-0 L-m-0 C-s-2 C-s-1 C-s-0 
job-4362,3,8,4,217976,217976,218030,0,54,218034,true,C-m-2 C-m-0 C-m-1 C-m-1 
job-4363,5,9,2,218027,218027,218087,0,60,218293,true,L-m-0 C-l-2 
job-4364,6,11,5,218084,218084,218097,0,13,218323,true,C-l-2 C-m-1 C-l-1 C-l-1 C-l-0 
job-4359,5,10,4,217812,217812,218188,0,376,218287,true,L-l-0 L-l-0 C-m-2 C-m-0 
job-4365,1,4,7,218135,218135,218203,0,68,218370,true,L-l-0 L-l-0 C-m-2 C-m-2 C-m-2 C-m-0 C-m-0 
job-4366,6,12,8,218191,218191,218270,0,79,218272,true,L-l-0 C-m-0 L-m-0 C-m-1 C-l-2 C-l-2 C-l-1 C-l-1 
job-4368,2,5,6,218278,218278,218329,0,51,218456,true,L-l-0 L-l-0 L-l-0 L-l-0 L-s-0 L-s-0 
job-4369,4,4,1,218344,218344,218421,0,77,218435,true,L-l-0 
job-4371,2,8,2,218443,218443,218470,0,27,218742,true,L-l-0 L-l-0 
job-4370,2,10,6,218395,218395,218483,0,88,218728,true,L-l-0 L-l-0 L-s-0 L-m-0 L-m-0 L-m-0 
job-4372,6,6,6,218488,218488,218531,0,43,218554,true,L-l-0 L-m-0 C-m-0 C-m-1 C-m-2 C-l-2 
job-4373,6,4,2,218526,218526,218618,0,92,218776,true,C-l-2 C-l-1 
job-4374,3,5,3,218580,218580,218690,0,110,218902,true,L-l-0 L-l-0 C-l-2 
job-4375,5,5,4,218637,218637,218724,0,87,218856,true,C-l-2 L-m-0 C-m-0 C-m-1 
job-4367,4,12,1,218244,218244,218724,0,480,218878,true,L-l-0 
job-4376,3,12,2,218692,218692,218725,0,33,218921,true,L-m-0 L-l-0 
job-4377,6,9,3,218733,218733,218812,0,79,218908,true,L-m-0 L-l-0 L-l-0 
job-4379,3,7,8,218835,218835,218903,0,68,219118,true,C-m-0 C-m-1 C-m-2 C-l-1 C-l-1 L-s-0 L-m-0 L-m-0 
job-4378,5,7,6,218788,218788,218913,0,125,218950,true,C-m-0 C-m-1 C-m-2 C-l-2 C-l-2 C-l-1 
job-4382,4,4,8,218979,218979,219019,0,40,219138,true,L-m-0 C-s-1 C-s-0 C-m-0 C-m-0 C-m-1 C-m-1 C-m-2 
job-4380,4,8,4,218885,218885,219044,0,159,219132,true,L-l-0 L-l-0 L-l-0 C-s-2 
job-4381,4,11,2,218937,218937,219145,0,208,219373,true,L-s-0 L-m-0 
job-4383,5,12,7,219019,219019,219191,0,172,219284,true,C-m-0 C-m-1 C-m-2 C-l-1 C-l-1 C-l-2 C-l-2 
job-4384,4,6,4,219076,219076,219197,0,121,219279,true,L-m-0 L-l-0 L-l-0 L-l-0 
job-4387,4,8,5,219206,219206,219232,0,26,219271,true,L-m-0 C-m-0 C-m-1 C-l-0 C-l-0 
job-4385,4,4,4,219118,219118,219251,0,133,219320,true,C-s-2 C-s-1 C-s-0 C-l-0 
job-4390,3,6,5,219347,219347,219364,0,17,219569,true,L-l-0 L-l-0 C-m-1 C-s-2 C-s-1 
job-4388,1,8,5,219239,219239,219371,0,132,219487,true,L-m-0 C-m-0 C-m-0 C-m-1 C-m-1 
job-4389,2,9,4,219295,219295,219378,0,83,219677,true,L-s-0 L-l-0 L-l-0 L-l-0 
job-4391,2,7,6,219399,219399,219476,0,77,219705,true,L-m-0 C-m-0 C-m-0 C-m-1 C-m-1 C-m-1 
job-4392,2,12,2,219458,219458,219573,0,115,219798,true,L-s-0 L-l-0 
job-4393,4,6,5,219500,219500,219609,0,109,219656,true,L-m-0 L-l-0 L-l-0 C-m-0 C-m-1 
job-4386,1,8,6,219156,219156,219617,0,461,219764,true,L-m-0 L-m-0 L-m-0 C-m-0 C-m-0 C-m-1 
job-4394,1,7,4,219549,219549,219672,0,123,219748,true,L-l-0 L-l-0 C-m-0 C-m-1 
job-4396,2,5,3,219663,219663,219726,0,63,219769,true,L-l-0 L-l-0 L-l-0 
job-4395,4,9,4,219604,219604,219732,0,128,219936,true,L-s-0 C-s-2 C-s-1 C-s-0 
job-4397,2,12,5,219711,219711,219756,0,45,219840,true,L-l-0 L-l-0 L-m-0 L-m-0 C-m-0 
job-4398,5,10,4,219756,219756,219821,0,65,219978,true,L-m-0 L-l-0 L-l-0 C-m-0 
job-4399,5,9,6,219807,219807,219893,0,86,219897,true,C-m-1 C-m-2 C-l-0 C-l-0 C-l-1 C-l-1 
job-4401,2,12,1,219894,219894,219910,0,16,220007,true,L-m-0 
job-4402,1,4,4,219947,219947,220030,0,83,220057,true,L-s-0 L-m-0 L-m-0 L-l-0 
job-4403,6,8,3,219994,219994,220087,0,93,220160,true,C-m-0 C-l-0 C-l-0 
job-4400,3,9,8,219853,219853,220300,0,447,220569,true,C-m-1 C-m-2 L-s-0 L-m-0 L-m-0 L-l-0 L-l-0 L-l-0 
job-4405,2,6,4,220092,220300,220364,208,64,220183,false,L-m-0 C-m-1 C-m-2 C-m-0 
job-4404,6,8,8,220038,220300,220402,262,102,220226,false,L-m-0 L-l-0 L-l-0 C-m-1 C-m-2 C-m-0 C-l-0 C-l-0 
job-4408,1,8,6,220236,220402,220418,166,16,220411,false,L-m-0 L-m-0 C-m-1 C-m-1 C-m-2 C-m-2 
job-4406,6,12,6,220141,220402,220484,261,82,220424,false,L-m-0 L-l-0 L-l-0 C-m-1 C-m-2 C-m-0 
job-4407,5,6,5,220191,220402,220485,211,83,220452,false,C-l-0 C-l-0 C-l-1 C-l-1 C-l-2 
job-4409,5,10,4,220293,220484,220588,191,104,220647,true,C-l-2 L-m-0 L-l-0 L-l-0 
job-4410,2,6,7,220346,220484,220613,138,129,220639,true,L-m-0 L-l-0 C-l-2 C-l-0 C-l-1 L-s-0 L-s-0 
job-4411,6,9,6,220408,220588,220617,180,29,220693,true,L-m-0 L-l-0 C-l-2 C-l-0 C-l-1 C-m-1 
job-4414,6,4,3,220554,220617,220689,63,72,220771,true,L-l-0 C-l-2 C-l-0 
job-4415,6,5,7,220595,220689,220711,94,22,220892,true,L-l-0 C-l-2 C-l-0 C-l-1 L-m-0 C-m-1 C-m-2 
job-4416,4,6,6,220645,220711,220725,66,14,220774,true,L-l-0 C-l-2 C-l-0 C-l-1 L-m-0 L-m-0 
job-4412,6,11,4,220445,220613,220756,168,143,220716,false,L-l-0 C-l-2 C-l-0 C-l-1 
job-4413,4,4,2,220503,220613,220784,110,171,220842,true,L-s-0 C-s-2 
job-4419,2,7,4,220786,220786,220841,0,55,220869,true,L-m-0 L-l-0 L-l-0 L-l-0 
job-4417,4,6,2,220681,220711,220869,30,158,220995,true,C-s-1 C-s-0 
job-4418,6,4,6,220729,220729,220960,0,231,221212,true,L-l-0 C-l-2 C-l-0 C-l-1 L-m-0 C-m-1 
job-4421,6,11,5,220891,220960,220978,69,18,221168,true,C-l-2 C-l-0 C-l-0 C-l-1 C-l-1 
job-4423,5,7,2,220997,220997,221027,0,30,221213,true,C-l-1 C-l-1 
job-4420,5,7,7,220836,220960,221035,124,75,221161,true,L-m-0 L-l-0 L-l-0 C-m-1 C-m-2 C-m-0 C-l-2 
job-4424,3,6,7,221050,221050,221071,0,21,221155,true,C-l-2 C-l-2 L-s-0 L-m-0 L-m-0 L-l-0 L-l-0 
job-4422,5,6,3,220943,220978,221079,35,101,221265,true,C-l-2 C-l-0 C-l-0 
job-4426,1,12,4,221157,221157,221210,0,53,221493,true,L-m-0 L-m-0 L-l-0 L-l-0 
job-4425,4,5,2,221099,221099,221242,0,143,221423,true,L-s-0 L-m-0 
job-4428,2,7,6,221229,221229,221301,0,72,221500,true,L-m-0 L-m-0 L-l-0 L-l-0 L-l-0 C-s-1 
job-4429,6,8,5,221268,221268,221333,0,65,221625,true,C-m-1 C-m-2 C-m-0 C-l-0 C-l-0 
job-4427,3,11,2,221189,221189,221419,0,230,221655,true,L-l-0 L-l-0 
job-4430,3,6,2,221316,221316,221441,0,125,221651,true,L-l-0 L-l-0 
job-4432,1,12,5,221433,221433,221489,0,56,221611,true,L-m-0 L-l-0 L-l-0 L-l-0 C-s-1 
job-4434,6,8,1,221545,221545,221594,0,49,221829,true,L-l-0 
job-4431,4,12,2,221370,221370,221613,0,243,221834,true,L-s-0 L-m-0 
job-4433,5,7,7,221488,221488,221626,0,138,221781,true,L-l-0 C-m-1 C-m-2 C-m-0 C-l-0 C-l-0 C-l-2 
job-4436,4,8,2,221648,221648,221685,0,37,221688,true,L-m-0 L-l-0 
job-4435,4,6,3,221601,221601,221693,0,92,221783,true,L-m-0 L-l-0 C-l-2 
job-4439,2,12,5,221791,221791,221861,0,70,221983,true,L-l-0 C-s-2 C-m-1 C-m-1 C-m-2 
job-4440,2,12,5,221845,221845,221863,0,18,221916,true,C-m-2 C-m-0 C-m-0 C-l-2 C-l-2 
job-4437,1,8,7,221694,221694,221882,0,188,221905,true,L-s-0 L-s-0 L-m-0 L-m-0 L-m-0 L-m-0 L-l-0 
job-4441,3,4,5,221883,221883,221958,0,75,222218,true,L-l-0 L-s-0 L-m-0 L-m-0 C-s-2 
job-4445,6,5,4,222084,222084,222099,0,15,222375,true,C-m-0 C-l-2 C-l-2 C-l-0 
job-4438,4,10,4,221737,221737,222108,0,371,222336,true,L-l-0 L-l-0 C-s-1 C-s-0 
job-4444,3,10,2,222038,222038,222186,0,148,222209,true,L-s-0 L-m-0 
job-4442,3,10,4,221937,221937,222191,0,254,222365,true,C-m-1 C-m-1 C-m-2 C-m-2 
job-4446,5,9,2,222131,222131,222292,0,161,222398,true,L-m-0 L-l-0 
job-4448,6,7,3,222245,222245,222312,0,67,222370,true,C-m-1 C-m-2 C-m-0 
job-4450,3,5,4,222349,222349,222406,0,57,222638,true,L-m-0 L-l-0 C-m-0 C-m-0 
job-4451,2,7,8,222389,222389,222416,0,27,222479,true,C-s-1 C-m-1 C-m-1 C-m-1 C-m-2 C-m-2 C-m-2 C-s-2 
job-4447,2,7,5,222182,222182,222438,0,256,222440,true,L-l-0 L-l-0 C-m-1 C-m-2 C-s-1 
job-4449,2,11,6,222296,222296,222470,0,174,222679,true,L-l-0 C-m-0 L-s-0 L-m-0 L-m-0 C-s-0 
job-4443,1,9,2,221992,221992,222529,0,537,222713,true,L-l-0 L-l-0 
job-4453,5,6,5,222498,222498,222584,0,86,222802,true,L-m-0 L-l-0 C-m-0 C-m-1 C-m-2 
job-4455,6,7,5,222587,222587,222656,0,69,222745,true,L-m-0 L-l-0 C-m-0 C-m-1 C-m-2 
job-4454,6,8,4,222545,222545,222680,0,135,222752,true,C-l-2 C-l-2 C-l-0 C-l-0 
job-4452,2,9,4,222440,222440,222755,0,315,222797,true,L-m-0 L-l-0 L-l-0 C-m-0 
job-4456,2,4,4,222636,222636,222776,0,140,222977,true,L-l-0 C-m-1 C-m-2 L-s-0 
job-4459,6,12,5,222782,222782,222847,0,65,222950,true,L-l-0 C-m-0 C-m-2 C-l-2 C-l-2 
job-4458,1,9,8,222735,222735,222906,0,171,223078,true,L-l-0 L-l-0 C-m-0 C-m-0 C-m-1 C-m-1 C-m-1 C-m-2 
job-4460,1,7,1,222851,222851,222976,0,125,223189,true,L-m-0 
job-4462,5,10,6,222954,222954,223059,0,105,223329,true,L-l-0 C-m-1 C-m-0 C-m-2 C-l-2 C-l-2 
job-4463,2,8,4,223007,223007,223075,0,68,223362,true,L-m-0 C-m-1 C-m-0 C-m-2 
job-4457,1,11,3,222685,222685,223171,0,486,223349,true,L-s-0 L-m-0 L-m-0 
job-4465,5,9,3,223113,223113,223186,0,73,223217,true,L-m-0 C-m-2 C-l-2 
job-4464,4,11,3,223063,223063,223245,0,182,223310,true,L-l-0 C-m-1 C-m-0 
job-4467,6,9,1,223234,223234,223293,0,59,223453,true,C-l-2 
job-4461,6,5,1,222893,222893,223312,0,419,223447,true,L-l-0 
job-4466,1,4,8,223172,223172,223338,0,166,223340,true,L-m-0 L-m-0 L-m-0 L-l-0 L-l-0 C-m-2 C-m-2 C-m-2 
job-4469,1,11,2,223321,223321,223363,0,42,223492,true,L-l-0 L-l-0 
job-4468,4,11,3,223268,223268,223372,0,104,223447,true,L-m-0 L-l-0 C-m-2 
job-4470,3,10,8,223389,223389,223429,0,40,223666,true,L-s-0 L-m-0 L-m-0 L-l-0 L-l-0 L-l-0 L-l-0 C-s-0 
job-4471,5,9,7,223440,223440,223501,0,61,223697,true,L-m-0 L-l-0 L-l-0 C-m-2 C-m-1 C-m-0 C-l-2 
job-4473,1,8,5,223536,223536,223560,0,24,223792,true,C-l-2 C-l-2 C-l-2 C-l-2 C-l-2 
job-4472,6,7,5,223482,223482,223566,0,84,223856,true,C-l-2 C-l-0 C-l-0 C-l-1 C-l-1 
job-4475,5,4,1,223643,223643,223662,0,19,223868,true,L-l-0 
job-4474,5,12,1,223596,223596,223701,0,105,224000,true,L-m-0 
job-4476,2,9,8,223692,223692,223884,0,192,224016,true,L-m-0 L-s-0 L-l-0 L-l-0 L-l-0 L-l-0 L-l-0 C-s-0 
job-4480,2,4,8,223888,223888,223944,0,56,224169,true,L-m-0 L-s-0 L-s-0 L-l-0 L-l-0 L-l-0 L-l-0 L-l-0 
job-4478,4,5,7,223793,223793,223945,0,152,224174,true,C-s-1 C-s-2 C-m-2 C-m-2 C-m-1 C-m-1 C-m-0 
job-4481,4,9,8,223942,223942,224050,0,108,224310,true,C-s-0 C-l-0 C-l-0 C-l-0 C-l-1 C-l-1 C-l-1 C-l-2 
job-4482,5,5,8,223991,224050,224096,59,46,224183,true,L-l-0 L-l-0 C-m-2 C-m-1 C-l-0 C-l-0 C-l-1 C-l-1 
job-4483,5,4,4,224046,224096,224149,50,53,224188,true,L-l-0 L-l-0 C-m-2 C-m-1 
job-4477,4,10,1,223742,223742,224150,0,408,224239,true,L-m-0 
job-4485,1,8,6,224144,224144,224178,0,34,224245,true,L-m-0 L-l-0 L-l-0 C-m-0 C-m-0 C-m-2 
job-4479,2,8,3,223844,223844,224193,0,349,224441,true,L-m-0 C-m-0 C-m-0 
job-4484,6,12,3,224095,224096,224299,1,203,224407,true,C-l-0 C-l-0 C-l-1 
job-4488,2,7,7,224302,224302,224324,0,22,224385,true,L-l-0 C-m-0 C-m-2 C-m-1 C-l-0 C-l-1 C-l-2 
job-4489,3,7,3,224360,224360,224382,0,22,224651,true,L-l-0 C-m-0 C-m-2 
job-4486,4,6,5,224202,224202,224496,0,294,224525,true,C-l-1 L-s-0 L-m-0 L-m-0 L-l-0 
job-4487,5,7,8,224245,224299,224507,54,208,224612,true,L-l-0 C-l-1 C-m-0 C-m-2 C-m-1 C-l-0 C-l-0 C-l-2 
job-4491,2,12,4,224453,224496,224531,43,35,224609,true,L-l-0 C-m-0 C-m-2 C-m-1 
job-4492,6,5,8,224496,224507,224570,11,63,224568,false,L-l-0 C-m-0 C-m-2 C-m-1 C-l-1 C-l-2 C-l-0 C-l-0 
job-4490,4,10,7,224412,224496,224588,84,92,224731,true,L-l-0 C-l-1 C-l-2 L-s-0 L-m-0 L-m-0 C-s-0 
job-4494,1,4,1,224596,224596,224607,0,11,224684,true,L-l-0 
job-4493,5,4,6,224541,224570,224682,29,112,224917,true,L-l-0 C-l-1 C-l-2 C-m-0 C-m-2 C-m-1 
job-4495,5,12,4,224642,224642,224694,0,52,224887,true,L-l-0 C-l-1 C-l-2 L-m-0 
job-4496,6,11,1,224699,224699,224863,0,164,224913,true,L-m-0 
job-4498,5,12,4,224795,224795,224904,0,109,225191,true,L-l-0 C-m-0 C-m-2 C-m-1 
job-4499,5,7,3,224846,224846,224939,0,93,225116,true,C-l-1 C-l-1 C-l-2 
job-4501,3,11,1,224930,224930,224942,0,12,225156,true,L-l-0 
job-4497,1,5,8,224736,224736,224946,0,210,225032,true,L-m-0 L-m-0 L-s-0 L-s-0 L-s-0 L-l-0 L-l-0 L-l-0 
job-4500,6,10,3,224882,224882,224984,0,102,225189,true,L-m-0 C-l-2 C-l-0 
job-4503,3,8,8,225020,225020,225039,0,19,225276,true,L-l-0 L-l-0 C-l-2 C-l-2 C-l-0 C-l-0 L-m-0 L-m-0 
job-4505,1,4,1,225110,225110,225207,0,97,225361,true,L-s-0 
job-4502,3,10,7,224980,224980,225216,0,236,225241,true,C-l-2 C-l-2 C-l-0 C-l-0 L-s-0 L-l-0 L-l-0 
job-4504,5,7,7,225067,225067,225269,0,202,225562,true,L-l-0 C-l-2 C-l-0 L-m-0 C-m-0 C-m-2 C-m-1 
job-4506,6,11,7,225149,225269,225313,120,44,225291,false,L-m-0 L-l-0 L-l-0 C-m-0 C-m-2 C-m-1 C-l-2 
job-4508,1,11,6,225245,225313,225341,68,28,225297,false,L-m-0 L-l-0 L-l-0 C-m-0 C-m-2 C-m-1 
job-4507,5,11,7,225193,225313,225359,120,46,225490,true,L-m-0 L-l-0 L-l-0 C-m-0 C-m-2 C-m-1 C-l-2 
job-4509,1,9,6,225301,225313,225366,12,53,225583,true,L-m-0 C-m-0 C-m-2 C-m-1 C-l-2 C-l-2 
job-4511,5,6,2,225399,225399,225441,0,42,225530,true,L-l-0 L-l-0 
job-4512,3,9,6,225456,225456,225466,0,10,225731,true,L-s-0 L-l-0 L-l-0 L-l-0 L-l-0 C-s-0 
job-4510,6,9,2,225359,225359,225487,0,128,225598,true,L-m-0 C-m-0 
job-4513,5,8,6,225510,225510,225553,0,43,225739,true,L-m-0 L-l-0 L-l-0 C-m-0 C-m-2 C-m-1 
job-4514,1,9,2,225550,225550,225566,0,16,225696,true,L-m-0 L-m-0 
job-4515,3,7,4,225600,225600,225635,0,35,225776,true,L-s-0 L-m-0 L-m-0 L-l-0 
job-4516,1,7,4,225644,225644,225661,0,17,225892,true,L-s-0 L-s-0 L-m-0 L-m-0 
job-4517,5,8,7,225702,225702,225762,0,60,225781,true,L-m-0 L-l-0 L-l-0 C-m-0 C-m-2 C-m-1 C-l-2 
job-4518,6,8,4,225747,225747,225786,0,39,226038,true,C-l-2 C-l-0 C-l-0 C-l-1 
job-4519,1,5,5,225809,225809,225819,0,10,225986,true,L-s-0 L-s-0 L-s-0 L-m-0 L-m-0 
job-4520,2,11,8,225860,225860,225871,0,11,226146,true,L-s-0 L-m-0 L-m-0 L-l-0 L-l-0 L-l-0 L-l-0 C-s-0 
job-4522,6,5,2,225957,225957,225989,0,32,226143,true,C-l-2 C-l-2 
job-4521,6,12,6,225905,225905,226030,0,125,226317,true,L-m-0 L-l-0 L-l-0 C-m-0 C-m-2 C-m-1 
job-4523,5,10,7,226018,226030,226082,12,52,226291,true,L-m-0 L-l-0 L-l-0 C-m-0 C-m-2 C-m-1 C-l-2 
job-4525,4,4,8,226096,226096,226145,0,49,226176,true,C-l-2 C-l-1 L-s-0 L-m-0 L-m-0 L-l-0 L-l-0 L-l-0 
job-4526,4,4,5,226140,226140,226162,0,22,226188,true,C-s-0 C-s-1 C-s-2 C-m-0 C-m-0 
job-4528,6,4,4,226252,226252,226319,0,67,226397,true,L-m-0 L-l-0 L-l-0 C-m-0 
job-4527,2,6,4,226194,226194,226338,0,144,226611,true,C-l-2 C-l-2 C-l-2 C-l-1 
job-4524,6,9,4,226060,226060,226361,0,301,226401,true,C-l-2 C-l-0 C-l-0 C-l-1 
job-4530,6,7,2,226347,226347,226363,0,16,226582,true,L-m-0 C-m-0 
job-4529,1,6,4,226301,226301,226501,0,200,226692,true,L-m-0 L-m-0 C-m-0 C-m-0 
job-4532,1,9,5,226438,226438,226503,0,65,226789,true,L-m-0 L-l-0 L-l-0 L-l-0 L-l-0 
job-4531,5,5,3,226388,226388,226541,0,153,226666,true,L-m-0 C-m-0 L-l-0 
job-4534,1,5,7,226533,226533,226678,0,145,226786,true,L-s-0 L-m-0 L-m-0 L-m-0 L-l-0 L-l-0 L-l-0 
job-4536,6,5,5,226624,226624,226706,0,82,226960,true,C-m-0 C-l-0 C-l-0 C-l-2 C-l-2 
job-4537,6,8,7,226698,226706,226754,8,48,226837,true,C-m-0 C-l-0 C-l-0 C-l-2 C-l-2 C-l-1 C-l-1 
job-4533,3,6,8,226490,226490,226760,0,270,226945,true,L-l-0 L-s-0 C-s-0 C-s-1 C-s-2 C-m-2 C-m-2 C-m-1 
job-4539,6,4,1,226784,226784,226818,0,34,226824,true,C-m-2 
job-4535,5,11,2,226577,226577,226825,0,248,227098,true,L-m-0 L-l-0 
job-4538,2,7,6,226741,226741,226870,0,129,226901,true,L-m-0 L-l-0 L-l-0 C-m-2 C-m-0 C-m-1 
job-4540,1,11,3,226842,226842,226871,0,29,227033,true,L-m-0 L-m-0 L-l-0 
job-4541,3,7,4,226898,226898,226958,0,60,227098,true,L-s-0 L-m-0 L-m-0 L-l-0 
job-4542,6,4,8,226952,226952,227071,0,119,227306,true,L-l-0 C-m-2 C-m-0 C-m-1 C-l-0 C-l-0 C-l-2 C-l-2 
job-4543,6,4,7,226996,227071,227096,75,25,227313,true,L-m-0 L-l-0 L-l-0 C-m-2 C-m-0 C-m-1 C-l-0 
job-4545,3,4,1,227088,227096,227109,8,13,227396,true,L-m-0 
job-4544,5,5,6,227051,227096,227238,45,142,227429,true,L-m-0 L-l-0 L-l-0 C-m-2 C-m-0 C-m-1 
job-4547,2,6,2,227198,227198,227305,0,107,227601,true,C-m-1 L-s-0 
job-4549,4,8,7,227298,227298,227312,0,14,227450,true,L-l-0 L-l-0 C-m-2 C-m-0 C-m-1 C-s-0 C-s-1 
job-4550,6,7,8,227354,227354,227391,0,37,227497,true,L-l-0 C-m-2 C-m-0 C-m-1 C-l-0 C-l-0 C-l-2 C-l-2 
job-4548,6,6,1,227246,227246,227398,0,152,227681,true,L-m-0 
job-4546,2,9,4,227144,227144,227436,0,292,227450,true,L-m-0 L-l-0 C-m-2 C-m-0 
job-4551,5,7,1,227404,227404,227477,0,73,227503,true,L-m-0 
job-4552,3,7,1,227455,227455,227565,0,110,227797,true,L-m-0 
job-4554,6,12,4,227553,227553,227604,0,51,227686,true,C-m-2 C-m-0 C-m-1 C-l-0 
job-4555,6,6,1,227608,227608,227640,0,32,227891,true,C-m-2 
job-4556,4,11,4,227649,227649,227710,0,61,227712,true,L-m-0 C-s-2 C-m-2 C-m-2 
job-4553,3,9,8,227504,227504,227754,0,250,227913,true,L-m-0 L-s-0 L-l-0 L-l-0 L-l-0 L-l-0 C-s-0 C-s-1 
job-4557,2,9,3,227705,227705,227779,0,74,228008,true,C-m-0 C-m-0 C-m-0 
job-4558,6,6,5,227741,227741,227806,0,65,227939,true,C-m-2 C-m-1 C-l-0 C-l-0 C-l-2 
job-4559,3,5,8,227792,227792,227945,0,153,228048,true,C-l-2 C-l-2 L-s-0 L-m-0 L-m-0 L-l-0 L-l-0 L-l-0 
job-4560,3,9,8,227853,227853,227987,0,134,228255,true,L-l-0 C-l-2 C-l-2 C-s-0 C-s-1 C-s-2 C-m-2 C-m-2 
job-4563,5,4,1,227989,227989,228005,0,16,228072,true,L-l-0 
job-4561,1,5,6,227898,227898,228029,0,131,228060,true,L-s-0 L-m-0 L-m-0 C-s-0 C-s-1 C-s-2 
job-4564,6,8,4,228037,228037,228075,0,38,228228,true,L-l-0 C-l-2 C-m-2 C-m-1 
job-4566,2,5,2,228148,228148,228268,0,120,228405,true,L-m-0 L-l-0 
job-4567,3,11,4,228198,228198,228306,0,108,228333,true,C-l-2 C-s-1 C-s-2 C-m-2 
job-4568,1,10,5,228247,228247,228311,0,64,228433,true,L-m-0 L-l-0 C-m-2 C-m-2 C-m-1 
job-4565,4,5,4,228091,228091,228473,0,382,228503,true,L-l-0 C-l-2 L-s-0 C-s-0 
job-4569,4,4,7,228293,228293,228491,0,198,228609,true,C-m-1 C-m-0 C-m-0 C-l-0 C-l-0 C-l-0 C-l-1 
job-4570,2,10,7,228350,228350,228550,0,200,228777,true,L-m-0 L-l-0 C-m-1 C-m-1 C-l-2 C-l-1 C-l-1 
job-4572,2,7,7,228436,228473,228565,37,92,228787,true,C-m-2 C-l-1 C-l-1 L-s-0 L-s-0 C-s-0 C-s-0 
job-4571,5,7,3,228386,228473,228572,87,99,228709,true,L-l-0 C-l-2 C-m-2 
job-4573,1,10,2,228496,228496,228583,0,87,228864,true,L-m-0 C-m-2 
job-4574,3,11,4,228556,228556,228593,0,37,228839,true,C-l-1 C-l-1 C-s-1 C-s-2 
job-4575,4,7,8,228601,228601,228627,0,26,228748,true,L-l-0 C-l-2 L-s-0 C-s-0 C-s-1 C-s-2 C-m-2 C-m-2 
job-4562,5,8,3,227946,227946,228714,0,768,228803,true,L-m-0 L-l-0 C-l-2 
job-4578,5,9,1,228744,228744,228811,0,67,228890,true,L-l-0 
job-4576,1,12,3,228647,228647,228829,0,182,228899,true,L-m-0 L-m-0 L-l-0 
job-4577,4,4,2,228698,228698,228992,0,294,229066,true,L-l-0 C-l-2 
job-4579,5,12,8,228795,228795,229078,0,283,229188,true,C-l-2 C-m-2 C-m-1 C-m-0 C-l-1 C-l-1 C-l-0 C-l-0 
job-4582,1,9,8,228927,229078,229108,151,30,228987,false,C-m-2 C-m-2 C-m-1 C-m-1 C-m-0 C-m-0 L-s-0 C-s-0 
job-4584,2,7,4,229008,229078,229119,70,41,229132,true,L-s-0 C-s-0 C-l-0 C-l-0 
job-4581,1,10,2,228879,229078,229129,199,51,229176,true,L-m-0 L-m-0 
job-4580,6,7,8,228834,229078,229145,244,67,229198,true,L-m-0 L-l-0 L-l-0 C-m-2 C-m-1 C-m-0 C-l-1 C-l-1 
job-4586,2,10,7,229096,229145,229160,49,15,229312,true,L-m-0 L-l-0 C-m-2 C-l-0 C-l-0 L-s-0 C-s-0 
job-4583,4,4,4,228960,229078,229178,118,100,229251,true,C-s-1 C-s-2 C-l-0 C-l-0 
job-4585,5,4,4,229049,229145,229184,96,39,229089,false,L-m-0 L-l-0 L-l-0 C-m-2 
job-4588,2,8,7,229214,229214,229245,0,31,229351,true,C-m-1 C-m-0 C-l-1 C-l-1 C-l-1 L-s-0 L-s-0 
job-4589,2,12,3,229251,229251,229381,0,130,229626,true,C-m-1 C-m-0 C-l-1 
job-4587,5,11,3,229158,229158,229412,0,254,229428,true,C-m-1 C-m-0 C-l-1 
job-4590,6,10,1,229305,229305,229515,0,210,229726,true,L-m-0 
job-4593,6,8,3,229463,229463,229524,0,61,229709,true,C-m-1 C-m-0 C-m-2 
job-4591,3,4,4,229369,229369,229599,0,230,229651,true,C-l-1 L-s-0 L-l-0 L-l-0 
job-4594,5,11,7,229506,229524,229602,18,78,229626,true,L-m-0 C-m-1 C-m-0 C-m-2 C-l-0 C-l-0 C-l-2 
job-4596,2,5,8,229604,229604,229639,0,35,229858,true,C-m-1 C-m-0 C-m-2 L-s-0 L-s-0 C-s-2 C-s-2 C-s-0 
job-4595,6,8,6,229555,229602,229663,47,61,229620,false,L-m-0 L-l-0 C-l-1 C-m-1 C-m-0 C-m-2 
job-4592,2,12,8,229413,229413,229676,0,263,229749,true,L-m-0 L-l-0 L-l-0 L-l-0 C-l-1 C-l-1 C-l-1 C-s-1 
job-4597,1,8,5,229652,229652,229753,0,101,229923,true,C-m-1 C-m-1 C-m-0 C-m-0 C-m-2 
job-4598,1,12,6,229697,229697,229782,0,85,229967,true,C-m-1 C-m-0 C-m-2 C-m-2 L-s-0 L-m-0 
job-4599,3,6,5,229753,229753,229943,0,190,230102,true,L-m-0 L-m-0 C-m-2 C-m-1 C-m-1 
job-4601,2,8,8,229853,229853,229971,0,118,230151,true,L-l-0 L-l-0 L-l-0 L-l-0 C-s-1 C-s-1 C-s-2 C-s-2 
job-4602,3,4,1,229901,229901,229980,0,79,230078,true,C-s-0 
job-4603,2,9,5,229945,229945,229984,0,39,230096,true,L-m-0 L-m-0 C-m-2 C-m-1 C-m-1 
job-4600,2,8,8,229793,229793,230014,0,221,230067,true,L-m-0 C-m-1 C-m-2 C-m-2 L-s-0 L-s-0 L-l-0 L-l-0 
job-4604,3,6,6,230005,230005,230186,0,181,230289,true,L-m-0 L-m-0 L-l-0 L-l-0 C-m-2 C-m-1 
job-4607,6,10,6,230153,230153,230189,0,36,230359,true,C-m-0 C-l-1 C-l-1 C-l-0 C-l-0 C-l-2 
job-4606,2,7,7,230103,230103,230220,0,117,230283,true,C-m-2 C-m-2 C-m-1 C-m-1 L-s-0 L-s-0 C-s-1 
job-4608,2,4,6,230196,230196,230239,0,43,230289,true,L-m-0 L-m-0 L-m-0 L-l-0 L-l-0 L-l-0 
job-4610,1,9,3,230286,230286,230297,0,11,230392,true,C-m-2 C-m-2 L-s-0 
job-4605,1,9,7,230056,230056,230360,0,304,230585,true,L-m-0 L-m-0 L-l-0 L-l-0 L-l-0 L-l-0 C-m-2 
job-4611,2,10,8,230347,230347,230360,0,13,230634,true,C-m-2 C-m-2 L-s-0 C-s-1 C-s-2 C-s-0 C-m-1 C-m-1 
job-4609,1,4,5,230243,230243,230361,0,118,230496,true,L-m-0 L-m-0 L-m-0 L-l-0 L-l-0 
job-4612,2,7,7,230389,230389,230418,0,29,230560,true,L-s-0 L-s-0 L-m-0 L-m-0 L-m-0 L-m-0 L-l-0 
job-4613,5,5,7,230442,230442,230461,0,19,230627,true,L-m-0 L-l-0 L-l-0 C-m-2 C-m-1 C-m-0 C-l-1 
job-4614,6,9,3,230490,230490,230617,0,127,230730,true,L-m-0 L-l-0 L-l-0 
job-4617,5,10,7,230641,230641,230763,0,122,230881,true,L-m-0 L-l-0 L-l-0 C-l-0 C-l-0 C-l-2 C-l-2 
job-4615,4,8,5,230546,230546,230798,0,252,231001,true,L-s-0 C-s-1 C-s-2 C-s-0 C-m-2 
job-4620,2,4,7,230793,230798,230874,5,76,231070,true,L-l-0 C-l-0 C-l-2 C-s-2 C-s-2 C-s-0 C-s-0 
job-4616,4,10,8,230591,230591,230899,0,308,231104,true,C-m-2 C-m-1 C-m-1 C-m-0 C-m-0 C-l-1 C-l-1 C-l-1 
job-4619,3,7,4,230729,230798,230935,69,137,230938,true,L-m-0 C-m-2 L-s-0 C-s-1 
job-4621,3,11,4,230853,230899,230958,46,59,231012,true,C-m-2 C-s-2 C-s-0 C-m-1 
job-4618,5,12,7,230685,230763,230964,78,201,230957,false,L-m-0 L-l-0 L-l-0 C-l-0 C-l-0 C-l-2 C-l-2 
job-4622,6,9,8,230890,230964,230985,74,21,230995,true,L-m-0 L-l-0 L-l-0 C-m-2 C-m-1 C-m-0 C-l-0 C-l-0 
job-4623,2,6,1,230928,230964,231017,36,53,231048,true,L-m-0 
job-4625,1,5,5,231031,231031,231059,0,28,231140,true,L-s-0 C-s-2 C-s-0 C-s-1 C-l-2 
job-4624,3,8,7,230977,230977,231103,0,126,231108,true,L-s-0 C-s-2 C-s-0 C-s-1 C-l-2 C-l-2 C-l-2 
job-4626,3,11,4,231080,231080,231143,0,63,231433,true,C-l-2 L-m-0 L-m-0 L-l-0 
job-4627,1,11,4,231130,231130,231211,0,81,231422,true,L-l-0 L-l-0 L-l-0 C-l-2 
job-4629,5,7,3,231212,231212,231228,0,16,231265,true,L-l-0 C-l-2 C-m-0 
job-4628,6,10,5,231172,231172,231285,0,113,231316,true,L-l-0 C-l-2 L-m-0 C-m-2 C-m-1 
job-4631,2,4,8,231312,231312,231355,0,43,231417,true,L-l-0 L-l-0 L-l-0 C-l-2 C-l-2 C-l-2 L-m-0 L-m-0 
job-4630,3,6,5,231258,231258,231359,0,101,231406,true,L-l-0 L-l-0 C-l-2 C-l-2 L-s-0 
job-4634,4,10,8,231464,231464,231477,0,13,231595,true,C-m-0 C-l-2 C-l-2 C-l-2 C-l-0 C-l-0 C-l-0 C-l-1 
job-4632,4,5,7,231367,231367,231488,0,121,231786,true,L-s-0 L-m-0 L-m-0 L-l-0 L-l-0 L-l-0 C-s-2 
job-4636,6,9,1,231568,231568,231658,0,90,231691,true,L-m-0 
job-4637,2,7,6,231614,231614,231669,0,55,231720,true,L-s-0 L-m-0 C-m-0 L-l-0 L-l-0 L-l-0 
job-4633,4,7,7,231417,231417,231725,0,308,231853,true,C-s-0 C-s-1 C-m-2 C-m-2 C-m-1 C-m-1 C-m-0 
job-4638,6,5,4,231644,231644,231759,0,115,231818,true,L-l-0 C-l-2 C-l-2 C-l-0 
job-4635,1,9,3,231528,231528,231770,0,242,231845,true,C-m-0 C-m-0 L-s-0 
job-4640,1,11,4,231741,231741,231824,0,83,232045,true,L-l-0 L-l-0 C-m-0 C-l-0 
job-4641,6,11,2,231789,231789,231865,0,76,231928,true,C-m-0 C-l-0 
job-4642,6,5,6,231836,231836,231914,0,78,232044,true,L-l-0 C-l-0 L-m-0 C-m-2 C-m-1 C-l-2 
job-4644,2,11,6,231929,231929,232057,0,128,232291,true,L-l-0 C-l-0 C-l-0 C-l-0 C-l-2 C-l-2 
job-4645,5,8,6,231974,231974,232073,0,99,232084,true,L-l-0 L-m-0 C-m-2 C-m-1 C-m-0 C-l-1 
job-4643,3,7,6,231887,231887,232078,0,191,232126,true,L-l-0 C-l-0 C-l-0 C-l-2 C-l-2 L-s-0 
job-4639,1,10,2,231694,231694,232080,0,386,232296,true,L-l-0 L-l-0 
job-4647,2,8,1,232068,232073,232101,5,28,232125,true,L-m-0 
job-4646,6,11,6,232022,232073,232161,51,88,232117,false,L-l-0 C-l-0 C-l-2 L-m-0 C-m-2 C-m-1 
job-4648,4,9,1,232115,232115,232199,0,84,232320,true,L-l-0 
job-4651,5,11,1,232277,232277,232305,0,28,232531,true,C-m-2 
job-4650,3,8,8,232230,232230,232323,0,93,232374,true,L-l-0 L-s-0 L-m-0 L-m-0 C-s-0 C-s-1 C-s-2 C-m-2 
job-4653,4,12,6,232370,232370,232380,0,10,232578,true,L-l-0 L-s-0 L-m-0 L-m-0 C-s-0 C-s-1 
job-4652,5,12,2,232320,232320,232424,0,104,232566,true,C-m-2 C-m-1 
job-4654,4,8,2,232420,232420,232431,0,11,232494,true,L-l-0 L-s-0 
job-4649,2,5,4,232167,232167,232471,0,304,232769,true,L-l-0 L-l-0 L-l-0 L-l-0 
job-4656,4,12,8,232525,232525,232550,0,25,232705,true,L-l-0 C-s-0 C-s-1 C-s-2 C-m-2 C-m-2 C-m-1 C-m-1 
job-4657,1,10,1,232574,232574,232607,0,33,232704,true,L-m-0 
job-4658,3,6,7,232623,232623,232686,0,63,232813,true,L-l-0 L-l-0 C-s-0 C-s-1 C-s-2 C-m-2 C-m-2 
job-4655,3,8,5,232477,232477,232741,0,264,232874,true,L-s-0 L-m-0 L-m-0 L-l-0 L-l-0 
job-4660,1,9,5,232729,232729,232759,0,30,232865,true,L-m-0 L-l-0 L-l-0 C-m-2 C-m-2 
job-4659,4,10,4,232691,232691,232832,0,141,233121,true,L-l-0 C-s-0 C-s-1 C-s-2 
job-4661,1,8,6,232784,232784,232883,0,99,233069,true,L-l-0 L-l-0 L-l-0 L-l-0 L-s-0 L-s-0 
job-4664,1,5,4,232936,232936,232969,0,33,232983,true,L-m-0 L-m-0 L-l-0 C-s-0 
job-4666,2,9,8,233033,233033,233048,0,15,233346,true,L-m-0 C-m-2 C-m-0 C-l-0 C-l-0 C-l-0 C-l-0 C-l-2 
job-4665,3,10,4,232990,232990,233084,0,94,233303,true,C-m-1 C-m-0 C-m-0 C-l-0 
job-4668,6,10,2,233132,233132,233168,0,36,233217,true,C-l-0 C-m-0 
job-4663,4,8,4,232887,232887,233178,0,291,233334,true,L-l-0 L-l-0 L-s-0 C-m-1 
job-4669,2,7,6,233170,233170,233204,0,34,233252,true,L-m-0 C-m-2 C-m-1 C-m-1 C-l-0 C-l-0 
job-4667,3,10,1,233078,233078,233207,0,129,233275,true,C-l-0 
job-4670,4,12,5,233213,233213,233234,0,21,233359,true,L-l-0 L-l-0 L-s-0 C-m-1 C-m-1 
job-4671,2,11,8,233263,233263,233333,0,70,233450,true,L-l-0 L-l-0 L-l-0 L-s-0 C-m-1 C-m-1 C-m-0 C-m-0 
job-4673,6,4,5,233367,233367,233463,0,96,233469,true,L-l-0 C-m-1 C-m-0 C-l-0 C-l-0 
job-4672,2,9,4,233321,233321,233510,0,189,233680,true,L-m-0 C-m-2 C-m-1 C-m-0 
job-4662,3,11,8,232845,232845,233514,0,669,233690,true,L-l-0 L-m-0 L-m-0 C-s-0 C-s-1 C-s-2 C-m-2 C-m-2 
job-4676,1,10,6,233496,233496,233517,0,21,233624,true,L-l-0 C-m-1 C-m-1 C-m-0 C-m-0 C-l-0 
job-4674,4,5,2,233405,233405,233629,0,224,233808,true,L-s-0 C-l-2 
job-4677,1,9,8,233542,233542,233637,0,95,233925,true,L-l-0 L-l-0 L-m-0 L-m-0 L-m-0 C-s-0 C-s-1 C-s-2 
job-4678,6,9,3,233591,233591,233680,0,89,233930,true,C-m-2 C-m-1 C-m-0 
job-4675,1,8,8,233452,233452,233691,0,239,233808,true,L-l-0 L-l-0 L-l-0 C-l-2 C-l-2 C-l-2 C-l-2 C-l-2 
job-4679,2,12,7,233641,233641,233785,0,144,233799,true,L-l-0 L-l-0 C-m-2 C-m-1 C-m-0 L-s-0 L-m-0 
job-4680,2,10,4,233695,233695,233825,0,130,233901,true,L-m-0 L-m-0 L-l-0 L-l-0 
job-4682,5,9,3,233791,233791,233868,0,77,233978,true,L-l-0 C-m-2 C-m-1 
job-4683,2,6,7,233844,233844,233943,0,99,234017,true,L-l-0 L-l-0 L-l-0 C-m-1 L-s-0 L-s-0 L-m-0 
job-4685,4,10,1,233953,233953,234006,0,53,234120,true,L-l-0 
job-4684,6,10,6,233902,233902,234043,0,141,234300,true,L-m-0 L-l-0 C-m-0 C-l-2 C-l-2 C-l-0 
job-4686,3,12,3,234007,234007,234046,0,39,234154,true,L-l-0 L-l-0 C-m-2 
job-4681,1,6,4,233748,233748,234169,0,421,234269,true,C-m-2 C-m-2 C-m-2 C-m-1 
job-4688,2,5,2,234115,234115,234170,0,55,234229,true,C-m-1 L-s-0 
job-4689,3,7,7,234161,234161,234191,0,30,234429,true,L-m-0 L-m-0 L-l-0 L-l-0 L-l-0 L-l-0 C-s-0 
job-4690,6,12,7,234217,234217,234276,0,59,234436,true,L-m-0 L-l-0 L-l-0 C-m-0 C-l-2 C-l-2 C-l-0 
job-4691,4,5,1,234271,234271,234312,0,41,234413,true,C-m-2 
job-4687,4,9,2,234060,234060,234417,0,357,234466,true,C-m-2 C-m-1 
job-4694,3,11,1,234414,234414,234441,0,27,234484,true,L-m-0 
job-4693,4,11,8,234362,234362,234444,0,82,234629,true,C-m-2 C-m-1 L-s-0 C-s-0 C-s-1 C-s-2 C-l-2 C-l-2 
job-4695,1,12,1,234464,234464,234518,0,54,234750,true,L-m-0 
job-4696,2,4,5,234512,234512,234535,0,23,234567,true,L-m-0 L-l-0 C-m-0 L-s-0 L-s-0 
job-4692,5,7,4,234312,234312,234579,0,267,234766,true,L-m-0 L-l-0 L-l-0 C-m-0 
job-4698,6,6,1,234599,234599,234617,0,18,234853,true,L-m-0 
job-4699,5,11,3,234645,234645,234678,0,33,234762,true,L-m-0 L-l-0 L-l-0 
job-4700,6,6,5,234692,234692,234764,0,72,234856,true,L-m-0 L-l-0 L-l-0 C-m-0 C-m-2 
job-4702,1,7,7,234794,234794,234821,0,27,235011,true,L-m-0 L-m-0 L-m-0 L-m-0 L-l-0 L-l-0 L-l-0 
job-4697,4,6,3,234550,234550,234877,0,327,235038,true,L-s-0 C-s-0 C-s-1 
job-4701,4,9,6,234750,234750,234921,0,171,235164,true,C-s-2 C-m-1 C-m-1 C-l-2 C-l-2 C-l-2 
job-4703,6,11,8,234836,234836,235020,0,184,235217,true,L-m-0 L-l-0 L-l-0 C-m-0 C-m-2 C-l-0 C-l-0 C-l-1 
job-4705,3,5,7,234942,234942,235031,0,89,235302,true,L-s-0 C-s-2 C-s-0 C-s-1 C-m-1 C-m-1 C-l-2 
job-4707,5,10,7,235046,235046,235110,0,64,235286,true,L-m-0 C-l-1 L-l-0 L-l-0 C-m-0 C-m-2 C-m-1 
job-4708,1,4,2,235100,235100,235132,0,32,235280,true,L-m-0 L-l-0 
job-4706,2,11,1,234997,234997,235141,0,144,235263,true,L-m-0 
job-4711,1,12,4,235248,235248,235273,0,25,235498,true,L-m-0 L-l-0 L-l-0 L-l-0 
job-4710,1,9,2,235201,235201,235278,0,77,235523,true,L-s-0 L-m-0 
job-4704,6,5,1,234884,234884,235283,0,399,235377,true,C-l-1 
job-4709,6,8,1,235149,235149,235317,0,168,235352,true,C-l-1 
job-4713,1,10,1,235343,235343,235415,0,72,235628,true,C-l-1 
job-4714,5,8,4,235398,235398,235416,0,18,235519,true,C-l-1 L-m-0 L-l-0 L-l-0 
job-4712,4,5,1,235294,235294,235525,0,231,235574,true,C-l-1 
job-4717,6,6,3,235548,235548,235567,0,19,235767,true,C-l-1 C-m-0 C-m-2 
job-4716,4,8,4,235493,235493,235602,0,109,235782,true,L-m-0 L-l-0 L-l-0 L-l-0 
job-4719,2,7,1,235657,235657,235673,0,16,235913,true,L-l-0 
job-4718,3,9,3,235604,235604,235675,0,71,235835,true,L-m-0 C-l-1 L-l-0 
job-4715,2,11,6,235451,235451,235732,0,281,235841,true,C-l-1 C-l-1 C-l-1 L-s-0 L-m-0 L-m-0 
job-4721,2,9,4,235748,235748,235761,0,13,235764,true,L-m-0 L-m-0 C-l-1 C-l-1 
job-4723,3,7,5,235838,235838,235853,0,15,235980,true,L-s-0 C-s-2 C-s-0 C-s-1 C-m-0 
job-4722,4,7,3,235787,235787,235859,0,72,235974,true,L-m-0 C-l-1 C-l-1 
job-4724,3,10,5,235896,235896,235930,0,34,236149,true,L-m-0 C-l-1 C-l-1 L-s-0 C-s-2 
job-4720,4,4,5,235701,235701,235974,0,273,236100,true,L-m-0 C-l-1 L-l-0 L-l-0 L-l-0 
job-4726,2,10,6,236011,236011,236024,0,13,236088,true,L-m-0 L-m-0 C-l-1 C-l-1 C-l-1 C-l-1 
job-4725,4,6,2,235958,235958,236097,0,139,236356,true,L-m-0 C-l-1 
job-4729,2,12,5,236155,236155,236165,0,10,236414,true,L-m-0 C-m-0 C-m-2 C-m-1 C-l-0 
job-4730,3,5,6,236212,236212,236228,0,16,236388,true,L-m-0 C-m-1 L-s-0 C-s-2 C-s-0 C-s-1 
job-4728,5,7,5,236105,236105,236373,0,268,236409,true,C-l-1 L-m-0 C-m-1 C-l-0 C-l-0 
job-4731,2,12,4,236272,236272,236380,0,108,236386,true,L-m-0 C-m-0 C-m-2 C-m-1 
job-4733,4,7,5,236368,236368,236444,0,76,236665,true,L-s-0 C-s-2 C-s-0 C-s-1 C-l-2 
job-4732,1,12,3,236322,236322,236485,0,163,236546,true,L-m-0 C-m-1 C-l-1 
job-4727,6,6,5,236056,236056,236499,0,443,236605,true,C-l-1 L-l-0 L-l-0 C-m-0 C-m-2 
job-4734,4,4,2,236420,236420,236565,0,145,236658,true,L-m-0 C-m-1 
job-4736,3,5,3,236509,236509,236567,0,58,236679,true,L-m-0 C-m-1 C-l-2 
job-4737,4,9,6,236554,236554,236579,0,25,236705,true,L-s-0 C-s-2 C-s-0 C-s-1 C-l-0 C-l-0 
job-4735,6,4,7,236466,236499,236616,33,117,236734,true,L-l-0 L-l-0 C-m-0 C-m-2 C-l-1 C-l-1 C-l-2 
job-4739,6,12,2,236646,236646,236693,0,47,236931,true,C-l-2 L-m-0 
job-4738,4,10,1,236599,236599,236712,0,113,236768,true,C-l-2 
job-4740,3,9,1,236689,236689,236787,0,98,236882,true,L-s-0 
job-4741,6,12,6,236744,236744,236869,0,125,236945,true,L-m-0 L-l-0 L-l-0 C-m-0 C-m-2 C-m-1 
job-4745,1,12,2,236934,236934,236945,0,11,237129,true,L-m-0 C-l-2 
job-4742,5,5,8,236781,236869,237005,88,136,237131,true,L-m-0 L-l-0 L-l-0 C-m-0 C-m-2 C-m-1 C-l-2 C-l-2 
job-4744,3,8,6,236883,236883,237015,0,132,237196,true,C-m-0 C-m-2 C-m-1 L-s-0 C-s-2 C-s-0 
job-4746,6,11,4,236980,236980,237076,0,96,237315,true,C-l-1 C-l-1 C-l-0 C-l-0 
job-4749,1,8,6,237131,237131,237142,0,11,237215,true,L-l-0 L-l-0 C-s-0 C-s-0 C-s-1 C-s-1 
job-4748,4,8,5,237085,237085,237144,0,59,237196,true,L-m-0 L-l-0 L-l-0 L-s-0 C-s-2 
job-4747,2,6,1,237029,237029,237195,0,166,237298,true,L-m-0 
job-4750,4,4,4,237183,237183,237207,0,24,237262,true,L-m-0 L-l-0 L-l-0 L-s-0 
job-4743,2,8,2,236832,236869,237217,37,348,237375,true,L-m-0 L-l-0 
job-4752,3,12,7,237281,237281,237331,0,50,237578,true,L-m-0 L-l-0 L-l-0 L-s-0 C-s-2 C-s-0 C-s-1 
job-4754,2,6,4,237369,237369,237386,0,17,237462,true,L-m-0 L-l-0 L-l-0 L-l-0 
job-4753,1,5,5,237324,237324,237397,0,73,237558,true,L-l-0 C-m-0 C-m-0 C-m-0 C-m-0 
job-4751,5,9,2,237246,237246,237505,0,259,237798,true,L-m-0 L-l-0 
job-4756,5,4,2,237455,237455,237529,0,74,237802,true,C-m-0 C-m-2 
job-4757,6,10,3,237510,237510,237532,0,22,237620,true,L-m-0 L-l-0 C-m-1 
job-4758,6,9,7,237550,237550,237643,0,93,237712,true,L-m-0 L-l-0 C-m-0 C-m-2 C-m-1 C-l-1 C-l-1 
job-4759,6,10,4,237595,237595,237661,0,66,237712,true,C-l-0 C-l-0 C-l-2 C-l-2 
job-4760,3,4,8,237652,237652,237662,0,10,237889,true,L-m-0 L-m-0 L-l-0 L-l-0 C-s-0 C-s-1 C-m-0 C-m-0 
job-4755,2,8,8,237420,237420,237687,0,267,237692,true,L-m-0 L-l-0 L-l-0 L-l-0 L-s-0 L-s-0 C-s-2 C-s-2 
job-4761,1,7,4,237702,237702,237839,0,137,237914,true,L-s-0 L-s-0 L-m-0 L-m-0 
job-4763,5,7,7,237819,237819,237853,0,34,237948,true,C-m-0 C-m-2 C-m-1 C-l-0 C-l-0 C-l-2 C-l-2 
job-4764,1,4,2,237868,237868,237904,0,36,238133,true,L-m-0 L-m-0 
job-4765,1,11,1,237910,237910,237925,0,15,238118,true,L-m-0 
job-4762,6,9,3,237762,237762,237965,0,203,238196,true,L-m-0 L-l-0 L-l-0 
job-4766,1,4,6,237954,237954,238011,0,57,238218,true,L-m-0 L-m-0 L-s-0 L-s-0 L-s-0 L-s-0 
job-4767,3,10,7,238007,238007,238017,0,10,238252,true,L-m-0 L-m-0 L-l-0 L-l-0 L-l-0 L-l-0 C-s-2 
job-4768,2,12,8,238058,238058,238068,0,10,238316,true,L-s-0 L-m-0 L-m-0 L-l-0 L-l-0 L-l-0 L-l-0 C-s-2 
job-4769,6,12,4,238114,238114,238151,0,37,238339,true,L-m-0 L-l-0 L-l-0 C-m-0 
job-4770,4,4,1,238155,238155,238208,0,53,238221,true,L-s-0 
job-4771,3,4,3,238209,238209,238268,0,59,238431,true,L-s-0 L-m-0 L-m-0 
job-4772,2,9,7,238251,238251,238291,0,40,238515,true,L-m-0 L-l-0 L-l-0 L-l-0 L-l-0 L-l-0 C-s-2 
job-4773,4,4,8,238305,238305,238346,0,41,238550,true,L-s-0 L-m-0 L-m-0 L-l-0 L-l-0 L-l-0 C-s-2 C-s-0 
job-4774,5,7,6,238356,238356,238441,0,85,238622,true,L-m-0 L-l-0 L-l-0 C-m-0 C-m-2 C-m-1 
job-4777,4,9,1,238506,238506,238555,0,49,238737,true,C-s-1 
job-4776,5,5,4,238441,238441,238585,0,144,238724,true,L-m-0 L-l-0 L-l-0 C-m-0 
job-4779,6,12,4,238609,238609,238633,0,24,238640,true,C-l-0 L-l-0 L-l-0 C-l-2 
job-4778,3,7,8,238563,238563,238682,0,119,238839,true,L-m-0 C-m-0 C-s-1 C-m-2 C-m-2 C-m-1 C-m-1 C-l-0 
job-4775,4,7,3,238401,238401,238730,0,329,238745,true,L-s-0 C-s-2 C-s-0 
job-4781,6,5,2,238706,238706,238809,0,103,238921,true,L-l-0 C-l-0 
job-4783,6,11,3,238818,238818,238877,0,59,239038,true,L-l-0 C-l-0 C-m-2 
job-4784,2,11,1,238864,238864,238968,0,104,238995,true,C-m-2 
job-4785,5,6,3,238919,238919,239011,0,92,239022,true,L-l-0 C-m-2 C-l-0 
job-4787,4,7,6,239016,239016,239086,0,70,239110,true,L-l-0 C-l-0 C-m-2 C-m-2 C-l-2 C-l-2 
job-4780,5,7,4,238656,238656,239095,0,439,239254,true,L-m-0 C-m-0 C-l-0 L-l-0 
job-4789,2,7,2,239115,239115,239137,0,22,239432,true,L-m-0 L-m-0 
job-4788,2,4,3,239062,239062,239169,0,107,239179,true,L-l-0 C-m-1 C-l-0 
job-4782,3,6,1,238760,238760,239179,0,419,239219,true,L-m-0 
job-4790,6,8,7,239167,239167,239343,0,176,239610,true,L-l-0 C-l-0 C-m-2 C-l-2 C-l-2 C-l-1 C-l-1 
job-4786,3,11,7,238967,238967,239353,0,386,239441,true,C-m-0 L-s-0 C-s-2 C-s-0 C-s-1 C-m-1 C-m-1 
job-4791,4,9,8,239223,239343,239535,120,192,239569,true,C-m-0 L-m-0 L-m-0 L-l-0 L-l-0 L-l-0 C-m-2 C-m-2 
job-4793,6,12,7,239324,239535,239666,211,131,239471,false,C-m-0 C-m-1 C-l-2 L-m-0 L-l-0 L-l-0 C-m-2 
job-4794,2,6,4,239395,239535,239666,140,131,239603,false,L-m-0 C-m-2 C-l-2 C-l-2 
job-4799,6,8,1,239651,239666,239689,15,23,239689,false,C-l-0 
job-4798,4,12,6,239599,239666,239728,67,62,239812,true,L-s-0 C-s-2 C-s-0 C-s-1 C-l-1 C-l-1 
job-4797,1,11,3,239537,239666,239779,129,113,239866,true,L-l-0 L-l-0 C-m-2 
job-4795,5,8,6,239445,239666,239793,221,127,239866,true,L-m-0 C-m-2 C-m-0 C-m-1 C-l-2 L-l-0 
job-4792,1,6,3,239275,239343,239799,68,456,240028,true,C-m-0 C-m-1 C-l-2 
job-4801,4,7,4,239752,239752,239811,0,59,240080,true,C-l-0 L-s-0 C-s-2 C-s-0 
job-4802,5,8,2,239800,239800,239875,0,75,239999,true,L-m-0 L-l-0 
job-4803,3,6,2,239846,239846,239939,0,93,240208,true,L-l-0 C-l-0 
job-4796,1,5,3,239494,239666,239949,172,283,240044,true,L-m-0 L-l-0 L-l-0 
job-4800,5,8,2,239705,239705,239960,0,255,240204,true,C-l-2 C-l-0 
job-4804,5,8,5,239906,239906,240038,0,132,240154,true,L-m-0 L-l-0 C-l-2 C-m-2 C-m-0 
job-4805,1,10,7,239968,239968,240063,0,95,240101,true,L-m-0 L-m-0 L-l-0 L-l-0 L-l-0 L-l-0 C-m-2 
job-4807,1,12,7,240065,240065,240126,0,61,240164,true,L-m-0 L-m-0 L-l-0 L-l-0 L-l-0 C-m-2 C-m-2 
job-4810,1,10,7,240206,240206,240267,0,61,240405,true,L-l-0 C-m-0 C-m-1 C-l-0 C-l-0 C-l-0 C-l-0 
job-4806,5,4,8,240013,240038,240292,25,254,240506,true,L-m-0 L-l-0 C-m-2 C-m-0 C-m-1 C-l-2 C-l-2 C-l-0 
job-4812,4,11,1,240296,240296,240324,0,28,240617,true,L-m-0 
job-4808,2,10,3,240113,240113,240394,0,281,240486,true,C-m-0 C-m-1 C-l-2 
job-4811,1,7,4,240257,240257,240404,0,147,240501,true,L-s-0 L-s-0 C-s-2 C-s-2 
job-4813,2,10,4,240346,240346,240407,0,61,240461,true,L-m-0 L-m-0 L-l-0 L-l-0 
job-4809,3,10,4,240151,240151,240413,0,262,240691,true,L-m-0 L-l-0 L-l-0 C-m-2 
job-4815,6,12,7,240447,240447,240487,0,40,240531,true,C-l-2 L-m-0 L-l-0 L-l-0 C-l-0 C-l-0 C-l-1 
job-4816,2,5,1,240496,240496,240530,0,34,240532,true,C-m-2 
job-4817,3,4,2,240535,240535,240547,0,12,240565,true,C-m-2 C-l-2 
job-4814,4,10,8,240396,240396,240569,0,173,240672,true,C-m-2 C-s-0 C-s-1 C-m-0 C-m-0 C-m-1 C-m-1 C-l-2 
job-4818,6,8,6,240591,240591,240655,0,64,240893,true,L-m-0 L-l-0 L-l-0 C-m-0 C-m-1 C-m-2 
job-4819,2,7,3,240652,240652,240664,0,12,240886,true,L-m-0 C-m-0 C-m-1 
job-4820,1,11,2,240704,240704,240754,0,50,240859,true,L-s-0 L-m-0 
job-4821,1,7,4,240755,240755,240812,0,57,240965,true,L-s-0 L-s-0 L-m-0 L-m-0 
job-4823,1,5,2,240851,240851,240874,0,23,241078,true,L-m-0 L-m-0 
job-4822,1,6,2,240807,240807,240926,0,119,240950,true,L-m-0 L-m-0 
job-4825,1,5,6,240951,240951,241011,0,60,241238,true,L-m-0 L-m-0 L-s-0 L-s-0 L-s-0 L-l-0 
job-4826,6,4,3,241004,241004,241065,0,61,241118,true,L-l-0 C-m-0 C-m-1 
job-4824,6,7,1,240906,240906,241082,0,176,241327,true,L-m-0 
job-4827,3,11,8,241054,241054,241144,0,90,241208,true,L-l-0 L-l-0 L-s-0 C-s-0 C-s-1 C-s-2 C-m-2 C-m-2 
job-4829,3,12,6,241134,241134,241160,0,26,241181,true,L-l-0 L-m-0 L-m-0 C-m-0 C-m-0 C-m-1 
job-4830,4,11,5,241193,241193,241276,0,83,241446,true,L-l-0 L-l-0 L-m-0 L-m-0 C-s-0 
job-4831,6,7,3,241231,241231,241286,0,55,241394,true,C-m-2 C-m-0 C-m-1 
job-4832,5,9,5,241278,241278,241289,0,11,241318,true,L-l-0 L-l-0 L-m-0 C-l-2 C-l-2 
job-4833,4,12,7,241338,241338,241392,0,54,241668,true,L-l-0 L-l-0 L-m-0 L-m-0 C-s-0 C-s-1 C-s-2 
job-4828,1,5,2,241099,241099,241438,0,339,241658,true,L-s-0 L-l-0 
job-4835,6,8,3,241439,241439,241465,0,26,241632,true,L-m-0 L-l-0 L-l-0 
job-4834,6,8,5,241385,241385,241527,0,142,241621,true,C-m-2 C-m-0 C-m-1 C-l-2 C-l-2 
job-4836,3,8,8,241490,241490,241554,0,64,241573,true,L-s-0 L-m-0 L-m-0 L-l-0 L-l-0 L-l-0 L-l-0 C-s-0 
job-4837,6,5,5,241533,241533,241554,0,21,241769,true,C-m-2 C-m-0 C-m-1 C-l-2 C-l-2 
job-4838,4,11,2,241583,241583,241633,0,50,241652,true,L-s-0 L-m-0 
job-4839,4,12,8,241623,241623,241716,0,93,241979,true,L-m-0 L-l-0 L-l-0 L-l-0 C-s-0 C-s-1 C-s-2 C-m-2 
job-4841,3,6,5,241720,241720,241746,0,26,241894,true,L-m-0 C-m-2 L-s-0 L-l-0 L-l-0 
job-4840,3,10,2,241675,241675,241813,0,138,241888,true,L-m-0 C-m-2 
job-4842,2,8,3,241783,241783,241818,0,35,241895,true,L-m-0 L-m-0 C-m-2 
job-4843,5,11,1,241836,241836,241878,0,42,241900,true,L-m-0 
job-4846,2,11,1,241980,241980,242006,0,26,242287,true,L-l-0 
job-4844,6,8,1,241889,241889,242046,0,157,242119,true,L-m-0 
job-4849,2,5,5,242108,242108,242158,0,50,242275,true,L-m-0 C-s-1 C-s-1 C-s-2 C-s-2 
job-4845,2,12,4,241932,241932,242161,0,229,242248,true,L-m-0 L-s-0 L-l-0 L-l-0 
job-4847,6,12,8,242023,242023,242164,0,141,242264,true,L-l-0 C-m-2 C-m-0 C-m-1 C-l-2 C-l-2 C-l-0 C-l-0 
job-4848,2,12,6,242068,242068,242270,0,202,242521,true,L-m-0 L-l-0 C-m-2 C-m-0 C-m-1 C-s-0 
job-4851,4,11,5,242228,242228,242291,0,63,242526,true,L-l-0 C-m-2 C-m-0 C-m-1 C-s-2 
job-4850,1,9,6,242163,242163,242334,0,171,242453,true,L-m-0 L-m-0 L-l-0 L-l-0 L-s-0 C-s-1 
job-4852,1,6,1,242281,242281,242350,0,69,242365,true,L-s-0 
job-4853,4,11,3,242333,242333,242376,0,43,242397,true,L-m-0 L-l-0 L-l-0 
job-4854,4,7,1,242384,242384,242543,0,159,242571,true,L-s-0 
job-4857,3,4,5,242532,242532,242554,0,22,242847,true,C-s-2 C-s-0 C-m-1 C-m-1 C-l-2 
job-4856,6,11,2,242470,242470,242584,0,114,242683,true,C-m-2 C-m-0 
job-4855,4,8,6,242426,242426,242616,0,190,242657,true,L-m-0 L-m-0 L-l-0 L-l-0 L-l-0 C-s-1 
job-4858,1,5,4,242586,242586,242750,0,164,242865,true,L-s-0 L-s-0 L-s-0 C-s-2 
job-4859,2,10,5,242624,242624,242757,0,133,242845,true,C-s-2 L-m-0 L-m-0 L-m-0 L-l-0 
job-4860,2,10,1,242672,242672,242819,0,147,242834,true,L-l-0 
job-4861,5,4,6,242712,242712,242830,0,118,242942,true,L-l-0 C-m-2 C-m-0 C-m-1 C-l-2 C-l-2 
job-4862,6,12,7,242751,242830,243012,79,182,242976,false,L-m-0 L-l-0 L-l-0 C-m-2 C-m-0 C-m-1 C-l-2 
job-4865,3,7,6,242910,243012,243118,102,106,243165,true,C-s-2 C-s-1 C-s-0 C-l-0 C-l-0 C-l-0 
job-4864,2,6,5,242858,243012,243169,154,157,243208,true,L-m-0 C-m-2 C-m-0 C-m-1 L-s-0 
job-4863,6,7,8,242815,243012,243303,197,291,243186,false,L-m-0 L-l-0 L-l-0 C-m-2 C-m-0 C-m-1 C-l-2 C-l-2 
job-4868,1,12,1,243054,243303,243333,249,30,243116,false,C-m-2 
job-4866,6,11,8,242957,243303,243350,346,47,243278,false,L-m-0 L-l-0 L-l-0 C-m-2 C-m-0 C-m-1 C-l-2 C-l-2 
job-4871,5,7,3,243195,243350,243382,155,32,243421,true,C-m-2 C-l-2 C-l-2 
job-4869,2,7,4,243097,243303,243383,206,80,243255,false,C-m-0 C-m-1 L-s-0 L-s-0 
job-4872,3,8,1,243259,243350,243388,91,38,243414,true,C-m-2 
job-4873,1,11,1,243304,243350,243388,46,38,243511,true,L-m-0 
job-4870,5,8,5,243143,243350,243391,207,41,243242,false,L-m-0 C-m-0 C-m-1 L-l-0 L-l-0 
job-4875,3,12,2,243420,243420,243438,0,18,243636,true,L-m-0 L-m-0 
job-4874,1,8,2,243359,243359,243489,0,130,243752,true,L-l-0 L-l-0 
job-4876,4,8,3,243474,243474,243505,0,31,243673,true,L-m-0 L-l-0 L-l-0 
job-4867,2,5,1,243007,243303,243628,296,325,243491,false,L-m-0 
job-4878,5,5,8,243585,243585,243652,0,67,243950,true,C-m-2 C-m-0 C-m-1 C-l-2 C-l-2 C-l-0 C-l-0 C-l-1 
job-4877,3,11,6,243533,243533,243743,0,210,243993,true,L-m-0 L-m-0 L-s-0 L-l-0 L-l-0 L-l-0 
job-4879,6,12,3,243644,243652,243755,8,103,243927,true,C-m-2 C-m-0 C-m-1 
job-4881,3,11,7,243749,243749,243766,0,17,243859,true,C-l-1 C-l-1 L-s-0 L-m-0 L-m-0 L-l-0 L-l-0 
job-4880,5,12,5,243694,243694,243905,0,211,243983,true,C-l-2 C-l-2 C-l-0 C-l-0 C-l-1 
job-4882,5,9,3,243798,243798,243959,0,161,244161,true,C-l-1 L-m-0 L-l-0 
job-4883,5,7,7,243847,243905,244064,58,159,244140,true,L-l-0 C-l-1 C-m-2 C-m-0 C-m-1 C-l-2 C-l-2 
job-4887,3,7,5,244038,244064,244081,26,17,244251,true,L-m-0 C-m-2 C-m-0 C-m-1 C-l-0 
job-4884,5,11,6,243900,244064,244147,164,83,243986,false,L-m-0 L-l-0 L-l-0 C-m-2 C-m-0 C-m-1 
job-4886,4,8,8,243986,244064,244168,78,104,244104,false,C-s-1 C-s-0 C-l-2 C-l-2 C-l-2 C-l-1 C-l-1 C-l-1 
job-4885,4,6,2,243945,244064,244181,119,117,244105,false,L-s-0 C-s-2 
job-4890,2,12,8,244184,244184,244254,0,70,244498,true,L-m-0 C-m-2 C-l-0 L-s-0 C-s-1 C-s-0 C-s-2 C-m-0 
job-4891,2,6,7,244237,244237,244308,0,71,244367,true,C-m-0 C-m-0 C-m-0 C-m-1 C-m-1 C-m-1 C-m-1 
job-4889,6,9,5,244133,244147,244327,14,180,244478,true,C-l-0 L-m-0 L-l-0 L-l-0 C-m-2 
job-4888,4,4,1,244088,244088,244333,0,245,244373,true,C-l-0 
job-4892,2,4,8,244284,244284,244351,0,67,244540,true,L-m-0 C-m-0 C-m-2 C-l-0 L-s-0 L-s-0 C-s-1 C-s-1 
job-4895,1,7,1,244451,244451,244538,0,87,244633,true,L-m-0 
job-4894,5,7,5,244392,244392,244619,0,227,244690,true,C-l-0 C-l-2 C-l-2 C-l-1 C-l-1 
job-4896,3,11,7,244506,244619,244631,113,12,244574,false,C-l-0 C-l-0 L-s-0 C-s-1 C-s-0 C-s-2 C-l-2 
job-4897,3,11,5,244550,244619,244702,69,83,244650,false,C-l-2 C-l-2 C-l-2 C-l-1 C-l-1 
job-4898,6,5,3,244596,244702,244715,106,13,244637,false,C-l-0 C-l-2 C-l-2 
job-4899,4,4,7,244654,244702,244723,48,21,244812,true,L-s-0 C-s-1 C-s-0 C-s-2 C-l-1 C-l-1 C-l-1 
job-4893,6,6,7,244336,244336,244745,0,409,244868,true,L-m-0 C-m-0 C-m-2 C-l-0 L-l-0 L-l-0 C-m-1 
job-4900,1,11,2,244700,244702,244756,2,54,244765,true,L-m-0 L-m-0 
job-4902,3,10,3,244794,244794,244875,0,81,245151,true,L-m-0 L-m-0 C-s-0 
job-4901,2,9,8,244747,244747,244882,0,135,245066,true,L-m-0 L-s-0 L-l-0 L-l-0 L-l-0 L-l-0 L-l-0 C-s-1 
job-4903,3,5,2,244847,244847,244912,0,65,245033,true,C-s-2 C-m-0 
job-4904,1,11,6,244884,244884,244915,0,31,245120,true,C-s-2 C-m-0 C-m-0 L-s-0 L-m-0 L-m-0 
job-4905,1,6,6,244930,244930,245018,0,88,245027,true,L-s-0 L-s-0 L-m-0 L-m-0 L-m-0 L-m-0 
job-4906,2,6,2,244975,244975,245020,0,45,245203,true,L-m-0 L-l-0 
job-4907,3,9,4,245039,245039,245090,0,51,245386,true,L-s-0 L-m-0 L-m-0 L-l-0 
job-4909,6,9,1,245138,245138,245198,0,60,245269,true,L-l-0 
job-4911,1,6,7,245243,245243,245280,0,37,245306,true,L-l-0 L-l-0 L-l-0 L-l-0 L-l-0 L-l-0 L-l-0 
job-4908,5,6,7,245088,245088,245291,0,203,245556,true,L-l-0 C-m-0 C-m-2 C-m-1 C-l-1 C-l-1 C-l-0 
job-4912,4,10,3,245291,245291,245313,0,22,245589,true,C-l-0 C-l-0 L-s-0 
job-4913,5,5,8,245330,245330,245372,0,42,245421,true,C-l-0 L-m-0 L-l-0 L-l-0 C-m-0 C-m-2 C-m-1 C-l-1 
job-4910,4,9,1,245196,245196,245474,0,278,245739,true,C-l-0 
job-4914,2,6,2,245384,245384,245498,0,114,245662,true,C-l-0 C-l-0 
job-4916,6,10,8,245476,245476,245547,0,71,245704,true,L-m-0 L-l-0 L-l-0 C-m-0 C-m-2 C-m-1 C-l-1 C-l-1 
job-4915,3,5,2,245430,245430,245568,0,138,245644,true,C-l-0 L-s-0 
job-4919,4,12,6,245638,245638,245660,0,22,245857,true,C-m-1 C-l-0 C-l-0 L-s-0 L-l-0 L-l-0 
job-4918,2,5,8,245585,245585,245668,0,83,245943,true,L-m-0 L-m-0 L-m-0 C-m-0 C-m-0 C-m-0 C-m-2 C-m-2 
job-4917,2,5,6,245526,245526,245676,0,150,245720,true,L-m-0 C-m-0 C-m-2 C-m-1 C-l-0 C-l-0 
job-4922,2,9,6,245785,245785,245887,0,102,245946,true,L-l-0 L-l-0 C-s-2 C-s-0 C-s-1 C-m-0 
job-4920,2,7,4,245687,245687,245905,0,218,246025,true,L-s-0 L-s-0 L-m-0 L-m-0 
job-4924,6,8,2,245901,245901,245957,0,56,246219,true,C-l-2 C-l-2 
job-4925,6,6,1,245952,245957,246002,5,45,246192,true,C-l-2 
job-4921,2,7,6,245737,245737,246025,0,288,246241,true,L-m-0 L-m-0 L-l-0 L-l-0 L-l-0 L-l-0 
job-4926,6,8,5,246007,246025,246037,18,12,246096,true,L-m-0 L-l-0 L-l-0 C-l-2 C-l-2 
job-4927,2,9,8,246057,246057,246098,0,41,246246,true,C-m-0 C-m-2 C-m-1 C-l-0 C-l-1 L-s-0 L-m-0 L-m-0 
job-4928,5,10,1,246097,246097,246117,0,20,246206,true,L-l-0 
job-4923,5,11,7,245845,245845,246185,0,340,246413,true,C-m-0 C-m-2 C-m-1 C-l-0 C-l-0 C-l-1 C-l-1 
job-4930,1,11,3,246192,246192,246265,0,73,246418,true,L-m-0 L-m-0 L-l-0 
job-4929,5,5,4,246152,246152,246289,0,137,246473,true,L-m-0 L-l-0 L-l-0 C-l-2 
job-4931,4,12,1,246246,246246,246322,0,76,246348,true,C-l-2 
job-4932,6,10,6,246295,246295,246403,0,108,246604,true,C-l-2 L-m-0 L-l-0 L-l-0 C-m-0 C-m-2 
job-4933,6,8,8,246335,246403,246451,68,48,246467,true,L-m-0 L-l-0 L-l-0 C-m-0 C-m-2 C-m-1 C-l-2 C-l-2 
job-4935,5,12,1,246419,246419,246467,0,48,246640,true,C-l-0 
job-4934,2,8,3,246383,246403,246481,20,78,246600,true,L-m-0 C-m-0 C-m-2 
job-4938,6,6,4,246559,246559,246593,0,34,246703,true,L-l-0 L-l-0 C-m-0 C-m-2 
job-4937,1,6,1,246514,246514,246617,0,103,246744,true,L-m-0 
job-4936,2,5,3,246466,246466,246619,0,153,246627,true,L-m-0 L-m-0 L-m-0 
job-4939,6,9,7,246598,246598,246837,0,239,247034,true,L-l-0 L-l-0 C-m-0 C-m-2 C-m-1 C-l-0 C-l-0 
job-4941,4,9,1,246722,246837,246874,115,37,246982,true,L-s-0 
job-4943,3,10,6,246825,246837,246899,12,62,247105,true,C-s-2 C-s-0 C-s-1 C-l-0 C-l-0 C-l-0 
job-4942,1,11,1,246777,246837,246911,60,74,247017,true,L-m-0 
job-4944,6,6,6,246863,246899,246914,36,15,247126,true,C-l-0 C-l-0 C-l-2 C-l-2 C-l-1 C-l-1 
job-4945,4,9,5,246919,246919,246945,0,26,247171,true,L-s-0 C-s-2 C-s-0 C-s-1 C-l-0 
job-4940,6,11,6,246665,246837,246998,172,161,247118,true,L-m-0 L-l-0 L-l-0 C-m-0 C-m-2 C-m-1 
job-4947,5,5,1,247037,247037,247091,0,54,247091,false,L-m-0 
job-4948,6,7,3,247089,247089,247166,0,77,247421,true,L-l-0 L-l-0 C-m-0 
job-4949,5,7,1,247130,247130,247187,0,57,247407,true,L-m-0 
job-4950,4,12,1,247183,247183,247295,0,112,247341,true,L-s-0 
job-4946,1,7,2,246980,246980,247316,0,336,247512,true,L-m-0 L-m-0 
job-4952,1,6,4,247281,247281,247338,0,57,247464,true,C-m-0 C-m-0 C-s-2 C-s-2 
job-4951,6,12,4,247230,247230,247411,0,181,247664,true,L-m-0 L-l-0 L-l-0 C-m-0 
job-4953,2,9,4,247333,247333,247421,0,88,247499,true,L-m-0 L-s-0 C-s-0 C-s-1 
job-4955,6,5,4,247437,247437,247447,0,10,247603,true,C-l-2 L-m-0 L-l-0 L-l-0 
job-4956,2,12,7,247503,247503,247550,0,47,247847,true,C-m-2 C-m-1 C-l-2 C-l-2 C-l-2 L-s-0 L-m-0 
job-4957,6,6,5,247539,247539,247636,0,97,247670,true,L-m-0 L-l-0 L-l-0 C-m-0 C-l-1 
job-4954,6,4,5,247377,247377,247737,0,360,247934,true,C-m-2 C-m-1 C-l-0 C-l-0 C-l-2 
job-4959,4,12,5,247637,247637,247787,0,150,248062,true,C-s-0 C-s-1 C-s-2 C-m-0 C-m-0 
job-4958,4,6,7,247589,247636,247815,47,179,247810,false,C-l-2 L-s-0 L-m-0 L-m-0 L-l-0 L-l-0 L-l-0 
job-4962,6,12,4,247802,247815,247843,13,28,247987,true,C-l-2 L-m-0 L-l-0 L-l-0 
job-4960,5,12,7,247687,247737,247858,50,121,247893,true,C-l-2 C-m-2 C-m-1 C-l-0 C-l-0 C-l-1 C-l-1 
job-4961,1,6,1,247757,247757,247904,0,147,248029,true,C-m-2 
job-4963,2,7,2,247854,247854,247920,0,66,248041,true,C-m-2 C-m-1 
job-4965,1,5,1,247947,247947,248017,0,70,248300,true,C-m-2 
job-4966,6,4,2,247998,247998,248020,0,22,248258,true,L-m-0 L-l-0 
job-4964,2,7,4,247900,247900,248071,0,171,248269,true,C-m-2 C-m-2 C-m-1 C-m-1 
job-4967,2,8,5,248044,248044,248098,0,54,248167,true,C-m-2 C-m-2 C-m-1 C-m-1 L-s-0 
job-4968,3,12,6,248103,248103,248179,0,76,248468,true,L-s-0 L-m-0 L-m-0 L-l-0 L-l-0 L-l-0 
job-4969,6,6,4,248140,248140,248225,0,85,248489,true,C-m-2 C-m-1 C-m-0 C-l-0 
job-4970,1,8,1,248199,248199,248311,0,112,248466,true,C-m-2 
job-4973,4,10,8,248351,248351,248437,0,86,248494,true,C-m-2 L-l-0 L-l-0 L-l-0 C-s-0 C-s-1 C-s-2 C-m-1 
job-4972,4,6,2,248281,248281,248441,0,160,248475,true,L-m-0 L-m-0 
job-4971,4,12,2,248238,248238,248447,0,209,248631,true,C-m-2 L-s-0 
job-4974,5,9,2,248409,248409,248448,0,39,248666,true,C-m-0 C-l-0 
job-4975,1,9,7,248458,248458,248510,0,52,248779,true,L-s-0 L-m-0 L-m-0 L-m-0 L-l-0 L-l-0 L-l-0 
job-4976,6,6,2,248507,248507,248586,0,79,248665,true,L-l-0 C-m-2 
job-4978,1,7,1,248599,248599,248629,0,30,248808,true,L-l-0 
job-4977,2,6,3,248553,248553,248690,0,137,248713,true,L-l-0 L-l-0 L-l-0 
job-4980,3,12,2,248717,248717,248743,0,26,248937,true,L-l-0 L-l-0 
job-4979,4,10,7,248654,248654,248778,0,124,248945,true,L-l-0 L-s-0 L-m-0 L-m-0 C-s-0 C-s-1 C-s-2 
job-4981,1,7,3,248768,248768,248841,0,73,248883,true,L-l-0 L-l-0 L-l-0 
job-4982,2,11,5,248820,248820,248883,0,63,248994,true,L-l-0 L-l-0 L-s-0 L-m-0 L-m-0 
job-4983,3,5,7,248872,248872,248913,0,41,249069,true,L-m-0 L-l-0 L-l-0 C-s-0 C-s-1 C-s-2 C-m-2 
job-4984,2,5,6,248911,248911,248974,0,63,249084,true,L-m-0 L-m-0 L-l-0 L-l-0 L-l-0 C-m-2 
job-4985,6,8,5,248956,248956,249049,0,93,249086,true,L-l-0 C-m-2 C-m-1 C-m-0 C-l-0 
job-4987,4,10,8,249054,249054,249071,0,17,249217,true,L-s-0 C-s-0 C-s-1 C-s-2 C-l-1 C-l-1 C-l-1 C-l-2 
job-4986,5,5,8,248995,249049,249126,54,77,249342,true,L-m-0 L-l-0 L-l-0 C-m-2 C-m-1 C-m-0 C-l-0 C-l-0 
job-4988,1,11,6,249109,249109,249195,0,86,249477,true,L-m-0 L-m-0 L-l-0 L-l-0 C-m-2 C-m-2 
job-4989,2,8,3,249157,249157,249244,0,87,249400,true,L-m-0 L-l-0 L-l-0 
job-4993,1,10,2,249355,249355,249422,0,67,249606,true,L-m-0 L-m-0 
job-4990,6,7,4,249218,249218,249429,0,211,249498,true,L-m-0 L-l-0 C-m-2 C-m-1 
job-4994,6,5,7,249400,249429,249488,29,59,249722,true,L-l-0 C-l-0 L-m-0 C-m-2 C-m-1 C-l-1 C-l-1 
job-4995,1,7,3,249458,249458,249521,0,63,249724,true,L-m-0 L-m-0 L-l-0 
job-4991,4,9,3,249268,249268,249556,0,288,249798,true,L-l-0 L-s-0 C-s-0 
job-4997,5,10,1,249559,249559,249672,0,113,249952,true,L-l-0 
job-4998,4,9,6,249614,249614,249705,0,91,249904,true,C-l-0 L-s-0 C-s-0 C-m-2 C-m-2 C-m-1 
job-4999,6,9,7,249672,249705,249728,33,23,249793,true,L-l-0 C-l-0 C-m-2 C-m-1 C-l-1 C-l-1 C-l-2 
job-4996,2,5,8,249520,249520,249742,0,222,249819,true,L-m-0 L-m-0 L-m-0 L-l-0 L-l-0 L-l-0 C-m-0 C-l-0 
job-4992,3,6,5,249305,249305,249807,0,502,249882,true,C-s-1 C-s-2 C-m-0 C-m-0 C-l-0 
job-5000,1,10,4,249722,249722,249840,0,118,249885,true,L-m-0 C-s-1 C-s-2 C-m-2 
job-5002,6,8,4,249820,249820,249887,0,67,249889,true,C-l-0 L-l-0 L-l-0 C-m-0 
job-5003,6,7,7,249861,249887,249958,26,71,249965,true,C-l-0 L-l-0 L-l-0 C-m-0 C-m-1 C-l-1 C-l-1 
job-5004,6,11,8,249905,249958,250095,53,137,250249,true,C-l-0 L-l-0 L-l-0 C-m-0 C-m-1 C-l-1 C-l-1 C-l-2 
job-5001,6,11,3,249768,249768,250132,0,364,250327,true,L-m-0 C-m-2 C-l-0 
job-5007,3,8,5,250075,250095,250147,20,52,250197,true,C-m-0 C-m-0 C-m-1 C-m-1 C-l-0 
job-5005,1,6,7,249960,249960,250159,0,199,250217,true,L-m-0 L-m-0 C-m-2 C-m-2 C-m-0 C-m-0 C-m-1 
job-5008,1,11,8,250129,250129,250168,0,39,250225,true,C-l-0 C-l-0 C-l-2 C-l-2 C-l-2 L-s-0 L-l-0 L-l-0 
job-5006,6,9,1,250022,250022,250237,0,215,250238,true,C-l-2 
job-5009,6,10,7,250186,250186,250345,0,159,250614,true,C-l-2 L-m-0 L-l-0 L-l-0 C-m-0 C-m-2 C-m-1 
job-5012,4,8,2,250327,250327,250348,0,21,250501,true,C-s-2 C-s-0 
job-5013,1,11,6,250384,250384,250404,0,20,250698,true,C-l-0 C-l-0 C-l-2 C-l-2 C-l-2 L-m-0 
job-5014,5,7,8,250439,250439,250483,0,44,250567,true,C-l-2 L-m-0 L-l-0 L-l-0 C-m-0 C-m-2 C-m-1 C-l-1 
job-5010,3,7,4,250250,250250,250484,0,234,250588,true,C-l-2 C-l-2 L-s-0 C-s-1 
job-5011,5,10,2,250285,250285,250503,0,218,250615,true,C-l-0 C-l-0 
job-5016,6,10,5,250536,250536,250601,0,65,250659,true,C-l-0 L-l-0 L-l-0 C-m-0 C-m-2 
job-5017,4,12,1,250575,250575,250605,0,30,250797,true,C-l-0 
job-5018,2,9,6,250623,250623,250674,0,51,250771,true,C-l-0 C-l-0 L-l-0 L-l-0 L-l-0 L-l-0 
job-5015,1,12,5,250489,250489,250724,0,235,250997,true,C-l-0 C-l-0 L-s-0 L-m-0 L-m-0 
job-5019,4,9,6,250662,250662,250756,0,94,250855,true,L-l-0 C-s-1 C-s-2 C-s-0 C-m-0 C-m-0 
job-5021,3,4,6,250743,250743,250767,0,24,251039,true,L-m-0 L-l-0 C-l-0 C-l-0 L-s-0 C-m-2 
job-5020,5,4,3,250700,250700,250769,0,69,251063,true,L-m-0 L-l-0 C-l-0 
job-5022,5,9,4,250795,250795,250809,0,14,251008,true,L-m-0 L-l-0 L-l-0 C-m-0 
job-5023,5,9,8,250842,250842,250915,0,73,251001,true,L-m-0 L-l-0 L-l-0 C-m-0 C-m-2 C-m-1 C-l-0 C-l-0 
job-5025,6,7,3,250940,250940,250968,0,28,251042,true,L-m-0 L-l-0 C-m-0 
job-5024,2,11,8,250894,250894,251007,0,113,251059,true,L-m-0 L-l-0 C-m-0 C-m-2 C-m-1 C-l-0 L-s-0 C-s-1 
job-5026,6,10,4,250987,250987,251086,0,99,251134,true,L-m-0 L-l-0 C-m-0 C-m-2 
job-5028,1,11,1,251084,251084,251103,0,19,251257,true,L-m-0 
job-5027,6,7,4,251032,251032,251154,0,122,251214,true,L-l-0 C-m-1 C-l-0 C-l-0 
job-5029,1,7,6,251137,251137,251182,0,45,251438,true,L-l-0 L-l-0 L-l-0 L-l-0 L-l-0 C-m-1 
job-5030,2,10,5,251173,251173,251303,0,130,251565,true,L-l-0 C-m-1 C-m-1 L-s-0 L-m-0 
job-5031,6,4,8,251231,251231,251368,0,137,251547,true,L-m-0 L-l-0 C-m-0 C-m-2 C-l-0 C-l-0 C-l-2 C-l-2 
job-5033,5,10,6,251330,251368,251390,38,22,251568,true,L-l-0 C-m-1 L-m-0 C-m-0 C-m-2 C-l-0 
job-5032,3,4,2,251283,251283,251391,0,108,251542,true,L-l-0 C-m-1 
job-5035,2,6,3,251430,251430,251571,0,141,251640,true,C-l-2 C-l-1 C-l-0 
job-5036,1,9,7,251478,251478,251577,0,99,251707,true,C-l-0 C-l-0 C-l-0 L-s-0 L-m-0 L-m-0 L-m-0 
job-5037,2,12,6,251541,251541,251597,0,56,251679,true,L-l-0 L-l-0 L-l-0 L-l-0 C-s-1 C-s-2 
job-5034,5,12,5,251384,251384,251633,0,249,251658,true,C-l-0 C-l-2 C-l-2 C-l-1 C-l-1 
job-5039,2,9,2,251629,251629,251644,0,15,251878,true,L-m-0 L-m-0 
job-5040,6,8,1,251676,251676,251710,0,34,251895,true,C-l-0 
job-5038,3,11,4,251581,251581,251726,0,145,251744,true,C-l-0 C-l-0 L-s-0 L-m-0 
job-5041,6,7,4,251724,251724,251854,0,130,251893,true,C-l-0 L-l-0 L-l-0 C-m-1 
job-5043,2,8,1,251813,251813,251865,0,52,252000,true,L-m-0 
job-5044,3,8,3,251854,251854,251886,0,32,251951,true,C-m-0 C-m-2 C-l-0 
job-5042,5,11,8,251763,251763,251933,0,170,252081,true,C-l-0 L-m-0 C-m-0 C-m-2 C-l-2 C-l-2 C-l-1 C-l-1 
job-5046,5,8,3,251959,251959,252046,0,87,252268,true,L-m-0 L-l-0 L-l-0 
job-5045,3,8,1,251898,251898,252072,0,174,252197,true,L-m-0 
job-5048,3,8,3,252059,252059,252104,0,45,252255,true,L-m-0 L-l-0 L-l-0 
job-5050,1,4,7,252144,252144,252207,0,63,252377,true,L-s-0 L-m-0 L-m-0 L-m-0 L-l-0 L-l-0 L-l-0 
job-5047,3,11,4,252011,252011,252216,0,205,252460,true,L-s-0 C-s-1 C-s-2 C-s-0 
job-5049,5,11,3,252102,252102,252225,0,123,252254,true,L-m-0 L-l-0 C-m-0 
job-5052,1,9,4,252245,252245,252284,0,39,252552,true,C-m-2 C-m-2 C-m-2 C-m-1 
job-5054,6,12,3,252328,252328,252404,0,76,252699,true,C-l-2 L-m-0 L-l-0 
job-5051,5,5,3,252195,252195,252428,0,233,252435,true,C-m-2 C-m-1 C-l-2 
job-5053,3,8,2,252291,252291,252492,0,201,252539,true,C-m-2 C-m-1 
job-5056,4,12,8,252431,252431,252505,0,74,252596,true,L-m-0 L-l-0 L-l-0 C-m-2 C-m-1 L-s-0 C-s-1 C-s-2 
job-5055,2,9,3,252384,252384,252542,0,158,252759,true,L-m-0 L-l-0 L-l-0 
job-5058,3,5,4,252532,252532,252574,0,42,252625,true,L-m-0 L-l-0 L-l-0 C-m-0 
job-5057,2,11,3,252487,252487,252593,0,106,252656,true,L-m-0 C-s-0 C-m-0 
job-5059,6,7,4,252572,252572,252629,0,57,252676,true,L-l-0 C-m-2 C-m-1 C-l-2 
job-5061,6,4,4,252668,252668,252686,0,18,252868,true,L-l-0 C-l-2 C-m-2 C-m-1 
job-5062,2,10,4,252717,252717,252793,0,76,253037,true,L-l-0 L-l-0 L-l-0 L-l-0 
job-5063,4,11,1,252777,252777,252832,0,55,252877,true,C-l-2 
job-5060,4,6,5,252627,252627,252834,0,207,253096,true,L-l-0 C-l-2 L-s-0 L-m-0 L-m-0 
job-5064,2,7,4,252835,252835,252890,0,55,252894,true,L-s-0 L-s-0 L-m-0 L-m-0 
job-5065,2,9,3,252894,252894,253008,0,114,253057,true,L-s-0 L-m-0 L-m-0 
job-5067,1,10,8,252976,252976,253016,0,40,253164,true,L-l-0 L-l-0 L-l-0 C-s-0 C-s-1 C-s-2 C-m-2 C-m-2 
job-5068,6,6,4,253027,253027,253047,0,20,253235,true,L-m-0 L-l-0 C-m-2 C-m-1 
job-5066,1,9,3,252930,252930,253115,0,185,253216,true,L-m-0 L-l-0 L-l-0 
job-5069,4,10,6,253072,253072,253180,0,108,253240,true,L-m-0 L-l-0 L-l-0 L-s-0 C-s-0 C-s-1 
job-5070,4,6,7,253121,253121,253243,0,122,253316,true,L-m-0 L-l-0 C-s-2 C-m-2 C-m-2 C-m-1 C-m-1 
job-5072,6,4,4,253220,253220,253261,0,41,253372,true,L-l-0 C-l-2 C-l-1 C-l-1 
job-5073,4,8,3,253261,253261,253323,0,62,253357,true,C-l-2 C-l-2 L-s-0 
job-5074,6,12,3,253313,253313,253340,0,27,253523,true,L-m-0 L-l-0 L-l-0 
job-5071,2,4,6,253167,253167,253537,0,370,253725,true,C-m-0 C-m-0 C-m-0 C-m-0 C-l-2 C-l-2 
job-5075,3,12,3,253370,253370,253544,0,174,253789,true,C-l-2 C-l-2 L-s-0 
job-5076,4,9,2,253437,253437,253555,0,118,253752,true,L-m-0 L-m-0 
job-5080,4,9,7,253633,253633,253646,0,13,253893,true,L-s-0 L-m-0 L-m-0 C-m-0 C-m-0 C-m-1 C-m-1 
job-5079,4,11,3,253572,253572,253650,0,78,253676,true,C-m-2 C-l-2 C-l-2 
job-5077,4,8,6,253481,253481,253655,0,174,253938,true,L-l-0 L-l-0 L-l-0 C-s-2 C-s-0 C-s-1 
job-5078,2,6,2,253529,253529,253716,0,187,253815,true,C-l-2 C-m-2 
job-5081,5,6,1,253686,253686,253735,0,49,253767,true,C-m-2 
job-5082,4,6,4,253735,253735,253760,0,25,253986,true,L-s-0 L-m-0 L-m-0 L-l-0 
job-5083,4,10,3,253784,253784,253841,0,57,254133,true,L-s-0 L-m-0 L-m-0 
job-5085,3,7,5,253892,253892,253903,0,11,254135,true,L-l-0 L-l-0 L-s-0 L-m-0 L-m-0 
job-5084,1,6,5,253839,253839,253967,0,128,254092,true,L-l-0 L-l-0 L-l-0 L-l-0 L-l-0 
job-5086,4,9,3,253945,253945,253990,0,45,254136,true,L-l-0 L-s-0 L-m-0 
job-5087,6,9,8,254005,254005,254059,0,54,254270,true,L-m-0 L-l-0 L-l-0 C-m-2 C-m-0 C-m-1 C-l-2 C-l-2 
job-5088,6,8,5,254055,254059,254131,4,72,254200,true,L-m-0 L-l-0 L-l-0 C-m-2 C-m-0 
job-5090,3,7,3,254157,254157,254244,0,87,254292,true,C-m-1 L-s-0 L-m-0 
job-5091,4,12,5,254205,254205,254339,0,134,254371,true,L-m-0 L-l-0 L-l-0 L-l-0 C-s-2 
job-5092,5,10,2,254260,254260,254418,0,158,254539,true,C-m-2 C-m-0 
job-5093,1,6,8,254303,254303,254448,0,145,254703,true,L-m-0 L-m-0 L-m-0 C-m-2 C-m-2 C-m-2 C-m-0 C-m-0 
job-5094,1,8,5,254344,254344,254489,0,145,254657,true,L-m-0 C-m-0 C-m-1 C-m-1 C-m-1 
job-5089,5,6,1,254099,254099,254546,0,447,254620,true,C-m-1 
job-5095,5,9,7,254386,254386,254686,0,300,254984,true,L-l-0 L-l-0 C-l-2 C-l-2 C-l-1 C-l-1 C-l-0 
job-5096,5,7,6,254438,254686,254720,248,34,254700,false,L-m-0 L-l-0 L-l-0 C-m-1 C-m-0 C-m-2 
job-5097,2,8,8,254493,254686,254720,193,34,254654,false,L-m-0 L-l-0 C-m-1 C-m-0 C-m-2 L-s-0 L-s-0 C-s-2 
job-5101,4,12,2,254677,254720,254796,43,76,254833,true,C-l-1 L-s-0 
job-5099,5,4,2,254585,254686,254825,101,139,254785,false,C-l-2 C-l-2 
job-5098,1,5,4,254533,254686,254837,153,151,254925,true,L-m-0 C-s-2 C-m-1 C-m-0 
job-5100,6,5,7,254629,254720,254853,91,133,254822,false,L-m-0 C-m-1 C-m-0 L-l-0 L-l-0 C-m-2 C-l-1 
job-5104,2,7,2,254826,254826,254893,0,67,255045,true,C-s-2 C-m-2 
job-5102,4,12,5,254735,254735,254937,0,202,255128,true,C-s-0 C-s-1 C-l-0 C-l-0 C-l-0 
job-5106,6,9,3,254938,254938,254958,0,20,254961,true,L-m-0 L-l-0 L-l-0 
job-5105,3,7,7,254883,254883,255011,0,128,255296,true,C-m-2 C-m-2 C-l-1 C-l-1 C-l-2 C-l-2 L-s-0 
job-5103,6,6,2,254784,254825,255076,41,251,255064,false,C-l-1 C-l-2 
job-5107,1,12,6,254978,254978,255098,0,120,255308,true,C-m-2 L-m-0 L-m-0 L-l-0 L-l-0 L-l-0 
job-5109,3,9,1,255075,255075,255135,0,60,255210,true,C-m-2 
job-5108,4,9,4,255030,255030,255163,0,133,255213,true,L-l-0 C-m-2 C-l-1 C-l-2 
job-5110,3,10,7,255127,255127,255171,0,44,255394,true,L-l-0 L-l-0 C-l-1 C-l-1 C-l-2 C-l-2 L-s-0 
job-5111,5,5,8,255188,255188,255311,0,123,255397,true,L-m-0 L-l-0 L-l-0 C-m-2 C-m-1 C-m-0 C-l-1 C-l-1 
job-5112,1,7,2,255241,255241,255394,0,153,255588,true,L-m-0 L-m-0 
job-5114,6,12,1,255348,255348,255441,0,93,255554,true,C-l-1 
job-5113,5,9,6,255297,255311,255451,14,140,255711,true,L-m-0 L-l-0 L-l-0 C-m-2 C-m-1 C-m-0 
job-5116,2,11,7,255429,255429,255452,0,23,255632,true,L-m-0 C-m-0 C-l-1 C-l-1 C-l-1 L-s-0 C-s-0 
job-5115,2,4,3,255387,255387,255463,0,76,255476,true,L-l-0 C-m-2 C-m-1 
job-5117,3,12,1,255486,255486,255544,0,58,255616,true,L-s-0 
job-5118,6,5,5,255538,255538,255614,0,76,255761,true,L-m-0 L-l-0 L-l-0 C-m-2 C-m-1 
job-5120,6,11,5,255618,255618,255680,0,62,255773,true,C-l-1 L-m-0 L-l-0 L-l-0 C-m-2 
job-5119,5,11,2,255580,255580,255700,0,120,255855,true,C-m-0 C-l-1 
job-5122,6,5,3,255723,255723,255736,0,13,256008,true,C-l-1 C-m-0 C-l-2 
job-5121,6,9,6,255676,255680,255742,4,62,255817,true,C-l-1 L-m-0 L-l-0 L-l-0 C-m-2 C-m-1 
job-5123,5,7,1,255774,255774,255931,0,157,256111,true,L-m-0 
job-5125,1,7,6,255882,255882,255944,0,62,255990,true,L-m-0 L-m-0 L-m-0 C-m-2 C-m-2 C-m-1 
job-5127,6,8,5,255973,255973,256062,0,89,256260,true,L-m-0 C-l-1 C-l-1 C-l-2 C-l-2 
job-5124,6,6,4,255835,255835,256159,0,324,256365,true,L-l-0 L-l-0 C-m-2 C-m-1 
job-5130,6,4,2,256120,256159,256184,39,25,256443,true,C-l-2 L-l-0 
job-5129,6,10,5,256064,256064,256203,0,139,256347,true,L-m-0 C-l-0 C-l-1 C-l-1 C-l-2 
job-5131,3,9,7,256170,256184,256218,14,34,256380,true,C-l-2 C-l-2 L-l-0 L-l-0 L-l-0 L-l-0 C-m-2 
job-5128,4,12,2,256016,256016,256225,0,209,256322,true,C-m-0 C-l-0 
job-5126,2,10,7,255931,255931,256242,0,311,256465,true,L-m-0 L-s-0 C-s-0 C-s-1 C-s-2 C-m-0 C-m-0 
job-5132,3,8,8,256225,256225,256242,0,17,256276,true,L-m-0 L-m-0 C-m-0 L-l-0 L-l-0 L-l-0 L-l-0 C-m-2 
job-5134,5,7,3,256327,256327,256395,0,68,256575,true,C-m-2 C-m-1 C-l-1 
job-5133,5,8,4,256266,256266,256396,0,130,256495,true,L-m-0 L-l-0 L-l-0 C-m-0 
job-5136,3,9,5,256431,256431,256453,0,22,256748,true,L-m-0 L-m-0 L-l-0 L-l-0 L-l-0 
job-5137,2,4,4,256484,256484,256533,0,49,256726,true,L-m-0 L-m-0 L-m-0 L-l-0 
job-5135,2,10,6,256374,256374,256543,0,169,256751,true,L-m-0 L-l-0 C-m-0 C-m-2 C-m-1 C-l-1 
job-5138,6,8,3,256522,256522,256618,0,96,256713,true,L-l-0 C-m-0 C-m-2 
job-5139,2,12,2,256566,256566,256695,0,129,256944,true,L-l-0 L-l-0 
job-5140,6,6,2,256627,256627,256702,0,75,256853,true,L-l-0 L-m-0 
job-5142,1,11,5,256725,256725,256757,0,32,256870,true,C-m-2 L-m-0 L-m-0 L-l-0 L-l-0 
job-5141,3,11,7,256668,256668,256766,0,98,256968,true,L-s-0 C-s-0 C-s-1 C-s-2 C-m-0 C-m-0 C-m-2 
job-5143,1,10,3,256786,256786,256838,0,52,256991,true,L-s-0 L-m-0 L-m-0 
job-5144,3,7,6,256845,256845,256878,0,33,257081,true,L-s-0 L-m-0 L-m-0 L-l-0 L-l-0 L-l-0 
job-5146,2,5,1,256932,256932,256984,0,52,257094,true,L-m-0 
job-5145,3,12,4,256901,256901,257043,0,142,257053,true,L-s-0 L-m-0 L-m-0 L-l-0 
job-5148,6,8,8,257032,257032,257105,0,73,257279,true,C-m-0 C-m-2 C-m-1 C-l-1 C-l-1 C-l-0 C-l-0 C-l-2 
job-5150,3,10,4,257155,257155,257193,0,38,257212,true,L-l-0 L-s-0 C-s-2 C-l-2 
job-5152,1,12,3,257253,257253,257272,0,19,257519,true,C-m-2 C-m-2 C-m-1 
job-5149,6,4,8,257100,257105,257350,5,245,257387,true,L-m-0 C-m-0 C-m-2 C-m-1 C-l-1 C-l-1 C-l-0 C-l-0 
job-5151,1,10,5,257205,257205,257362,0,157,257451,true,L-l-0 L-l-0 C-s-1 C-m-0 C-m-0 
job-5153,5,8,8,257304,257350,257380,46,30,257381,true,L-m-0 C-m-0 C-m-2 C-m-1 C-l-1 C-l-1 C-l-0 C-l-0 
job-5147,2,5,8,256988,256988,257395,0,407,257694,true,L-m-0 L-l-0 L-l-0 L-l-0 L-l-0 C-s-0 C-s-0 C-s-1 
job-5155,2,5,7,257418,257418,257450,0,32,257512,true,L-m-0 L-m-0 L-m-0 L-l-0 L-l-0 L-l-0 L-l-0 
job-5154,1,6,6,257359,257359,257573,0,214,257752,true,L-m-0 L-l-0 C-m-2 C-m-2 C-m-2 C-m-1 
job-5156,6,8,8,257462,257462,257591,0,129,257756,true,L-m-0 L-l-0 C-m-1 C-m-0 C-l-1 C-l-1 C-l-0 C-l-0 
job-5159,6,5,4,257613,257613,257654,0,41,257718,true,L-l-0 L-m-0 C-m-1 C-m-0 
job-5157,5,12,4,257513,257513,257663,0,150,257811,true,L-l-0 C-m-2 C-l-2 C-l-2 
job-5158,4,11,1,257551,257551,257793,0,242,258038,true,L-s-0 
job-5162,2,12,5,257763,257763,257803,0,40,257905,true,C-m-1 C-m-1 C-m-0 C-m-0 C-l-2 
job-5163,5,6,7,257805,257805,257824,0,19,258114,true,C-m-1 C-m-0 C-l-2 C-l-2 C-l-1 C-l-1 C-l-0 
job-5164,3,12,4,257865,257865,257937,0,72,258168,true,L-s-0 C-m-1 C-m-1 C-m-0 
job-5160,1,7,8,257682,257682,257969,0,287,257983,true,L-m-0 L-m-0 L-m-0 L-m-0 L-l-0 L-l-0 L-l-0 L-l-0 
job-5165,4,8,7,257912,257912,257977,0,65,258101,true,C-m-0 C-l-2 C-l-2 C-l-2 C-l-1 C-l-1 C-l-1 
job-5166,2,6,6,257959,257959,257978,0,19,258189,true,C-s-1 C-s-0 C-s-2 C-m-0 C-m-0 L-s-0 
job-5161,1,9,8,257722,257722,258016,0,294,258172,true,L-l-0 L-l-0 C-s-1 C-s-0 C-s-2 C-m-2 C-m-2 C-m-2 
job-5168,3,7,1,258061,258061,258073,0,12,258214,true,L-m-0 
job-5169,2,11,4,258127,258127,258161,0,34,258294,true,L-m-0 L-l-0 C-m-0 C-m-1 
job-5167,5,7,5,258015,258015,258165,0,150,258251,true,L-l-0 L-l-0 L-m-0 C-m-0 C-m-1 
job-5170,1,4,8,258182,258182,258208,0,26,258317,true,L-s-0 L-s-0 L-s-0 L-s-0 L-m-0 L-m-0 L-m-0 L-m-0 
job-5171,6,12,5,258227,258227,258243,0,16,258274,true,L-m-0 L-l-0 L-l-0 C-m-0 C-m-1 
job-5172,1,5,8,258291,258291,258324,0,33,258481,true,L-s-0 L-s-0 L-s-0 L-m-0 L-m-0 L-m-0 L-m-0 L-m-0 
job-5174,3,4,1,258377,258377,258397,0,20,258507,true,L-l-0 
job-5176,5,11,6,258502,258502,258579,0,77,258745,true,C-m-0 C-m-1 C-m-2 C-l-2 C-l-2 C-l-1 
job-5173,3,11,3,258337,258337,258586,0,249,258589,true,L-s-0 L-m-0 L-m-0 
job-5175,3,12,3,258442,258442,258609,0,167,258712,true,L-l-0 L-l-0 L-l-0 
job-5179,3,7,3,258625,258625,258661,0,36,258914,true,L-l-0 L-l-0 L-l-0 
job-5180,2,5,8,258672,258672,258683,0,11,258821,true,L-l-0 L-l-0 L-l-0 L-l-0 L-l-0 C-m-0 C-m-1 C-m-1 
job-5178,1,12,1,258582,258582,258738,0,156,258799,true,C-m-0 
job-5181,4,10,6,258739,258739,258800,0,61,259099,true,L-l-0 L-l-0 C-m-0 C-m-1 C-m-2 C-l-1 
job-5177,2,11,7,258546,258546,258809,0,263,259034,true,L-l-0 C-m-0 C-m-1 C-m-2 C-l-2 C-l-1 C-l-1 
job-5182,4,7,7,258782,258782,258814,0,32,258839,true,C-l-1 C-l-2 C-l-2 L-s-0 L-m-0 L-m-0 C-s-1 
job-5183,5,6,8,258831,258831,258842,0,11,259057,true,L-m-0 L-l-0 L-l-0 C-m-0 C-m-1 C-m-2 C-l-1 C-l-1 
job-5184,3,7,6,258879,258879,258909,0,30,259198,true,L-s-0 L-m-0 L-m-0 L-l-0 L-l-0 L-l-0 
job-5185,1,4,1,258932,258932,258950,0,18,259088,true,L-s-0 
job-5186,6,10,7,258982,258982,259053,0,71,259281,true,L-m-0 L-l-0 L-l-0 C-m-0 C-m-1 C-m-2 C-l-1 
job-5188,5,6,7,259067,259067,259159,0,92,259210,true,C-l-1 L-m-0 L-l-0 L-l-0 C-m-0 C-m-1 C-m-2 
job-5187,4,9,8,259027,259027,259167,0,140,259458,true,C-l-1 L-s-0 C-s-1 C-s-0 C-s-2 C-l-2 C-l-2 C-l-2 
job-5189,3,6,8,259118,259118,259183,0,65,259348,true,L-m-0 C-m-0 C-m-1 C-m-2 C-l-1 C-l-0 C-l-0 C-l-0 
job-5190,1,6,8,259167,259167,259200,0,33,259276,true,L-m-0 L-m-0 L-m-0 L-m-0 C-m-0 C-m-0 C-m-0 C-m-0 
job-5191,5,7,8,259212,259212,259223,0,11,259432,true,L-m-0 L-l-0 L-l-0 C-m-0 C-m-1 C-m-2 C-l-0 C-l-0 
job-5192,5,6,6,259254,259254,259266,0,12,259286,true,L-m-0 L-l-0 L-l-0 C-m-0 C-m-1 C-m-2 
job-5193,2,12,4,259309,259309,259432,0,123,259546,true,L-s-0 L-m-0 L-m-0 L-l-0 
job-5195,4,7,6,259390,259390,259441,0,51,259552,true,C-s-0 C-s-2 C-m-0 C-m-0 C-m-1 C-m-1 
job-5196,3,5,2,259436,259436,259448,0,12,259523,true,L-m-0 L-l-0 
job-5197,6,5,6,259496,259496,259561,0,65,259829,true,C-m-0 C-m-1 C-m-2 C-l-0 C-l-0 C-l-1 
job-5194,4,4,4,259349,259349,259563,0,214,259780,true,L-m-0 L-l-0 L-l-0 C-s-1 
job-5199,1,8,6,259597,259597,259682,0,85,259897,true,L-m-0 L-m-0 L-m-0 L-s-0 L-s-0 L-l-0 
job-5198,1,5,1,259544,259544,259697,0,153,259781,true,L-m-0 
job-5200,4,7,6,259651,259651,259706,0,55,259712,true,L-l-0 L-l-0 C-s-1 C-s-0 C-s-2 C-m-0 
job-5202,6,10,4,259747,259747,259762,0,15,259887,true,L-l-0 L-l-0 C-m-0 C-m-1 
job-5203,4,6,3,259791,259791,259837,0,46,260048,true,L-m-0 L-s-0 L-l-0 
job-5201,4,12,1,259695,259695,259895,0,200,260177,true,L-m-0 
job-5205,4,9,6,259892,259892,259909,0,17,260171,true,L-s-0 L-l-0 L-l-0 L-l-0 C-s-1 C-s-0 
job-5204,4,9,1,259837,259837,259924,0,87,260010,true,L-m-0 
job-5208,6,12,8,260028,260028,260055,0,27,260187,true,C-m-0 C-m-1 C-m-2 C-l-0 C-l-0 C-l-1 C-l-1 C-l-2 
job-5207,3,4,5,259977,259977,260106,0,129,260221,true,L-l-0 L-l-0 L-l-0 L-l-0 C-s-1 
job-5206,2,6,5,259937,259937,260129,0,192,260334,true,L-s-0 L-s-0 L-m-0 L-m-0 L-m-0 
job-5210,1,9,4,260128,260128,260167,0,39,260190,true,L-m-0 C-s-0 C-s-2 C-m-0 
job-5209,3,4,8,260069,260069,260293,0,224,260324,true,C-s-0 C-s-2 C-m-0 C-m-0 C-m-1 C-m-1 C-m-2 C-m-2 
job-5211,4,9,8,260184,260184,260312,0,128,260408,true,L-s-0 L-m-0 L-m-0 L-l-0 L-l-0 L-l-0 C-s-1 C-l-0 
job-5212,6,10,8,260228,260293,260469,65,176,260469,false,C-l-0 C-m-0 C-m-1 C-m-2 C-l-1 C-l-1 C-l-2 C-l-2 
job-5216,3,11,3,260410,260469,260501,59,32,260698,true,L-l-0 L-l-0 L-l-0 
job-5214,6,4,5,260320,260469,260520,149,51,260517,false,C-m-0 C-m-1 C-m-2 C-l-0 L-m-0 
job-5215,2,12,2,260367,260469,260592,102,123,260756,true,L-m-0 L-l-0 
job-5217,6,11,7,260469,260520,260635,51,115,260779,true,L-m-0 L-l-0 C-m-0 C-m-1 C-m-2 C-l-0 C-l-1 
job-5218,5,8,5,260512,260635,260693,123,58,260609,false,C-m-0 C-m-1 C-m-2 C-l-0 L-m-0 
job-5213,2,11,7,260272,260312,260701,40,389,260779,true,C-m-0 C-m-1 C-m-2 C-l-0 C-l-0 C-l-0 L-s-0 
job-5222,4,10,3,260714,260714,260739,0,25,260838,true,L-m-0 L-s-0 C-s-1 
job-5221,6,5,7,260665,260701,260784,36,83,261011,true,C-m-0 C-m-1 C-m-2 C-l-0 C-l-0 C-l-1 C-l-1 
job-5220,1,7,8,260619,260635,260879,16,244,260891,true,L-l-0 L-l-0 L-l-0 L-l-0 L-l-0 C-m-0 C-m-1 C-m-2 
job-5225,2,5,7,260873,260873,260890,0,17,260913,true,C-l-2 C-l-2 C-l-2 L-s-0 L-s-0 C-s-1 C-s-1 
job-5224,6,10,8,260804,260804,260902,0,98,260976,true,C-m-0 C-m-1 C-m-2 C-l-0 C-l-0 C-l-1 C-l-1 C-l-2 
job-5219,3,11,2,260563,260635,260911,72,276,261010,true,L-m-0 L-l-0 
job-5226,4,7,8,260914,260914,260949,0,35,261071,true,L-m-0 L-s-0 L-l-0 L-l-0 L-l-0 C-s-1 C-s-0 C-s-2 
job-5223,2,4,2,260758,260758,261024,0,266,261320,true,L-m-0 L-m-0 
job-5227,5,4,6,260967,260967,261106,0,139,261172,true,L-l-0 L-l-0 C-m-0 C-m-1 C-m-2 C-l-0 
job-5228,2,7,7,261028,261028,261134,0,106,261391,true,L-l-0 C-m-0 C-m-1 C-m-2 C-l-0 C-l-0 C-l-0 
job-5229,4,4,1,261080,261080,261138,0,58,261377,true,L-s-0 
job-5230,3,5,7,261129,261129,261178,0,49,261378,true,L-l-0 L-l-0 L-l-0 C-m-0 C-m-0 C-m-1 C-m-1 
job-5232,1,12,1,261233,261233,261251,0,18,261356,true,L-m-0 
job-5231,5,11,7,261178,261178,261544,0,366,261741,true,L-m-0 L-l-0 L-l-0 C-m-0 C-m-1 C-m-2 C-l-0 
job-5233,5,9,6,261286,261544,261767,258,223,261644,false,L-m-0 L-l-0 L-l-0 C-m-0 C-m-1 C-m-2 
job-5237,2,12,1,261499,261767,261779,268,12,261603,false,L-m-0 
job-5236,4,9,2,261446,261767,261786,321,19,261547,false,C-l-1 L-s-0 
job-5235,5,6,1,261384,261767,261816,383,49,261623,false,C-l-1 
job-5238,3,4,2,261541,261767,261823,226,56,261751,false,C-m-0 C-m-1 
job-5234,5,4,8,261331,261767,261961,436,194,261701,false,L-m-0 L-l-0 L-l-0 C-m-0 C-m-1 C-m-2 C-l-0 C-l-0 
job-5239,5,10,7,261597,261961,261993,364,32,261638,false,L-m-0 L-l-0 L-l-0 C-m-0 C-m-1 C-m-2 C-l-0 
job-5241,1,6,6,261705,261961,262017,256,56,261767,false,L-m-0 L-m-0 L-m-0 L-l-0 L-l-0 C-m-0 
job-5240,4,11,8,261652,261961,262037,309,76,261949,false,C-l-0 L-s-0 C-s-1 C-s-0 C-s-2 C-l-1 C-l-1 C-l-1 
job-5243,4,11,8,261807,262037,262073,230,36,261902,false,C-l-0 C-l-2 L-s-0 C-s-1 C-s-0 C-s-2 C-l-1 C-l-1 
job-5245,2,4,8,261908,262073,262086,165,13,261968,false,L-m-0 C-m-0 C-m-1 C-m-2 C-s-1 C-s-1 C-s-0 C-s-0 
job-5244,3,11,5,261852,262073,262095,221,22,261957,false,C-l-0 C-l-0 C-l-2 C-l-2 L-s-0 
job-5248,1,5,2,262063,262073,262105,10,32,262137,true,C-l-1 C-l-1 
job-5247,1,5,7,262011,262073,262152,62,79,262322,true,L-s-0 C-l-1 C-l-1 C-l-1 C-l-1 C-l-1 C-l-1 
job-5242,6,5,8,261757,262017,262218,260,201,262213,false,C-l-0 L-m-0 L-l-0 L-l-0 C-m-0 C-m-1 C-m-2 C-l-2 
job-5250,3,7,7,262156,262218,262241,62,23,262457,true,L-m-0 C-m-0 C-m-1 L-s-0 C-s-1 C-s-0 C-m-2 
job-5249,5,10,7,262098,262218,262275,120,57,262201,false,C-l-1 C-l-1 L-m-0 L-l-0 L-l-0 C-m-0 C-m-1 
job-5246,2,6,3,261956,262073,262296,117,223,262472,true,C-s-2 C-s-2 C-l-1 
job-5251,1,4,1,262218,262218,262296,0,78,262484,true,L-s-0 
job-5253,6,9,2,262319,262319,262336,0,17,262353,true,L-m-0 L-l-0 
job-5255,3,12,2,262419,262419,262457,0,38,262635,true,L-m-0 C-s-2 
job-5256,6,12,4,262464,262464,262558,0,94,262619,true,C-m-0 C-m-1 C-m-2 C-l-1 
job-5254,5,7,3,262371,262371,262576,0,205,262768,true,L-m-0 L-l-0 L-l-0 
job-5252,1,5,2,262267,262267,262580,0,313,262775,true,L-s-0 L-s-0 
job-5257,4,7,1,262529,262529,262627,0,98,262749,true,C-l-1 
job-5258,1,4,4,262585,262585,262641,0,56,262859,true,C-l-1 C-l-1 C-l-1 C-l-1 
job-5261,5,8,1,262737,262737,262771,0,34,262855,true,C-l-0 
job-5260,5,10,7,262683,262683,262842,0,159,262860,true,C-l-1 L-l-0 L-l-0 C-m-0 C-m-1 C-m-2 C-l-0 
job-5259,5,11,2,262638,262638,262882,0,244,263169,true,C-l-1 L-m-0 
job-5264,1,10,8,262890,262890,262924,0,34,263186,true,L-l-0 L-l-0 C-m-0 C-m-0 C-m-1 C-m-1 C-m-2 C-m-2 
job-5265,6,9,3,262945,262945,262996,0,51,263185,true,C-l-1 L-m-0 C-l-2 
job-5266,1,9,6,263019,263019,263060,0,41,263077,true,L-l-0 L-l-0 C-m-0 C-m-0 C-m-1 C-m-1 
job-5263,5,11,7,262826,262842,263070,16,228,263181,true,C-l-1 C-l-0 L-l-0 L-l-0 C-m-0 C-m-1 C-m-2 
job-5262,4,9,2,262780,262780,263142,0,362,263273,true,C-l-0 L-s-0 
job-5268,3,9,1,263118,263118,263154,0,36,263290,true,L-l-0 
job-5267,2,9,8,263074,263074,263211,0,137,263306,true,C-l-0 C-l-0 C-l-0 C-l-0 L-m-0 L-m-0 L-m-0 L-l-0 
job-5271,2,10,2,263274,263274,263333,0,59,263531,true,L-s-0 L-m-0 
job-5269,6,10,2,263170,263170,263343,0,173,263380,true,L-l-0 C-m-0 
job-5270,2,7,4,263218,263218,263365,0,147,263372,true,L-l-0 L-l-0 L-l-0 C-m-0 
job-5273,2,12,6,263375,263375,263402,0,27,263595,true,L-m-0 C-m-1 C-m-2 L-s-0 L-l-0 L-l-0 
job-5272,6,6,3,263322,263322,263475,0,153,263623,true,L-m-0 C-m-1 C-m-2 
job-5275,4,8,8,263466,263466,263519,0,53,263694,true,C-s-2 C-s-1 C-s-0 C-m-0 C-m-0 C-l-0 C-l-0 C-l-0 
job-5276,5,10,4,263523,263523,263535,0,12,263802,true,L-m-0 C-m-1 C-m-2 C-m-0 
job-5277,3,8,3,263578,263578,263640,0,62,263840,true,L-m-0 L-m-0 C-s-2 
job-5279,1,9,7,263665,263665,263675,0,10,263808,true,C-m-1 C-m-1 C-m-2 C-m-2 C-m-0 C-m-0 C-l-0 
job-5278,5,8,4,263615,263615,263678,0,63,263813,true,C-m-1 C-m-2 C-m-0 C-l-0 
job-5280,5,6,5,263712,263712,263847,0,135,263858,true,L-m-0 C-m-1 C-m-2 C-m-0 C-l-0 
job-5281,3,11,7,263758,263758,263908,0,150,263948,true,L-m-0 C-m-1 C-m-2 C-m-0 C-l-0 C-l-0 C-s-2 
job-5282,5,9,4,263814,263814,263917,0,103,264123,true,C-l-1 C-l-1 C-l-2 C-l-2 
job-5286,5,9,2,264035,264035,264066,0,31,264121,true,C-l-2 C-l-2 
job-5283,1,10,8,263870,263870,264086,0,216,264303,true,L-m-0 L-m-0 C-m-1 C-m-1 C-m-2 C-m-2 C-m-0 C-m-0 
job-5284,2,6,7,263924,263924,264091,0,167,264307,true,L-m-0 L-m-0 C-m-1 C-m-1 C-m-2 C-m-2 C-m-0 
job-5274,3,11,5,263420,263420,264142,0,722,264172,true,L-s-0 L-l-0 L-l-0 L-l-0 L-l-0 
job-5285,6,4,2,263981,263981,264150,0,169,264246,true,C-l-1 C-l-1 
job-5289,3,7,1,264169,264169,264181,0,12,264376,true,L-m-0 
job-5288,2,6,1,264120,264120,264197,0,77,264477,true,L-m-0 
job-5287,1,8,6,264077,264077,264228,0,151,264422,true,C-s-2 C-s-2 C-s-1 C-s-1 C-s-0 C-s-0 
job-5290,3,10,5,264211,264211,264246,0,35,264262,true,L-s-0 L-m-0 L-m-0 L-l-0 L-l-0 
job-5292,3,4,8,264309,264309,264324,0,15,264425,true,L-l-0 L-l-0 L-s-0 C-s-2 C-s-1 C-s-0 C-m-1 C-m-1 
job-5291,6,9,2,264274,264274,264332,0,58,264447,true,L-m-0 L-l-0 
job-5293,4,5,5,264360,264360,264518,0,158,264709,true,L-s-0 L-m-0 L-m-0 L-l-0 L-l-0 
job-5294,5,9,7,264411,264411,264521,0,110,264805,true,C-m-1 C-m-2 C-m-0 C-l-1 C-l-1 C-l-2 C-l-2 
job-5295,1,11,2,264471,264471,264563,0,92,264638,true,L-l-0 L-l-0 
job-5296,3,7,4,264527,264527,264602,0,75,264792,true,L-l-0 L-l-0 L-l-0 L-s-0 
job-5298,4,8,5,264616,264616,264649,0,33,264698,true,L-s-0 L-l-0 L-l-0 L-l-0 C-s-0 
job-5299,1,11,6,264665,264665,264701,0,36,264936,true,L-s-0 L-l-0 L-l-0 L-l-0 L-l-0 C-s-0 
job-5297,4,6,4,264564,264564,264726,0,162,264765,true,L-m-0 L-m-0 C-s-2 C-s-1 
job-5300,2,10,4,264713,264713,264736,0,23,264741,true,L-s-0 L-l-0 L-l-0 L-l-0 
job-5301,2,10,3,264752,264752,264924,0,172,265080,true,L-s-0 L-m-0 L-m-0 
job-5302,5,11,8,264801,264801,264984,0,183,265249,true,L-l-0 L-l-0 C-m-1 C-m-2 C-m-0 C-l-1 C-l-1 C-l-2 
job-5305,1,12,5,264950,264950,264987,0,37,265285,true,L-m-0 C-m-1 C-m-2 C-m-0 C-l-2 
job-5304,2,5,6,264904,264904,264998,0,94,265287,true,L-s-0 L-l-0 C-m-1 C-m-2 C-m-0 C-l-1 
job-5303,4,12,8,264850,264850,265005,0,155,265127,true,L-m-0 C-l-2 C-s-2 C-s-1 C-s-0 C-l-0 C-l-0 C-l-0 
job-5306,3,11,8,265000,265000,265025,0,25,265233,true,L-m-0 C-l-2 C-l-2 L-s-0 L-l-0 L-l-0 L-l-0 L-l-0 
job-5307,5,8,5,265045,265045,265131,0,86,265370,true,L-m-0 L-l-0 L-l-0 C-m-1 C-m-2 
job-5309,5,5,6,265131,265131,265166,0,35,265364,true,L-m-0 L-l-0 L-l-0 C-m-1 C-m-2 C-m-0 
job-5308,1,5,1,265087,265087,265200,0,113,265417,true,L-m-0 
job-5311,3,6,6,265231,265231,265268,0,37,265392,true,L-m-0 L-l-0 L-l-0 C-s-2 C-s-1 C-s-0 
job-5310,2,12,5,265180,265180,265301,0,121,265420,true,L-m-0 L-m-0 L-s-0 L-l-0 L-l-0 
job-5312,2,6,5,265271,265271,265374,0,103,265648,true,L-m-0 L-l-0 L-l-0 L-l-0 L-l-0 
job-5314,6,5,5,265384,265384,265439,0,55,265664,true,L-l-0 L-l-0 C-m-2 C-m-0 C-l-0 
job-5315,5,9,7,265436,265439,265517,3,78,265614,true,L-l-0 L-l-0 C-m-2 C-m-0 C-l-0 C-l-0 C-l-2 
job-5316,5,10,4,265491,265517,265532,26,15,265682,true,L-l-0 L-l-0 C-m-2 C-m-0 
job-5313,5,4,2,265324,265324,265557,0,233,265662,true,L-m-0 C-m-1 
job-5317,5,6,3,265538,265538,265628,0,90,265751,true,L-l-0 L-l-0 C-m-2 
job-5319,3,12,1,265644,265644,265654,0,10,265823,true,L-m-0 
job-5318,5,6,6,265586,265586,265713,0,127,265854,true,L-m-0 C-m-1 C-m-0 C-l-0 C-l-0 C-l-2 
job-5320,5,8,6,265700,265700,265737,0,37,265782,true,C-l-2 L-l-0 L-l-0 C-m-2 C-l-1 C-l-1 
job-5321,4,9,4,265752,265752,265764,0,12,265871,true,L-s-0 L-m-0 L-m-0 L-l-0 
job-5323,1,12,8,265842,265842,265853,0,11,265895,true,L-l-0 C-s-2 C-s-1 C-s-0 C-m-1 C-m-1 C-m-0 C-m-0 
job-5322,3,11,6,265792,265792,265957,0,165,266050,true,L-s-0 L-m-0 L-m-0 L-l-0 L-l-0 L-l-0 
job-5325,6,9,8,265931,265931,265965,0,34,266042,true,C-m-1 C-m-0 C-m-2 C-l-0 C-l-0 C-l-2 C-l-2 C-l-1 
job-5326,6,5,4,265972,265972,266030,0,58,266061,true,L-m-0 L-l-0 C-m-1 C-m-0 
job-5324,1,6,4,265885,265885,266058,0,173,266352,true,L-m-0 L-l-0 L-l-0 C-s-2 
job-5327,4,10,5,266025,266025,266080,0,55,266081,true,L-l-0 L-s-0 C-s-1 C-s-0 C-m-2 
job-5329,4,11,1,266144,266144,266202,0,58,266224,true,L-m-0 
job-5328,1,8,4,266087,266087,266205,0,118,266405,true,L-s-0 L-s-0 L-m-0 L-m-0 
job-5330,5,9,3,266201,266201,266227,0,26,266258,true,L-l-0 L-l-0 C-m-1 
job-5331,1,4,2,266261,266261,266302,0,41,266447,true,L-s-0 L-s-0 
job-5332,3,4,7,266314,266314,266404,0,90,266492,true,L-s-0 L-m-0 L-m-0 L-l-0 L-l-0 L-l-0 L-l-0 
job-5334,3,8,2,266421,266421,266484,0,63,266594,true,C-m-1 C-m-0 
job-5335,3,4,8,266465,266465,266489,0,24,266693,true,C-m-2 C-l-1 C-l-1 L-s-0 L-m-0 L-m-0 L-l-0 L-l-0 
job-5333,5,9,8,266371,266371,266500,0,129,266589,true,C-m-1 C-m-0 C-m-2 C-l-0 C-l-0 C-l-2 C-l-2 C-l-1 
job-5337,2,4,7,266574,266574,266594,0,20,266827,true,L-m-0 L-l-0 C-m-1 L-s-0 L-s-0 C-s-2 C-s-2 
job-5336,5,6,4,266524,266524,266665,0,141,266774,true,L-m-0 L-l-0 L-l-0 C-m-1 
job-5338,5,11,8,266614,266614,266700,0,86,266748,true,C-m-0 C-m-2 C-l-0 C-l-0 C-l-2 C-l-2 C-l-1 C-l-1 
job-5339,2,4,8,266677,266677,266742,0,65,266878,true,C-m-0 C-m-2 C-l-0 C-l-2 C-l-1 L-s-0 L-s-0 L-m-0 
job-5341,3,7,4,266767,266767,266782,0,15,266850,true,C-l-0 C-l-0 C-l-0 L-s-0 
job-5340,3,12,7,266720,266720,266788,0,68,266870,true,L-m-0 L-m-0 C-m-0 C-m-0 C-m-2 C-m-2 C-l-0 
job-5342,4,9,6,266819,266819,266829,0,10,266915,true,L-s-0 L-m-0 L-m-0 L-l-0 L-l-0 L-l-0 
job-5343,4,10,7,266874,266874,266904,0,30,267141,true,L-s-0 L-m-0 L-m-0 L-l-0 L-l-0 L-l-0 C-s-2 
job-5344,6,4,3,266917,266917,267021,0,104,267277,true,L-m-0 L-l-0 L-l-0 
job-5346,3,7,3,267016,267016,267161,0,145,267292,true,C-s-0 C-m-0 C-m-0 
job-5348,2,8,6,267103,267103,267180,0,77,267242,true,L-m-0 L-l-0 L-l-0 L-l-0 L-l-0 C-m-0 
job-5349,4,7,8,267145,267145,267192,0,47,267396,true,C-m-2 C-m-2 C-m-1 C-m-1 C-l-0 C-l-0 C-l-0 C-l-2 
job-5347,3,11,1,267058,267058,267201,0,143,267258,true,L-l-0 
job-5351,4,11,4,267247,267247,267302,0,55,267352,true,L-l-0 L-l-0 C-s-0 C-m-0 
job-5352,6,11,1,267297,267297,267336,0,39,267356,true,C-m-2 
job-5353,2,8,3,267344,267344,267370,0,26,267472,true,L-l-0 L-l-0 L-l-0 
job-5345,1,12,5,266965,266965,267418,0,453,267546,true,L-m-0 L-m-0 L-s-0 C-s-2 C-s-1 
job-5350,4,4,2,267193,267193,267434,0,241,267439,true,L-m-0 L-l-0 
job-5354,5,7,6,267394,267394,267448,0,54,267612,true,L-l-0 C-m-0 C-m-2 C-m-1 C-l-0 C-l-0 
job-5355,6,7,1,267438,267438,267582,0,144,267781,true,L-l-0 
job-5357,2,12,4,267548,267548,267611,0,63,267901,true,L-m-0 L-m-0 C-s-2 C-s-1 
job-5358,4,7,5,267603,267603,267626,0,23,267755,true,L-l-0 C-s-0 C-m-0 C-m-0 C-m-2 
job-5356,2,4,6,267488,267488,267804,0,316,267987,true,L-l-0 L-l-0 L-l-0 L-s-0 L-s-0 L-m-0 
job-5361,1,11,1,267755,267755,267829,0,74,267897,true,C-s-2 
job-5362,3,7,3,267799,267799,267841,0,42,268105,true,C-s-0 C-m-0 C-m-0 
job-5359,2,6,3,267648,267648,267880,0,232,268170,true,L-m-0 L-m-0 L-m-0 
job-5363,6,4,3,267859,267859,267950,0,91,268223,true,L-l-0 C-m-0 C-m-2 
job-5364,3,9,2,267906,267906,267966,0,60,268008,true,L-s-0 L-m-0 
job-5360,3,5,4,267698,267698,267978,0,280,268263,true,L-l-0 L-l-0 C-s-2 C-s-1 
job-5366,2,9,8,267991,267991,268018,0,27,268044,true,C-m-1 C-l-2 C-l-2 C-l-2 L-s-0 L-m-0 L-m-0 L-m-0 
job-5365,6,6,4,267945,267945,268047,0,102,268228,true,C-m-1 C-l-0 C-l-0 C-l-2 
job-5367,2,5,4,268042,268042,268086,0,44,268230,true,C-m-1 C-l-2 C-l-2 C-l-2 
job-5368,2,8,8,268107,268107,268190,0,83,268314,true,L-s-0 L-s-0 L-m-0 L-m-0 L-m-0 L-m-0 L-l-0 L-l-0 
job-5369,4,4,5,268156,268156,268240,0,84,268447,true,L-l-0 L-l-0 C-s-2 C-s-1 C-s-0 
job-5370,6,10,1,268206,268206,268294,0,88,268340,true,L-m-0 
job-5372,2,7,3,268296,268296,268313,0,17,268578,true,L-m-0 L-m-0 L-m-0 
job-5373,3,6,4,268351,268351,268453,0,102,268540,true,L-m-0 L-m-0 C-s-0 C-m-1 
job-5371,4,4,6,268251,268251,268516,0,265,268813,true,L-s-0 L-l-0 L-l-0 L-l-0 C-s-2 C-s-1 
job-5376,5,7,2,268509,268509,268523,0,14,268787,true,C-l-2 C-l-1 
job-5375,5,5,5,268459,268459,268593,0,134,268675,true,L-m-0 C-m-2 C-l-0 C-l-0 C-l-2 
job-5377,6,6,1,268565,268565,268674,0,109,268839,true,C-l-2 
job-5381,4,8,7,268782,268782,268800,0,18,268939,true,L-l-0 L-l-0 C-s-2 C-s-1 C-s-0 C-m-2 C-m-2 
job-5374,2,7,6,268404,268404,268812,0,408,268855,true,L-m-0 C-m-1 C-m-1 C-m-0 C-m-0 C-m-0 
job-5379,4,9,2,268670,268670,268843,0,173,268864,true,C-m-1 C-l-2 
job-5382,6,7,8,268828,268828,268886,0,58,269130,true,L-m-0 L-l-0 C-m-0 C-m-2 C-l-0 C-l-0 C-l-1 C-l-1 
job-5380,4,8,4,268726,268726,268894,0,168,269125,true,C-l-2 C-l-2 L-s-0 L-l-0 
job-5378,1,9,3,268624,268624,268930,0,306,269213,true,L-m-0 L-m-0 C-m-0 
job-5383,2,6,5,268882,268882,268977,0,95,269135,true,L-l-0 C-m-2 C-l-2 C-l-2 C-s-2 
job-5384,4,6,8,268933,268933,268977,0,44,269259,true,L-l-0 L-l-0 C-m-2 C-l-2 C-l-2 L-s-0 L-m-0 L-m-0 
job-5385,4,10,3,268982,268982,269010,0,28,269253,true,L-s-0 L-m-0 L-m-0 
job-5386,6,9,7,269028,269028,269049,0,21,269263,true,L-m-0 L-l-0 L-l-0 C-m-2 C-m-0 C-m-1 C-l-2 
job-5388,5,9,4,269119,269119,269143,0,24,269168,true,C-l-0 C-l-0 C-l-1 C-l-1 
job-5389,3,5,8,269174,269174,269345,0,171,269393,true,L-s-0 C-s-2 C-s-1 C-s-0 C-l-0 C-l-0 C-l-0 C-l-0 
job-5387,6,4,8,269078,269078,269434,0,356,269648,true,L-m-0 L-l-0 L-l-0 C-m-2 C-m-0 C-m-1 C-l-2 C-l-2 
job-5390,5,4,5,269230,269434,269444,204,10,269318,false,L-m-0 L-l-0 L-l-0 C-m-2 C-m-0 
job-5391,1,10,4,269283,269434,269445,151,11,269387,false,L-m-0 L-m-0 L-l-0 L-l-0 
job-5394,5,5,7,269426,269434,269479,8,45,269514,true,C-m-1 C-l-2 C-l-2 C-l-0 C-l-0 C-l-1 C-l-1 
job-5393,2,10,3,269369,269434,269490,65,56,269718,true,C-m-2 C-m-0 C-m-1 
job-5392,4,6,4,269318,269434,269526,116,92,269587,true,L-s-0 C-s-2 C-s-1 C-s-0 
job-5396,1,4,6,269523,269523,269604,0,81,269850,true,L-m-0 L-m-0 C-m-2 C-m-2 C-m-0 C-m-0 
job-5395,3,4,6,269474,269474,269674,0,200,269710,true,C-m-2 C-m-2 C-m-0 C-m-0 L-m-0 L-m-0 
job-5400,2,4,3,269729,269729,269742,0,13,270019,true,L-s-0 L-m-0 L-m-0 
job-5397,2,12,8,269576,269576,269769,0,193,270061,true,L-s-0 L-l-0 L-l-0 L-l-0 L-l-0 C-s-2 C-s-1 C-s-0 
job-5399,2,7,4,269671,269671,269780,0,109,269991,true,L-m-0 C-m-2 C-m-0 C-m-1 
job-5398,6,6,7,269622,269622,269844,0,222,269852,true,C-m-1 C-l-2 C-l-2 C-l-0 C-l-0 C-l-1 C-l-1 
job-5401,1,10,5,269778,269778,269976,0,198,270255,true,L-m-0 L-m-0 C-m-2 C-m-2 C-m-0 
job-5403,2,12,2,269870,269870,269988,0,118,270280,true,C-m-2 C-m-0 
job-5405,4,11,8,269972,269972,270008,0,36,270085,true,C-s-2 C-s-1 C-s-0 C-m-1 C-m-1 C-l-2 C-l-2 C-l-2 
job-5402,3,6,2,269823,269823,270022,0,199,270257,true,L-m-0 L-m-0 
job-5406,3,6,2,270022,270022,270064,0,42,270147,true,C-m-0 L-m-0 
job-5407,2,12,8,270062,270062,270188,0,126,270216,true,L-m-0 L-m-0 C-s-2 C-s-1 C-s-0 C-m-2 C-m-2 C-m-1 
job-5404,4,6,5,269919,269919,270214,0,295,270225,true,C-m-0 L-s-0 L-l-0 L-l-0 L-l-0 
job-5411,3,9,6,270273,270273,270289,0,16,270576,true,L-m-0 C-m-0 C-m-1 C-m-2 L-s-0 C-s-2 
job-5408,4,12,1,270118,270118,270303,0,185,270366,true,C-m-0 
job-5409,4,11,4,270172,270172,270333,0,161,270410,true,C-m-1 C-l-2 C-l-2 C-l-2 
job-5410,5,7,6,270229,270229,270352,0,123,270541,true,L-m-0 L-l-0 L-l-0 C-m-2 C-l-0 C-l-0 
job-5412,5,9,6,270320,270333,270362,13,29,270524,true,C-m-1 C-m-0 C-l-2 C-l-2 C-l-1 C-l-1 
job-5414,3,9,2,270420,270420,270432,0,12,270638,true,L-s-0 C-s-2 
job-5415,1,4,7,270460,270460,270489,0,29,270669,true,L-m-0 L-m-0 C-m-2 C-m-2 L-s-0 L-s-0 L-s-0 
job-5413,6,6,4,270361,270361,270638,0,277,270895,true,L-m-0 L-l-0 L-l-0 C-m-2 
job-5417,2,8,7,270559,270559,270708,0,149,270979,true,L-m-0 C-m-1 C-m-0 C-m-2 C-l-0 C-l-0 C-l-0 
job-5419,3,8,8,270673,270708,270729,35,21,270938,true,C-l-0 C-l-0 L-l-0 L-l-0 L-l-0 L-l-0 C-s-2 C-s-1 
job-5420,3,6,6,270736,270736,270804,0,68,270826,true,C-l-0 C-l-0 L-l-0 L-l-0 L-l-0 L-l-0 
job-5416,6,8,7,270509,270509,270914,0,405,271108,true,C-m-1 C-m-0 C-l-2 C-l-2 C-l-1 C-l-1 C-l-0 
job-5421,6,4,8,270782,270914,270942,132,28,270900,false,L-l-0 L-l-0 C-m-1 C-m-0 C-l-2 C-l-2 C-l-1 C-l-1 
job-5423,2,12,1,270882,270942,270972,60,30,270995,true,L-m-0 
job-5418,3,7,5,270611,270638,271043,27,405,271166,true,L-m-0 L-m-0 C-m-2 C-m-2 L-s-0 
job-5425,2,9,4,270986,270986,271065,0,79,271205,true,L-m-0 C-s-1 C-s-0 C-m-0 
job-5422,6,7,3,270829,270942,271072,113,130,270964,false,L-l-0 L-l-0 C-m-1 
job-5426,1,5,2,271033,271033,271113,0,80,271258,true,L-s-0 C-s-1 
job-5428,2,6,6,271137,271137,271160,0,23,271249,true,L-s-0 L-m-0 L-m-0 L-m-0 C-s-1 L-l-0 
job-5427,1,10,6,271079,271079,271185,0,106,271247,true,L-s-0 C-s-1 C-m-1 C-m-2 C-m-2 L-m-0 
job-5430,4,10,4,271235,271235,271265,0,30,271514,true,L-l-0 L-s-0 C-s-1 C-s-0 
job-5429,6,4,4,271193,271193,271268,0,75,271549,true,C-m-1 C-m-2 L-m-0 L-l-0 
job-5424,1,11,4,270934,270942,271284,8,342,271502,true,C-m-2 C-m-1 C-m-1 C-s-2 
job-5432,5,5,4,271344,271344,271398,0,54,271502,true,L-l-0 C-m-1 C-m-2 C-m-0 
job-5431,2,9,6,271292,271292,271417,0,125,271654,true,L-s-0 L-m-0 L-m-0 L-m-0 L-l-0 L-l-0 
job-5433,5,5,3,271391,271391,271467,0,76,271517,true,C-l-2 C-l-2 C-l-1 
job-5435,5,4,2,271498,271498,271546,0,48,271767,true,C-l-2 C-l-2 
job-5436,6,6,3,271545,271545,271567,0,22,271730,true,L-m-0 L-l-0 L-l-0 
job-5437,6,11,3,271600,271600,271720,0,120,271926,true,C-l-2 L-m-0 L-l-0 
job-5439,1,9,3,271694,271694,271753,0,59,272026,true,L-m-0 L-m-0 C-l-2 
job-5438,6,6,1,271649,271649,271763,0,114,272020,true,L-l-0 
job-5434,1,5,2,271434,271434,271764,0,330,271835,true,C-l-2 C-l-2 
job-5440,5,10,8,271732,271732,271774,0,42,271918,true,L-m-0 L-l-0 C-l-2 C-m-1 C-m-2 C-m-0 C-l-1 C-l-1 
job-5441,4,11,7,271792,271792,271891,0,99,272019,true,L-s-0 L-m-0 L-m-0 L-l-0 L-l-0 L-l-0 C-s-2 
job-5442,4,7,8,271829,271829,271919,0,90,272181,true,C-s-1 C-s-0 C-m-1 C-m-1 C-m-2 C-m-2 C-m-0 C-m-0 
job-5444,4,4,5,271927,271927,271970,0,43,272115,true,C-l-1 L-s-0 L-m-0 L-m-0 L-l-0 
job-5445,6,12,3,271979,271979,271989,0,10,272254,true,C-l-1 L-m-0 L-l-0 
job-5443,3,8,6,271872,271872,272030,0,158,272242,true,C-l-2 C-l-2 C-l-2 C-l-2 C-l-1 C-l-1 
job-5446,6,5,8,272019,272019,272063,0,44,272277,true,C-l-1 L-m-0 L-l-0 L-l-0 C-m-1 C-m-2 C-m-0 C-l-0 
job-5447,4,4,6,272086,272086,272107,0,21,272128,true,L-s-0 L-m-0 L-m-0 L-l-0 L-l-0 L-l-0 
job-5450,1,7,4,272248,272248,272277,0,29,272466,true,L-s-0 L-m-0 C-s-2 C-s-2 
job-5449,4,11,4,272195,272195,272355,0,160,272636,true,L-m-0 L-l-0 L-l-0 L-l-0 
job-5448,3,6,2,272140,272140,272375,0,235,272448,true,L-s-0 L-m-0 
job-5453,4,4,1,272379,272379,272439,0,60,272509,true,L-s-0 
job-5452,3,9,3,272326,272326,272499,0,173,272545,true,C-l-0 C-l-0 C-s-2 
job-5451,6,7,8,272291,272291,272538,0,247,272675,true,C-m-1 C-m-2 C-m-0 C-l-2 C-l-2 C-l-1 C-l-1 C-l-0 
job-5454,5,5,5,272422,272538,272591,116,53,272705,true,L-m-0 L-l-0 L-l-0 C-m-1 C-m-2 
job-5456,3,5,7,272519,272538,272604,19,66,272852,true,L-m-0 C-m-0 C-m-1 C-m-2 C-l-1 C-l-1 L-s-0 
job-5455,5,11,4,272468,272538,272628,70,90,272649,true,C-m-0 C-l-2 C-l-2 C-l-1 
job-5458,4,11,8,272619,272619,272661,0,42,272898,true,C-l-1 C-l-0 L-s-0 L-m-0 L-m-0 L-l-0 L-l-0 L-l-0 
job-5461,3,9,7,272771,272771,272826,0,55,272939,true,L-m-0 L-l-0 L-l-0 L-l-0 L-l-0 C-s-2 C-s-1 
job-5459,1,10,1,272665,272665,272865,0,200,272943,true,C-l-0 
job-5457,5,8,1,272572,272572,272865,0,293,272943,true,C-l-0 
job-5463,1,6,1,272879,272879,272928,0,49,273145,true,L-l-0 
job-5460,3,11,4,272723,272723,272989,0,266,273259,true,C-l-0 C-l-0 L-s-0 L-m-0 
job-5464,6,11,8,272939,272939,272990,0,51,273101,true,L-l-0 C-l-0 C-m-0 C-m-1 C-m-2 C-l-2 C-l-2 C-l-1 
job-5465,1,8,1,272994,272994,273016,0,22,273123,true,L-m-0 
job-5462,1,6,8,272830,272830,273062,0,232,273110,true,L-m-0 L-m-0 L-m-0 L-l-0 L-l-0 L-l-0 L-l-0 L-l-0 
job-5467,2,7,6,273087,273087,273098,0,11,273367,true,L-m-0 L-m-0 L-l-0 L-l-0 L-l-0 C-s-0 
job-5466,3,7,6,273040,273040,273111,0,71,273155,true,L-m-0 L-l-0 L-l-0 L-s-0 C-s-2 C-s-1 
job-5468,6,6,3,273139,273139,273224,0,85,273514,true,L-m-0 L-l-0 L-l-0 
job-5469,6,8,8,273187,273187,273283,0,96,273556,true,C-m-0 C-m-1 C-m-2 C-l-0 C-l-0 C-l-2 C-l-2 C-l-1 
job-5471,1,8,3,273280,273280,273339,0,59,273500,true,C-m-0 C-m-0 C-m-1 
job-5472,5,4,5,273328,273328,273433,0,105,273577,true,C-m-0 C-m-1 C-l-1 L-m-0 L-l-0 
job-5473,4,8,4,273390,273390,273498,0,108,273675,true,L-l-0 L-s-0 C-s-2 C-s-1 
job-5474,2,11,4,273434,273434,273540,0,106,273734,true,L-l-0 L-l-0 L-l-0 C-l-1 
job-5476,4,6,6,273518,273518,273582,0,64,273607,true,L-l-0 L-s-0 L-m-0 L-m-0 C-s-2 C-s-1 
job-5470,6,6,1,273231,273231,273611,0,380,273753,true,C-l-1 
job-5478,1,10,7,273619,273619,273667,0,48,273703,true,L-l-0 L-l-0 L-l-0 L-l-0 C-m-0 C-m-0 C-m-1 
job-5477,5,5,8,273570,273570,273670,0,100,273810,true,L-l-0 C-m-0 C-m-1 C-m-2 C-l-0 C-l-0 C-l-2 C-l-2 
job-5475,3,6,1,273481,273481,273700,0,219,273752,true,C-l-1 
job-5479,5,7,7,273665,273670,273728,5,58,273863,true,C-l-1 L-m-0 L-l-0 L-l-0 C-m-0 C-m-1 C-m-2 
job-5480,2,11,1,273711,273711,273751,0,40,273913,true,L-m-0 
job-5481,3,7,1,273765,273765,273826,0,61,273912,true,L-s-0 
job-5482,2,7,6,273822,273822,273908,0,86,273922,true,L-m-0 L-m-0 L-m-0 L-m-0 L-l-0 L-l-0 
job-5483,1,4,7,273869,273869,273919,0,50,273927,true,L-l-0 L-l-0 L-l-0 L-l-0 L-l-0 L-l-0 L-l-0 
job-5484,2,10,7,273911,273911,273922,0,11,274170,true,L-l-0 L-l-0 L-s-0 L-m-0 L-m-0 L-m-0 C-s-2 
job-5485,6,4,1,273967,273967,273999,0,32,274195,true,L-m-0 
job-5486,3,8,6,274029,274029,274066,0,37,274348,true,L-s-0 L-m-0 L-m-0 L-l-0 L-l-0 L-l-0 
job-5487,5,10,4,274078,274078,274136,0,58,274394,true,L-m-0 L-l-0 L-l-0 C-m-0 
job-5488,1,9,4,274122,274122,274171,0,49,274361,true,L-m-0 L-m-0 L-l-0 L-l-0 
job-5490,6,9,7,274203,274203,274250,0,47,274506,true,C-m-0 C-m-1 C-m-2 C-l-1 C-l-1 C-l-0 C-l-0 
job-5492,3,7,5,274291,274291,274314,0,23,274396,true,L-l-0 C-m-0 C-m-1 C-m-2 C-l-1 
job-5489,3,7,6,274162,274162,274317,0,155,274467,true,L-m-0 L-m-0 L-l-0 L-l-0 L-l-0 L-s-0 
job-5494,4,10,7,274392,274392,274409,0,17,274591,true,C-l-0 L-s-0 C-s-2 C-s-1 C-s-0 C-l-2 C-l-2 
job-5491,5,4,4,274254,274254,274473,0,219,274742,true,C-m-0 C-m-1 C-m-2 C-l-1 
job-5493,5,4,5,274341,274341,274475,0,134,274670,true,C-l-1 L-m-0 L-l-0 L-l-0 C-l-0 
job-5495,6,10,7,274440,274473,274754,33,281,275020,true,C-l-1 C-l-0 C-m-0 C-m-1 C-m-2 C-l-2 C-l-2 
job-5498,4,9,1,274580,274754,274772,174,18,274803,true,C-l-2 
job-5499,6,8,4,274623,274754,274778,131,24,274934,true,C-l-1 C-l-1 C-l-0 C-l-0 
job-5497,3,4,2,274535,274754,274798,219,44,274846,true,L-m-0 C-m-0 
job-5496,5,4,7,274491,274754,274879,263,125,274851,false,L-m-0 L-l-0 L-l-0 C-m-0 C-m-1 C-m-2 C-l-2 
job-5500,5,6,7,274668,274879,275044,211,165,274944,false,L-m-0 L-l-0 L-l-0 C-m-0 C-m-1 C-m-2 C-l-2 
job-5501,4,4,8,274712,274879,275044,167,165,275136,true,C-l-2 L-s-0 C-s-2 C-s-1 C-s-0 C-l-1 C-l-1 C-l-1 
job-5504,4,7,5,274869,275044,275072,175,28,275155,true,C-l-0 C-l-2 L-s-0 C-s-2 C-s-1 
job-5506,3,6,6,274972,275072,275100,100,28,275176,true,C-l-0 C-l-0 C-l-2 C-l-2 L-s-0 C-s-2 
job-5505,4,11,1,274920,275044,275111,124,67,275071,false,C-s-0 
job-5502,6,7,5,274762,275044,275124,282,80,274859,false,C-l-2 L-m-0 L-l-0 L-l-0 C-m-0 
job-5503,3,12,6,274811,275044,275124,233,80,274938,false,C-m-1 C-m-1 C-m-2 C-m-2 C-l-0 C-l-0 
job-5507,2,6,4,275013,275072,275161,59,89,275112,false,L-m-0 C-m-1 C-m-2 C-m-0 
job-5510,4,7,4,275164,275164,275217,0,53,275270,true,L-l-0 C-l-0 L-s-0 C-s-0 
job-5511,2,8,5,275218,275218,275255,0,37,275257,true,L-m-0 L-l-0 L-l-0 L-l-0 C-m-0 
job-5508,2,10,3,275068,275072,275274,4,202,275470,true,C-s-1 C-l-1 C-l-1 
job-5513,6,9,3,275300,275300,275341,0,41,275638,true,C-l-1 C-m-2 C-l-2 
job-5509,5,6,5,275122,275124,275382,2,258,275413,true,L-m-0 C-m-0 C-l-0 C-l-1 L-l-0 
job-5512,5,12,3,275262,275262,275415,0,153,275417,true,L-l-0 C-l-0 C-m-1 
job-5515,1,4,1,275406,275406,275457,0,51,275606,true,L-m-0 
job-5517,1,8,6,275509,275509,275541,0,32,275726,true,L-m-0 L-m-0 L-m-0 L-l-0 L-l-0 C-m-0 
job-5514,5,5,6,275355,275382,275552,27,170,275783,true,L-l-0 C-l-0 L-m-0 C-m-0 C-m-2 C-l-1 
job-5516,5,9,2,275469,275469,275588,0,119,275821,true,L-l-0 C-l-0 
job-5518,2,7,4,275551,275551,275593,0,42,275618,true,L-m-0 L-l-0 C-m-0 C-m-2 
job-5519,4,9,2,275599,275599,275644,0,45,275919,true,L-s-0 L-m-0 
job-5520,2,12,6,275659,275659,275742,0,83,275905,true,L-s-0 L-m-0 L-m-0 L-l-0 L-l-0 L-l-0 
job-5523,4,6,5,275820,275820,275836,0,16,276094,true,L-m-0 C-l-1 L-s-0 C-s-1 C-s-0 
job-5522,6,8,7,275765,275765,275855,0,90,276125,true,L-l-0 C-m-0 C-m-2 C-m-1 C-l-0 C-l-0 C-l-1 
job-5524,2,5,3,275867,275867,275881,0,14,276009,true,L-m-0 L-m-0 L-l-0 
job-5521,3,6,2,275717,275717,276003,0,286,276164,true,L-m-0 L-l-0 
job-5525,1,10,6,275908,275908,276033,0,125,276056,true,L-m-0 L-m-0 L-l-0 L-l-0 L-l-0 L-l-0 
job-5526,2,11,8,275965,275965,276101,0,136,276283,true,L-s-0 C-s-1 C-s-0 C-s-2 C-m-0 C-m-0 C-m-2 C-m-2 
job-5527,6,4,1,276007,276007,276105,0,98,276393,true,L-m-0 
job-5530,5,10,7,276132,276132,276151,0,19,276379,true,C-m-0 C-m-2 C-l-0 L-m-0 C-l-1 C-l-1 C-l-2 
job-5529,3,8,8,276096,276096,276157,0,61,276383,true,C-m-2 L-l-0 L-l-0 L-l-0 L-l-0 C-m-1 C-m-1 C-l-0 
job-5528,3,10,1,276052,276052,276197,0,145,276319,true,C-m-0 
job-5534,1,10,1,276328,276328,276350,0,22,276573,true,L-l-0 
job-5535,2,11,7,276372,276372,276391,0,19,276426,true,L-l-0 L-l-0 C-s-1 C-s-0 C-s-2 C-m-1 C-m-1 
job-5532,3,6,5,276231,276231,276403,0,172,276654,true,C-m-0 L-s-0 L-m-0 L-m-0 L-l-0 
job-5533,1,8,5,276280,276280,276426,0,146,276501,true,L-s-0 L-m-0 L-m-0 L-l-0 L-l-0 
job-5531,2,4,2,276186,276186,276427,0,241,276679,true,C-m-0 C-m-0 
job-5536,5,4,7,276412,276412,276439,0,27,276669,true,L-m-0 L-l-0 L-l-0 C-m-1 C-m-2 C-l-0 C-l-0 
job-5537,1,8,4,276461,276461,276473,0,12,276667,true,L-s-0 L-s-0 L-m-0 L-m-0 
job-5538,2,8,2,276508,276508,276544,0,36,276617,true,L-s-0 L-s-0 
job-5540,2,11,2,276597,276597,276626,0,29,276844,true,L-m-0 L-m-0 
job-5543,6,5,7,276757,276757,276826,0,69,276844,true,C-m-0 C-m-1 C-m-2 C-l-0 C-l-0 C-l-1 C-l-1 
job-5539,2,12,1,276550,276550,276830,0,280,276912,true,L-s-0 
job-5542,2,12,8,276694,276694,276844,0,150,276880,true,L-l-0 L-l-0 L-l-0 L-l-0 C-s-1 C-s-0 C-s-2 C-m-0 
job-5541,3,12,2,276660,276660,276855,0,195,276856,true,L-m-0 L-m-0 
job-5544,4,9,2,276802,276802,276878,0,76,276878,false,C-l-2 C-l-2 
job-5546,2,10,4,276900,276900,276932,0,32,277092,true,L-m-0 L-m-0 L-l-0 L-l-0 
job-5548,3,9,5,277013,277013,277033,0,20,277269,true,C-s-0 C-s-2 C-m-0 C-m-0 C-m-1 
job-5545,2,4,7,276849,276849,277074,0,225,277156,true,L-m-0 C-l-2 C-l-2 L-s-0 L-s-0 L-l-0 L-l-0 
job-5547,4,5,6,276956,276956,277100,0,144,277217,true,L-m-0 L-l-0 L-l-0 C-l-2 C-l-2 C-s-1 
job-5550,5,6,1,277112,277112,277190,0,78,277364,true,L-m-0 
job-5551,5,12,5,277165,277165,277263,0,98,277446,true,L-l-0 L-l-0 C-m-0 C-m-1 C-m-2 
job-5549,4,9,1,277064,277064,277312,0,248,277513,true,C-s-0 
job-5553,1,10,5,277269,277269,277337,0,68,277519,true,L-l-0 L-l-0 C-m-0 C-m-0 C-m-1 
job-5555,2,10,7,277373,277373,277410,0,37,277576,true,L-m-0 L-l-0 L-l-0 C-m-1 C-m-0 C-m-0 C-s-1 
job-5554,3,9,6,277322,277322,277522,0,200,277575,true,C-m-1 C-m-2 C-m-2 L-m-0 L-m-0 C-s-0 
job-5556,4,5,8,277419,277419,277654,0,235,277795,true,L-l-0 L-l-0 C-m-1 C-m-0 C-s-1 C-s-2 C-l-2 C-l-2 
job-5558,6,9,7,277516,277654,277679,138,25,277789,true,L-l-0 C-m-1 C-m-0 C-m-2 L-m-0 C-l-2 C-l-2 
job-5552,1,12,6,277213,277213,277692,0,479,277743,true,L-l-0 L-l-0 C-m-0 C-m-1 C-m-2 L-s-0 
job-5557,5,9,2,277469,277469,277746,0,277,277832,true,C-l-0 C-l-0 
job-5562,5,4,2,277719,277719,277754,0,35,277791,true,C-l-2 C-l-2 
job-5560,3,5,7,277616,277679,277755,63,76,277836,true,L-m-0 L-m-0 L-l-0 L-l-0 C-m-1 C-m-1 C-m-0 
job-5564,1,7,3,277811,277811,277842,0,31,277972,true,L-l-0 L-l-0 L-l-0 
job-5563,3,12,2,277772,277772,277844,0,72,277847,true,L-m-0 L-m-0 
job-5559,2,5,8,277564,277654,277897,90,243,277986,true,L-m-0 L-l-0 L-l-0 C-l-0 C-s-1 C-s-1 C-s-2 C-s-2 
job-5565,5,4,7,277850,277850,278003,0,153,278105,true,L-m-0 L-l-0 C-l-0 C-l-0 C-m-1 C-l-2 C-l-2 
job-5566,4,10,4,277894,277894,278039,0,145,278082,true,C-m-0 L-s-0 C-l-1 C-l-1 
job-5567,5,10,5,277932,278003,278039,71,36,278195,true,L-m-0 L-l-0 L-l-0 C-m-1 C-l-0 
job-5568,6,12,4,277977,278039,278092,62,53,278032,false,C-l-0 C-l-1 C-l-1 C-l-2 
job-5570,5,7,5,278076,278076,278130,0,54,278170,true,L-m-0 C-m-1 C-l-0 L-l-0 L-l-0 
job-5569,3,7,5,278028,278039,278131,11,92,278202,true,L-m-0 C-m-1 C-m-0 C-l-2 C-l-2 
job-5561,2,6,6,277670,277679,278159,9,480,278257,true,C-m-0 C-m-0 C-m-2 C-m-2 C-m-2 C-s-0 
job-5573,2,10,7,278221,278221,278232,0,11,278299,true,L-m-0 L-l-0 C-m-2 C-m-2 C-m-1 C-m-1 C-m-1 
job-5572,4,11,5,278184,278184,278267,0,83,278341,true,C-m-0 C-s-0 C-s-1 C-s-2 C-m-2 
job-5574,6,5,7,278272,278272,278283,0,11,278341,true,C-m-2 C-m-1 C-l-2 C-l-2 C-l-1 C-l-1 C-l-0 
job-5571,3,8,7,278135,278135,278320,0,185,278429,true,C-m-0 L-s-0 L-m-0 L-m-0 L-l-0 L-l-0 L-l-0 
job-5577,1,9,4,278403,278403,278425,0,22,278527,true,L-m-0 L-m-0 C-m-0 C-m-0 
job-5576,6,10,1,278355,278355,278473,0,118,278622,true,L-m-0 
job-5578,2,8,2,278472,278472,278531,0,59,278675,true,L-m-0 C-m-0 
job-5579,1,5,4,278519,278519,278540,0,21,278824,true,L-m-0 L-m-0 L-m-0 L-m-0 
job-5575,4,7,2,278309,278309,278581,0,272,278630,true,C-m-0 C-s-0 
job-5581,6,8,7,278621,278621,278758,0,137,279013,true,L-m-0 L-l-0 L-l-0 C-m-2 C-m-1 C-l-2 C-l-2 
job-5584,1,4,2,278776,278776,278833,0,57,279115,true,L-s-0 L-m-0 
job-5582,6,5,6,278672,278758,278839,86,81,278775,false,L-m-0 L-l-0 L-l-0 C-m-2 C-m-1 C-l-2 
job-5580,3,9,2,278573,278573,278848,0,275,279029,true,C-m-0 L-s-0 
job-5585,3,10,4,278824,278824,278903,0,79,279041,true,C-m-0 C-s-0 C-s-1 C-s-2 
job-5583,6,12,1,278716,278758,278943,42,185,278919,false,C-l-2 
job-5587,6,7,2,278919,278919,278993,0,74,279237,true,L-m-0 L-l-0 
job-5590,4,4,1,279076,279076,279112,0,36,279181,true,L-m-0 
job-5589,4,10,3,279023,279023,279129,0,106,279377,true,L-l-0 C-m-0 L-s-0 
job-5586,2,11,4,278870,278870,279130,0,260,279338,true,C-m-0 C-m-0 C-l-2 C-l-2 
job-5588,6,7,2,278972,278972,279148,0,176,279348,true,L-l-0 C-l-2 
job-5591,4,10,5,279127,279127,279165,0,38,279182,true,L-m-0 L-m-0 C-s-0 C-s-1 C-s-2 
job-5592,4,9,1,279189,279189,279255,0,66,279527,true,L-s-0 
job-5594,1,5,5,279309,279309,279366,0,57,279595,true,L-m-0 L-m-0 C-m-0 C-m-0 L-s-0 
job-5593,6,6,4,279259,279259,279485,0,226,279779,true,L-m-0 L-l-0 L-l-0 C-m-0 
job-5597,5,10,3,279460,279460,279521,0,61,279612,true,C-l-2 C-l-2 C-l-1 
job-5596,1,4,5,279404,279404,279540,0,136,279754,true,L-m-0 L-m-0 C-m-0 C-m-0 C-m-1 
job-5599,1,8,4,279544,279544,279601,0,57,279613,true,L-m-0 C-m-1 C-m-1 L-s-0 
job-5600,3,8,7,279592,279592,279608,0,16,279803,true,L-s-0 L-l-0 L-l-0 L-l-0 L-l-0 C-m-0 C-m-0 
job-5595,4,4,6,279363,279363,279672,0,309,279713,true,C-s-0 C-s-1 C-s-2 C-m-2 C-m-2 C-m-1 
job-5598,2,10,3,279498,279498,279728,0,230,279894,true,L-m-0 L-m-0 C-m-1 
job-5601,2,8,7,279644,279644,279759,0,115,279972,true,L-m-0 C-m-1 L-s-0 L-s-0 L-l-0 L-l-0 L-l-0 
job-5603,2,12,1,279747,279747,279770,0,23,279976,true,L-m-0 
job-5604,5,5,4,279792,279792,279839,0,47,280059,true,L-l-0 L-m-0 C-m-2 C-m-0 
job-5605,1,6,8,279847,279847,279887,0,40,279891,true,L-l-0 L-l-0 L-l-0 L-l-0 L-l-0 C-m-1 C-m-1 C-m-1 
job-5606,5,9,4,279898,279898,279939,0,41,280109,true,L-l-0 L-m-0 C-m-2 C-m-0 
job-5602,2,6,7,279692,279692,279949,0,257,280038,true,L-l-0 L-l-0 L-l-0 C-m-1 C-m-1 C-s-0 C-s-0 
job-5607,5,10,1,279951,279951,279982,0,31,280220,true,L-m-0 
job-5608,5,11,3,280004,280004,280028,0,24,280176,true,L-m-0 L-l-0 L-l-0 
job-5610,3,4,5,280097,280097,280206,0,109,280350,true,L-m-0 C-m-1 L-s-0 C-s-0 C-s-1 
job-5609,5,9,4,280050,280050,280218,0,168,280223,true,L-m-0 L-l-0 L-l-0 C-m-1 
job-5611,6,8,5,280158,280158,280275,0,117,280300,true,C-m-2 C-m-0 C-l-2 C-l-2 C-l-1 
job-5612,4,12,2,280200,280200,280299,0,99,280416,true,C-l-1 C-s-2 
job-5613,4,6,6,280251,280251,280360,0,109,280555,true,L-s-0 L-m-0 L-m-0 L-l-0 L-l-0 L-l-0 
job-5615,4,7,8,280336,280336,280396,0,60,280442,true,C-l-1 C-s-2 C-s-1 C-m-2 C-m-2 C-m-0 C-m-0 C-m-1 
job-5614,3,8,3,280291,280291,280473,0,182,280473,false,C-l-1 C-l-1 C-s-0 
job-5618,5,8,1,280481,280481,280504,0,23,280632,true,C-l-1 
job-5617,6,12,5,280434,280434,280536,0,102,280692,true,C-l-1 L-m-0 L-l-0 L-l-0 C-m-2 
job-5619,1,11,6,280535,280535,280592,0,57,280620,true,L-m-0 C-s-0 C-m-2 C-l-1 C-l-1 C-l-1 
job-5622,5,6,5,280665,280665,280703,0,38,280704,true,C-l-1 C-m-0 C-m-1 C-l-2 C-l-2 
job-5620,4,10,5,280581,280581,280707,0,126,280873,true,L-m-0 C-m-2 C-l-1 L-s-0 L-l-0 
job-5616,1,5,1,280394,280394,280724,0,330,280946,true,C-s-0 
job-5621,3,8,6,280623,280623,280741,0,118,280841,true,L-m-0 L-l-0 L-l-0 C-s-0 C-m-2 C-l-1 
job-5624,6,12,8,280754,280754,280783,0,29,280921,true,C-l-1 L-m-0 L-l-0 L-l-0 C-m-2 C-l-2 C-l-2 C-l-0 
job-5623,4,5,7,280704,280704,280869,0,165,281143,true,C-l-1 C-s-2 C-s-1 C-m-0 C-m-0 C-m-1 C-m-1 
job-5626,2,4,8,280858,280858,280906,0,48,280990,true,L-s-0 L-m-0 L-m-0 L-m-0 C-l-1 L-l-0 L-l-0 L-l-0 
job-5625,2,12,5,280809,280809,280950,0,141,281090,true,C-l-1 C-l-1 C-l-1 L-s-0 L-m-0 
job-5627,3,12,3,280904,280904,280976,0,72,281197,true,L-l-0 L-l-0 C-s-2 
job-5629,3,8,7,281015,281015,281035,0,20,281286,true,L-l-0 L-l-0 L-s-0 C-s-2 C-s-1 C-s-0 C-l-2 
job-5628,6,4,7,280956,280956,281042,0,86,281244,true,L-l-0 L-m-0 C-m-0 C-m-1 C-m-2 C-l-1 C-l-1 
job-5630,4,8,4,281057,281057,281220,0,163,281483,true,L-s-0 L-m-0 L-m-0 L-l-0 
job-5633,1,7,3,281213,281213,281229,0,16,281344,true,C-m-0 C-m-0 C-m-1 
job-5632,1,7,7,281159,281159,281266,0,107,281345,true,L-l-0 L-l-0 C-s-2 C-s-1 C-s-0 C-m-0 C-m-0 
job-5634,2,8,5,281269,281269,281373,0,104,281442,true,L-l-0 L-l-0 L-l-0 C-m-0 C-m-0 
job-5636,5,4,5,281367,281367,281416,0,49,281709,true,C-l-1 C-l-1 C-l-2 C-l-2 C-l-0 
job-5635,3,5,7,281315,281315,281439,0,124,281617,true,L-s-0 L-m-0 L-m-0 C-m-1 C-m-1 C-m-2 C-m-2 
job-5631,3,4,6,281113,281113,281597,0,484,281813,true,L-l-0 L-l-0 C-s-2 C-s-1 C-s-0 C-m-0 
job-5639,1,12,8,281508,281508,281619,0,111,281836,true,L-m-0 L-l-0 C-s-2 C-s-1 C-s-0 C-m-1 C-l-1 C-l-1 
job-5637,5,10,6,281417,281417,281678,0,261,281909,true,L-l-0 C-m-0 C-l-1 C-l-1 C-l-2 C-l-2 
job-5640,3,12,8,281547,281597,281679,50,82,281903,true,L-l-0 L-l-0 C-m-0 C-m-2 C-m-2 C-l-0 C-l-0 C-l-0 
job-5642,6,12,2,281655,281678,281709,23,31,281943,true,C-l-1 C-l-2 
job-5643,6,8,5,281697,281709,281740,12,31,281952,true,L-l-0 C-l-1 C-l-0 C-m-2 C-l-2 
job-5644,5,4,2,281746,281746,281785,0,39,281905,true,L-l-0 C-m-0 
job-5638,3,8,5,281461,281461,281787,0,326,282004,true,L-s-0 L-m-0 L-m-0 C-m-1 C-m-1 
job-5641,3,8,8,281597,281678,281814,81,136,281815,true,L-l-0 L-l-0 C-m-0 C-l-0 C-s-2 C-s-1 C-s-0 C-l-1 
job-5645,3,7,5,281806,281806,281881,0,75,281939,true,L-l-0 L-l-0 C-m-0 C-l-1 C-l-1 
job-5648,4,5,8,281978,281978,282011,0,33,282261,true,L-l-0 C-l-1 L-s-0 C-s-2 C-s-1 C-s-0 C-m-1 C-m-1 
job-5647,1,9,3,281920,281920,282031,0,111,282057,true,L-m-0 L-m-0 L-l-0 
job-5646,5,11,4,281875,281875,282048,0,173,282052,true,L-l-0 C-m-0 C-l-1 L-m-0 
job-5650,5,7,4,282093,282093,282128,0,35,282360,true,L-m-0 L-l-0 C-m-0 C-l-1 
job-5652,4,8,2,282191,282191,282202,0,11,282280,true,C-l-1 L-s-0 
job-5651,2,10,6,282137,282137,282269,0,132,282501,true,L-m-0 L-m-0 L-l-0 L-l-0 L-l-0 C-m-0 
job-5654,3,5,4,282286,282286,282299,0,13,282474,true,L-m-0 L-l-0 L-l-0 C-s-0 
job-5649,3,4,6,282033,282033,282334,0,301,282447,true,L-m-0 L-l-0 L-l-0 C-m-0 C-l-1 C-l-1 
job-5653,3,8,6,282244,282244,282345,0,101,282403,true,C-m-0 C-l-1 C-l-1 L-s-0 C-s-2 C-s-1 
job-5655,5,4,4,282340,282340,282351,0,11,282464,true,C-m-0 C-l-1 L-m-0 L-l-0 
job-5656,6,5,1,282404,282404,282416,0,12,282435,true,L-m-0 
job-5659,4,11,5,282566,282566,282595,0,29,282743,true,L-l-0 C-s-2 C-s-1 C-s-0 C-m-0 
job-5657,4,9,4,282470,282470,282602,0,132,282758,true,L-s-0 L-m-0 L-m-0 L-l-0 
job-5660,6,12,1,282611,282611,282642,0,31,282930,true,L-l-0 
job-5661,6,10,4,282651,282651,282735,0,84,282792,true,L-l-0 L-m-0 C-m-0 C-m-1 
job-5658,1,5,2,282514,282514,282843,0,329,283036,true,L-l-0 L-l-0 
job-5663,6,12,6,282743,282743,282847,0,104,283046,true,L-l-0 L-m-0 C-m-0 C-m-1 C-m-2 C-l-1 
job-5662,3,9,3,282705,282705,282884,0,179,283135,true,L-l-0 L-s-0 C-s-2 
job-5665,6,11,1,282845,282847,282903,2,56,283196,true,L-l-0 
job-5668,4,11,6,282994,282994,283007,0,13,283184,true,L-m-0 C-s-2 C-m-0 C-m-0 C-m-1 C-m-1 
job-5667,6,12,1,282942,282942,283038,0,96,283235,true,L-l-0 
job-5666,4,5,6,282897,282897,283082,0,185,283158,true,L-l-0 C-l-2 C-l-1 C-l-1 L-s-0 L-m-0 
job-5669,3,11,7,283048,283048,283088,0,40,283157,true,L-m-0 L-l-0 L-l-0 C-s-2 C-m-0 C-m-0 C-m-1 
job-5664,4,4,8,282789,282789,283103,0,314,283141,true,C-l-1 C-s-1 C-s-0 C-l-0 C-l-0 C-l-0 C-l-2 C-l-2 
job-5670,1,4,2,283094,283094,283121,0,27,283236,true,C-l-2 C-l-2 
job-5671,3,10,8,283147,283147,283158,0,11,283310,true,L-s-0 L-m-0 L-m-0 L-l-0 L-l-0 L-l-0 L-l-0 C-s-1 
job-5674,3,10,8,283296,283296,283362,0,66,283496,true,C-m-0 C-m-1 C-m-2 C-l-0 C-l-0 L-s-0 C-s-1 C-s-0 
job-5672,5,9,7,283195,283195,283381,0,186,283435,true,L-m-0 L-l-0 L-l-0 C-m-0 C-m-1 C-m-2 C-l-0 
job-5673,2,10,2,283246,283246,283408,0,162,283558,true,L-m-0 L-l-0 
job-5675,5,6,7,283350,283381,283468,31,87,283699,true,L-m-0 L-l-0 L-l-0 C-m-0 C-m-1 C-m-2 C-l-0 
job-5676,3,7,3,283401,283401,283516,0,115,283645,true,C-m-0 C-m-1 C-m-2 
job-5680,5,7,7,283614,283614,283673,0,59,283941,true,C-m-0 C-m-1 C-m-2 C-l-2 C-l-2 C-l-1 C-l-1 
job-5677,2,6,7,283460,283460,283709,0,249,283972,true,L-m-0 L-l-0 C-l-0 C-l-0 C-l-0 L-s-0 L-s-0 
job-5679,2,4,7,283566,283566,283771,0,205,284015,true,L-l-0 L-l-0 L-l-0 L-l-0 L-l-0 C-l-0 C-l-0 
job-5678,2,12,2,283506,283506,283821,0,315,283888,true,L-m-0 L-m-0 
job-5683,1,11,2,283770,283770,283837,0,67,283878,true,L-l-0 L-l-0 
job-5682,6,12,7,283714,283714,283839,0,125,284053,true,C-l-0 C-m-1 C-m-2 C-l-2 C-l-2 C-l-1 C-l-1 
job-5681,5,4,1,283655,283673,283878,18,205,283988,true,C-m-0 
job-5684,3,9,6,283816,283816,283897,0,81,283942,true,L-l-0 L-l-0 C-m-0 C-l-0 C-l-0 L-s-0 
job-5686,1,10,2,283899,283899,283949,0,50,284077,true,L-l-0 L-l-0 
job-5688,6,9,4,284000,284000,284073,0,73,284172,true,L-l-0 L-m-0 C-m-0 C-m-1 
job-5687,1,7,2,283944,283944,284100,0,156,284322,true,L-l-0 L-s-0 
job-5690,1,4,7,284094,284094,284213,0,119,284489,true,L-l-0 L-l-0 L-l-0 L-l-0 C-s-1 C-s-0 C-s-2 
job-5692,4,11,1,284205,284205,284216,0,11,284296,true,C-m-1 
job-5691,4,11,4,284149,284149,284254,0,105,284379,true,L-m-0 L-m-0 C-m-0 C-m-0 
job-5685,1,8,2,283856,283856,284258,0,402,284461,true,L-l-0 L-l-0 
job-5694,6,6,5,284291,284291,284340,0,49,284557,true,L-l-0 L-m-0 C-m-0 C-m-1 C-m-2 
job-5693,2,10,1,284250,284250,284343,0,93,284372,true,L-l-0 
job-5689,3,7,5,284039,284039,284364,0,325,284567,true,L-s-0 L-l-0 C-s-1 C-s-0 C-s-2 
job-5696,2,7,2,284386,284386,284416,0,30,284715,true,L-m-0 L-l-0 
job-5697,2,4,5,284437,284437,284458,0,21,284679,true,L-m-0 L-l-0 L-l-0 L-l-0 C-m-0 
job-5695,5,6,5,284342,284342,284479,0,137,284723,true,L-l-0 L-m-0 C-m-0 C-m-1 C-m-2 
job-5699,2,12,7,284542,284542,284638,0,96,284644,true,L-m-0 C-s-1 C-s-0 C-s-2 C-m-0 C-m-0 C-m-1 
job-5698,3,5,7,284491,284491,284645,0,154,284778,true,L-s-0 L-m-0 L-m-0 L-l-0 L-l-0 L-l-0 L-l-0 
job-5700,5,6,4,284580,284580,284670,0,90,284849,true,C-m-1 C-m-2 C-l-0 C-l-0 
job-5701,3,12,6,284629,284629,284688,0,59,284813,true,C-m-2 C-l-2 C-l-2 C-l-2 C-l-2 C-l-1 
job-5702,5,4,2,284679,284679,284763,0,84,285026,true,C-m-2 C-l-1 
job-5703,3,9,8,284729,284729,284808,0,79,285036,true,C-m-2 C-l-1 C-l-1 L-s-0 L-m-0 L-m-0 L-l-0 L-l-0 
job-5705,1,5,7,284848,284848,284873,0,25,284877,true,L-m-0 L-m-0 L-m-0 L-m-0 L-m-0 L-l-0 L-l-0 
job-5706,5,8,7,284899,284899,284971,0,72,285003,true,L-m-0 L-l-0 C-m-2 C-m-1 C-m-0 C-l-1 C-l-1 
job-5704,2,4,5,284782,284782,284974,0,192,285103,true,L-m-0 L-l-0 L-l-0 L-l-0 C-m-2 
job-5708,1,5,4,284997,284997,285022,0,25,285279,true,L-m-0 L-m-0 L-m-0 L-m-0 
job-5707,1,10,5,284949,284949,285037,0,88,285296,true,L-m-0 L-l-0 C-m-2 C-m-1 C-m-1 
job-5709,6,5,6,285045,285045,285061,0,16,285112,true,L-m-0 L-l-0 L-l-0 C-m-1 C-m-2 C-m-0 
job-5710,4,8,6,285095,285095,285167,0,72,285296,true,L-s-0 L-m-0 L-m-0 L-l-0 L-l-0 L-l-0 
job-5711,1,9,5,285146,285146,285171,0,25,285427,true,C-s-1 C-s-0 C-s-2 C-m-1 C-m-1 
job-5712,5,11,1,285196,285196,285319,0,123,285543,true,L-m-0 
job-5714,5,5,3,285295,285295,285324,0,29,285410,true,C-m-1 C-m-2 C-m-0 
job-5715,5,6,6,285347,285347,285357,0,10,285362,true,L-m-0 C-m-1 C-m-2 C-m-0 C-l-1 C-l-1 
job-5713,3,8,8,285240,285240,285363,0,123,285617,true,L-m-0 L-s-0 L-l-0 L-l-0 L-l-0 L-l-0 C-s-1 C-s-0 
job-5716,2,8,3,285389,285389,285407,0,18,285513,true,L-s-0 L-s-0 L-m-0 
job-5717,4,4,7,285440,285440,285526,0,86,285805,true,L-s-0 L-m-0 L-m-0 L-l-0 L-l-0 L-l-0 C-s-1 
job-5719,4,8,3,285523,285523,285655,0,132,285717,true,C-m-2 C-m-2 C-m-0 
job-5718,2,6,8,285478,285478,285763,0,285,286030,true,C-s-0 C-s-0 C-s-2 C-s-2 C-m-1 C-m-1 C-m-1 C-m-1 
job-5721,4,5,3,285627,285627,285818,0,191,285866,true,L-m-0 L-l-0 L-l-0 
job-5720,3,9,3,285582,285582,285832,0,250,286113,true,C-m-0 L-s-0 L-m-0 
job-5726,2,11,2,285851,285851,285913,0,62,286003,true,L-l-0 L-l-0 
job-5723,4,5,4,285723,285723,285930,0,207,286175,true,C-s-1 C-m-2 C-m-2 C-l-1 
job-5727,5,10,5,285900,285900,286072,0,172,286131,true,L-l-0 C-m-0 L-m-0 C-m-1 C-l-0 
job-5728,6,4,6,285950,286072,286118,122,46,286039,false,L-l-0 L-m-0 C-m-1 C-m-2 C-l-0 C-l-0 
job-5725,4,9,1,285808,285808,286132,0,324,286325,true,C-l-2 
job-5724,4,12,3,285761,285761,286135,0,374,286162,true,C-l-1 C-l-1 C-l-2 
job-5730,4,9,6,286038,286118,286164,80,46,286233,true,L-l-0 L-m-0 L-m-0 C-s-2 C-m-1 C-m-1 
job-5722,3,9,2,285669,285669,286180,0,511,286334,true,L-l-0 C-m-0 
job-5732,1,5,6,286126,286126,286180,0,54,286331,true,L-s-0 L-l-0 L-l-0 C-s-1 C-s-0 C-m-0 
job-5733,4,5,8,286176,286176,286223,0,47,286263,true,L-l-0 C-l-1 C-l-1 C-l-2 C-l-2 L-m-0 L-m-0 C-s-2 
job-5729,3,6,7,285991,286072,286224,81,152,286265,true,L-l-0 C-m-0 C-l-1 C-l-2 L-s-0 C-s-1 C-s-0 
job-5734,6,6,2,286225,286225,286245,0,20,286362,true,L-m-0 L-l-0 
job-5735,6,11,7,286274,286274,286298,0,24,286502,true,L-m-0 L-l-0 L-l-0 C-m-0 C-m-1 C-l-1 C-l-1 
job-5736,1,9,3,286323,286323,286344,0,21,286474,true,C-m-2 C-m-2 L-s-0 
job-5731,6,12,1,286081,286118,286383,37,265,286559,true,C-m-2 
job-5737,3,6,2,286367,286367,286418,0,51,286582,true,L-s-0 L-m-0 
job-5738,2,5,1,286410,286410,286420,0,10,286573,true,L-m-0 
job-5739,1,9,6,286459,286459,286491,0,32,286769,true,L-s-0 L-m-0 L-m-0 L-m-0 L-l-0 L-l-0 
job-5740,2,6,8,286508,286508,286546,0,38,286557,true,L-s-0 L-s-0 L-m-0 L-m-0 L-m-0 L-m-0 L-l-0 L-l-0 
job-5741,4,10,3,286555,286555,286652,0,97,286938,true,L-s-0 L-m-0 L-m-0 
job-5743,5,9,3,286655,286655,286700,0,45,286943,true,L-m-0 C-m-0 C-m-1 
job-5744,3,6,7,286709,286709,286726,0,17,286765,true,L-s-0 L-m-0 L-m-0 C-m-0 C-m-0 C-m-1 C-m-1 
job-5742,4,5,8,286602,286602,286857,0,255,286902,true,L-l-0 L-l-0 L-l-0 C-s-1 C-s-0 C-s-2 C-m-2 C-m-2 
job-5745,6,8,4,286761,286761,286906,0,145,287092,true,L-m-0 C-m-0 C-m-1 C-l-1 
job-5749,2,8,2,286937,286937,286947,0,10,287084,true,C-m-2 C-l-1 
job-5748,6,8,7,286893,286906,287007,13,101,287248,true,L-m-0 C-m-0 C-m-1 C-l-1 L-l-0 L-l-0 C-m-2 
job-5750,1,10,4,286989,286989,287035,0,46,287076,true,C-m-2 C-m-2 C-l-1 C-l-1 
job-5747,6,9,4,286856,286856,287078,0,222,287270,true,C-l-2 C-l-2 C-l-0 C-l-0 
job-5751,1,11,4,287038,287038,287078,0,40,287291,true,L-m-0 C-m-0 C-m-1 C-l-1 
job-5746,1,7,7,286812,286812,287088,0,276,287169,true,L-m-0 L-m-0 C-m-0 C-m-0 C-m-1 C-m-1 C-l-1 
job-5752,6,11,7,287085,287085,287127,0,42,287204,true,L-m-0 C-m-0 C-m-1 C-l-1 L-l-0 L-l-0 C-m-2 
job-5753,4,6,5,287122,287122,287137,0,15,287237,true,C-l-1 L-s-0 C-s-1 C-s-0 C-s-2 
job-5755,1,7,3,287218,287218,287232,0,14,287371,true,L-m-0 L-m-0 L-m-0 
job-5754,5,8,7,287172,287172,287317,0,145,287383,true,L-m-0 L-l-0 L-l-0 C-m-0 C-m-1 C-m-2 C-l-1 
job-5758,6,12,4,287365,287365,287478,0,113,287735,true,C-m-1 C-m-2 C-l-1 C-l-1 
job-5757,2,12,4,287320,287320,287494,0,174,287660,true,L-l-0 L-l-0 C-m-0 L-s-0 
job-5760,2,9,4,287438,287438,287522,0,84,287603,true,C-m-1 C-m-2 C-l-2 C-l-2 
job-5756,1,11,5,287272,287272,287578,0,306,287658,true,L-m-0 L-m-0 L-l-0 L-l-0 C-m-0 
job-5759,3,6,6,287402,287402,287586,0,184,287656,true,L-m-0 C-m-0 C-s-1 C-s-0 C-s-2 C-l-2 
job-5763,1,8,1,287595,287595,287629,0,34,287872,true,L-l-0 
job-5762,4,4,4,287546,287546,287641,0,95,287692,true,L-l-0 L-l-0 C-m-0 C-m-1 
job-5761,4,6,5,287490,287490,287671,0,181,287809,true,C-m-1 C-m-2 C-l-2 C-l-1 C-l-1 
job-5765,6,5,1,287700,287700,287739,0,39,287777,true,C-l-2 
job-5764,5,10,8,287644,287671,287853,27,182,288080,true,L-m-0 L-l-0 L-l-0 C-m-1 C-m-2 C-m-0 C-l-1 C-l-1 
job-5766,3,6,3,287762,287762,287883,0,121,287997,true,L-m-0 C-m-1 C-m-2 
job-5767,5,11,6,287813,287853,287928,40,75,287941,true,L-m-0 C-m-1 C-m-2 L-l-0 L-l-0 C-m-0 
job-5769,3,11,2,287902,287928,287995,26,67,288085,true,L-m-0 C-m-1 
job-5770,6,6,3,287952,287952,288006,0,54,288103,true,C-l-2 C-l-2 C-l-0 
job-5768,5,12,8,287857,287928,288023,71,95,288102,true,L-m-0 L-l-0 L-l-0 C-m-1 C-m-2 C-m-0 C-l-1 C-l-1 
job-5772,1,7,4,288040,288040,288140,0,100,288411,true,L-l-0 L-l-0 L-l-0 L-l-0 
job-5774,6,7,8,288144,288144,288154,0,10,288229,true,L-l-0 L-m-0 C-m-1 C-m-0 C-l-1 C-l-1 C-l-2 C-l-2 
job-5771,1,9,4,287992,287992,288156,0,164,288224,true,L-l-0 L-l-0 C-m-2 C-m-2 
job-5773,3,7,3,288085,288085,288174,0,89,288225,true,C-m-2 C-m-2 L-s-0 
job-5776,2,10,3,288231,288231,288270,0,39,288391,true,L-m-0 L-s-0 C-s-1 
job-5777,3,11,6,288276,288276,288336,0,60,288373,true,L-s-0 C-s-1 C-s-0 C-s-2 C-m-2 C-m-2 
job-5778,3,10,3,288333,288333,288357,0,24,288439,true,C-m-1 C-m-1 C-m-0 
job-5781,2,4,6,288488,288488,288513,0,25,288747,true,L-s-0 C-s-1 C-s-1 C-s-0 C-s-0 C-s-2 
job-5779,5,8,4,288372,288372,288571,0,199,288644,true,C-m-2 C-m-1 C-m-0 C-l-1 
job-5775,6,7,3,288190,288190,288574,0,384,288670,true,L-m-0 L-l-0 L-l-0 
job-5780,2,8,8,288435,288435,288585,0,150,288633,true,L-m-0 C-m-2 C-m-1 C-m-0 C-l-1 C-l-1 C-l-1 L-s-0 
job-5782,3,12,1,288545,288545,288602,0,57,288867,true,C-s-1 
job-5783,5,7,6,288596,288596,288645,0,49,288711,true,L-m-0 L-l-0 L-l-0 C-m-2 C-m-1 C-m-0 
job-5785,5,6,1,288711,288711,288757,0,46,288912,true,L-l-0 
job-5784,6,5,1,288663,288663,288824,0,161,288888,true,L-m-0 
job-5786,3,7,5,288773,288773,288849,0,76,288942,true,L-s-0 L-l-0 L-l-0 L-l-0 L-l-0 
job-5788,2,7,5,288883,288883,288923,0,40,289095,true,C-m-1 C-m-1 L-s-0 L-s-0 L-m-0 
job-5787,4,4,6,288823,288823,288981,0,158,289149,true,C-s-1 C-s-0 C-s-2 C-m-2 C-m-2 C-m-1 
job-5789,5,9,5,288931,288931,289064,0,133,289118,true,L-m-0 L-l-0 L-l-0 C-m-0 C-l-1 
job-5791,2,11,5,289006,289064,289101,58,37,289153,true,L-m-0 L-l-0 C-m-0 C-m-2 C-m-1 
job-5790,5,11,8,288975,289064,289243,89,179,289189,false,L-m-0 L-l-0 L-l-0 C-m-0 C-m-2 C-m-1 C-l-1 C-l-1 
job-5793,4,11,8,289108,289243,289260,135,17,289277,true,L-s-0 C-s-1 C-s-0 C-s-2 C-l-2 C-l-2 C-l-2 C-l-0 
job-5794,2,12,3,289155,289243,289273,88,30,289332,true,L-m-0 L-l-0 C-m-0 
job-5796,1,4,2,289257,289260,289285,3,25,289566,true,L-m-0 C-m-0 
job-5795,6,5,4,289206,289260,289340,54,80,289553,true,C-l-2 C-l-2 C-l-0 C-l-0 
job-5792,5,9,8,289057,289243,289347,186,104,289235,false,L-m-0 L-l-0 L-l-0 C-m-0 C-m-2 C-m-1 C-l-1 C-l-1 
job-5797,6,10,4,289307,289340,289395,33,55,289427,true,C-l-2 C-l-2 C-l-0 C-l-0 
job-5798,5,5,4,289358,289358,289442,0,84,289631,true,L-m-0 L-l-0 L-l-0 C-m-0 
job-5800,1,6,8,289444,289444,289474,0,30,289530,true,L-m-0 L-m-0 L-m-0 L-s-0 L-s-0 L-l-0 L-l-0 L-l-0 
job-5799,1,6,2,289396,289396,289476,0,80,289490,true,L-m-0 L-m-0 
job-5801,4,8,3,289498,289498,289645,0,147,289750,true,L-s-0 L-m-0 L-m-0 
job-5804,5,5,3,289649,289649,289666,0,17,289768,true,L-m-0 C-l-1 C-l-1 
job-5805,2,5,6,289705,289705,289717,0,12,289955,true,L-l-0 L-l-0 C-m-0 C-m-2 C-m-1 C-l-2 
job-5802,4,6,2,289556,289556,289771,0,215,289958,true,L-l-0 L-l-0 
job-5803,5,4,7,289602,289602,289807,0,205,289859,true,C-m-0 C-m-2 C-m-1 C-l-2 C-l-2 C-l-0 C-l-0 
job-5807,3,8,1,289804,289807,289841,3,34,289858,true,L-m-0 
job-5806,5,9,7,289758,289807,289887,49,80,290130,true,L-m-0 L-l-0 L-l-0 C-m-0 C-m-2 C-m-1 C-l-2 
job-5810,1,9,3,289956,289956,289988,0,32,290078,true,L-m-0 L-l-0 L-l-0 
job-5809,1,4,2,289903,289903,290006,0,103,290012,true,L-m-0 L-m-0 
job-5811,5,11,8,290002,290002,290097,0,95,290174,true,L-l-0 L-l-0 C-m-0 C-m-2 C-m-1 C-l-2 C-l-2 C-l-0 
job-5808,2,10,2,289855,289855,290113,0,258,290297,true,L-m-0 L-l-0 
job-5813,6,8,1,290103,290103,290113,0,10,290386,true,C-m-1 
job-5812,5,12,5,290052,290097,290113,45,16,290113,false,L-m-0 L-l-0 L-l-0 C-m-0 C-m-2 
job-5814,3,11,3,290149,290149,290212,0,63,290447,true,L-s-0 L-m-0 L-m-0 
job-5815,1,6,8,290202,290202,290244,0,42,290521,true,L-m-0 L-l-0 L-l-0 L-l-0 L-l-0 L-l-0 L-l-0 L-l-0 
job-5816,3,11,5,290246,290246,290257,0,11,290515,true,L-s-0 L-m-0 L-m-0 L-l-0 L-l-0 
job-5817,4,9,4,290300,290300,290337,0,37,290384,true,L-s-0 L-m-0 L-m-0 L-l-0 
job-5819,2,6,1,290385,290385,290421,0,36,290692,true,L-m-0 
job-5818,4,5,1,290351,290351,290483,0,132,290762,true,L-s-0 
job-5821,5,9,4,290482,290482,290497,0,15,290746,true,L-m-0 L-l-0 L-l-0 C-m-0 
job-5822,4,6,1,290524,290524,290566,0,42,290809,true,L-m-0 
job-5820,2,4,1,290430,290430,290610,0,180,290792,true,L-m-0 
job-5823,1,10,7,290577,290577,290675,0,98,290952,true,L-m-0 L-m-0 L-s-0 L-l-0 L-l-0 L-l-0 L-l-0 
job-5824,3,9,4,290632,290632,290736,0,104,291033,true,L-m-0 C-s-1 C-s-0 C-s-2 
job-5827,4,6,8,290761,290761,290845,0,84,291059,true,L-m-0 C-s-1 C-s-0 C-s-2 C-m-2 C-m-2 C-m-1 C-m-1 
job-5826,5,6,2,290718,290718,290850,0,132,291148,true,L-l-0 C-m-0 
job-5829,1,11,8,290859,290859,290935,0,76,291031,true,L-m-0 L-l-0 L-l-0 C-m-0 C-m-0 C-s-1 C-s-0 C-s-2 
job-5825,4,12,3,290684,290684,290947,0,263,290999,true,L-m-0 L-s-0 L-l-0 
job-5831,6,12,3,290973,290973,291151,0,178,291379,true,L-l-0 C-m-0 L-m-0 
job-5830,6,5,6,290920,290920,291172,0,252,291363,true,C-m-2 C-m-1 C-l-0 C-l-0 C-l-1 C-l-1 
job-5832,6,4,2,291030,291151,291208,121,57,291252,true,L-l-0 C-m-0 
job-5828,2,6,8,290803,290803,291240,0,437,291376,true,L-l-0 C-m-0 C-l-2 C-l-2 C-l-2 C-l-2 C-l-2 C-l-2 
job-5833,3,9,5,291096,291151,291269,55,118,291355,true,L-l-0 L-s-0 L-m-0 L-m-0 C-s-1 
job-5834,2,4,2,291139,291151,291332,12,181,291572,true,L-m-0 C-m-2 
job-5837,2,4,7,291307,291307,291339,0,32,291587,true,L-m-0 L-m-0 L-m-0 L-l-0 L-l-0 L-l-0 L-l-0 
job-5835,2,10,4,291189,291189,291391,0,202,291625,true,C-m-2 C-m-2 C-s-0 C-s-2 
job-5838,1,12,3,291360,291360,291402,0,42,291454,true,L-l-0 L-l-0 L-l-0 
job-5836,3,8,1,291247,291247,291427,0,180,291707,true,L-l-0 
job-5839,1,9,7,291419,291419,291438,0,19,291564,true,L-l-0 L-l-0 L-l-0 L-l-0 L-s-0 L-m-0 L-m-0 
job-5840,5,12,4,291474,291474,291650,0,176,291929,true,L-m-0 L-l-0 L-l-0 C-m-2 
job-5842,4,12,3,291591,291591,291703,0,112,291747,true,C-m-0 C-m-1 C-m-1 
job-5844,1,12,8,291697,291697,291710,0,13,291726,true,L-l-0 L-l-0 C-l-2 C-l-2 C-l-0 C-l-0 C-l-1 C-l-1 
job-5843,5,12,8,291650,291650,291788,0,138,291915,true,L-m-0 C-m-2 L-l-0 L-l-0 C-l-2 C-l-2 C-l-0 C-l-0 
job-5845,5,5,2,291753,291753,291791,0,38,291793,true,C-m-0 C-m-1 
job-5846,1,5,4,291797,291797,291842,0,45,292042,true,L-s-0 L-m-0 L-m-0 L-m-0 
job-5841,3,10,7,291535,291535,291865,0,330,292015,true,L-m-0 C-m-2 L-s-0 C-s-0 C-s-2 C-s-1 C-m-0 
job-5847,4,9,8,291841,291841,291956,0,115,292207,true,C-m-2 C-m-0 L-l-0 L-l-0 L-l-0 C-m-1 C-m-1 C-l-2 
job-5848,6,9,8,291890,291956,292073,66,117,292141,true,L-m-0 L-l-0 L-l-0 C-m-1 C-m-2 C-m-0 C-l-2 C-l-2 
job-5852,3,11,3,292084,292084,292165,0,81,292372,true,C-m-2 C-m-0 C-l-2 
job-5849,5,11,5,291934,292073,292175,139,102,292279,true,L-m-0 L-l-0 L-l-0 C-m-1 C-m-2 
job-5854,2,4,7,292190,292190,292293,0,103,292415,true,L-m-0 L-m-0 L-l-0 L-l-0 L-l-0 L-l-0 L-l-0 
job-5853,3,11,2,292139,292139,292335,0,196,292409,true,C-l-2 C-l-2 
job-5856,1,10,4,292286,292286,292356,0,70,292478,true,C-m-1 C-m-1 C-m-2 C-m-2 
job-5850,1,6,6,291986,292073,292418,87,345,292474,true,L-m-0 L-m-0 L-m-0 L-l-0 L-l-0 C-m-1 
job-5851,4,8,5,292027,292073,292421,46,348,292436,true,L-s-0 C-s-0 C-s-2 C-s-1 C-m-0 
job-5855,5,5,4,292237,292237,292559,0,322,292626,true,C-m-1 C-l-2 C-m-2 C-l-0 
job-5857,6,11,7,292333,292418,292578,85,160,292604,true,C-l-2 C-l-0 L-m-0 L-l-0 L-l-0 C-l-1 C-l-1 
job-5859,5,10,2,292409,292578,292600,169,22,292538,false,C-l-2 C-l-0 
job-5858,5,11,4,292374,292559,292732,185,173,292835,true,C-l-2 C-l-0 C-m-1 C-m-2 
job-5862,6,10,8,292566,292732,292796,166,64,292893,true,C-m-1 C-m-2 C-l-2 C-l-0 L-l-0 L-l-0 C-m-0 C-l-1 
job-5861,6,11,1,292515,292578,292806,63,228,292855,true,L-m-0 
job-5860,2,4,6,292456,292578,292813,122,235,292921,true,C-m-1 C-m-2 C-l-2 C-l-0 L-s-0 L-s-0 
job-5866,4,10,2,292785,292813,292847,28,34,292946,true,L-s-0 C-s-0 
job-5863,1,9,5,292625,292732,292849,107,117,292983,true,L-m-0 L-m-0 C-m-0 C-m-0 C-l-2 
job-5864,5,12,8,292686,292796,292907,110,111,293013,true,C-m-0 C-m-1 C-m-2 C-l-2 C-l-0 C-l-0 L-l-0 L-l-0 
job-5869,2,12,5,292931,292931,292942,0,11,292978,true,L-m-0 C-m-0 C-m-1 C-m-2 C-l-1 
job-5867,4,5,7,292839,292907,292954,68,47,293021,true,C-l-2 L-s-0 L-l-0 L-l-0 L-l-0 C-s-0 C-s-2 
job-5868,6,8,4,292880,292907,292961,27,54,292986,true,C-m-0 C-m-1 C-m-2 C-l-0 
job-5870,3,4,2,292985,292985,293060,0,75,293278,true,L-m-0 C-l-2 
job-5871,1,8,5,293037,293037,293083,0,46,293206,true,C-l-1 C-l-1 C-l-2 C-l-2 C-l-2 
job-5872,6,12,4,293095,293095,293142,0,47,293190,true,C-l-2 L-l-0 L-l-0 C-m-0 
job-5873,4,10,4,293155,293155,293177,0,22,293425,true,C-l-2 L-s-0 L-l-0 L-l-0 
job-5874,4,7,5,293207,293207,293319,0,112,293412,true,C-l-2 L-s-0 L-l-0 L-l-0 L-l-0 
job-5875,1,12,6,293252,293252,293330,0,78,293574,true,L-m-0 L-m-0 C-l-1 C-l-1 C-l-2 C-l-2 
job-5865,5,5,4,292732,292813,293350,81,537,293549,true,L-m-0 C-l-2 C-l-1 C-l-1 
job-5878,1,6,8,293403,293403,293417,0,14,293701,true,C-s-0 C-l-2 C-l-2 C-l-2 C-l-2 C-l-2 L-m-0 L-m-0 
job-5876,1,10,2,293296,293296,293489,0,193,293503,true,C-l-2 C-s-0 
job-5877,4,8,2,293349,293349,293529,0,180,293735,true,C-l-2 L-s-0 
job-5881,3,9,3,293537,293537,293558,0,21,293591,true,L-l-0 L-l-0 C-l-2 
job-5880,1,6,2,293493,293493,293584,0,91,293680,true,L-m-0 L-m-0 
job-5883,5,12,4,293632,293632,293668,0,36,293937,true,C-l-2 C-m-0 C-m-1 C-m-2 
job-5882,1,12,3,293577,293577,293714,0,137,293823,true,L-l-0 L-l-0 L-l-0 
job-5885,1,11,4,293743,293743,293769,0,26,293943,true,L-m-0 L-m-0 L-l-0 L-l-0 
job-5879,3,5,7,293445,293445,293825,0,380,293972,true,C-s-0 C-l-2 C-l-2 L-m-0 L-m-0 L-l-0 L-l-0 
job-5884,4,5,4,293692,293692,293867,0,175,294002,true,C-l-2 L-s-0 C-s-2 C-s-1 
job-5886,6,4,7,293791,293791,293947,0,156,294050,true,L-l-0 C-m-0 C-m-1 C-m-2 C-l-1 C-l-1 C-l-0 
job-5888,1,7,4,293907,293907,293998,0,91,294125,true,L-l-0 L-l-0 C-m-0 C-m-0 
job-5887,1,12,2,293846,293846,294003,0,157,294282,true,L-l-0 L-l-0 
job-5891,3,4,4,294044,294044,294063,0,19,294274,true,L-s-0 L-m-0 L-m-0 L-l-0 
job-5889,1,9,4,293952,293952,294101,0,149,294198,true,L-l-0 C-m-0 C-m-0 L-s-0 
job-5892,4,9,5,294103,294103,294150,0,47,294285,true,L-m-0 L-l-0 L-l-0 C-m-0 L-s-0 
job-5890,2,10,3,293998,293998,294260,0,262,294508,true,L-l-0 C-m-0 L-m-0 
job-5894,6,7,8,294202,294202,294266,0,64,294468,true,L-l-0 C-m-0 C-m-1 C-m-2 C-l-1 C-l-1 C-l-0 C-l-0 
job-5893,6,5,1,294157,294157,294314,0,157,294530,true,L-m-0 
job-5896,1,11,3,294292,294292,294332,0,40,294470,true,L-m-0 L-m-0 L-l-0 
job-5898,1,12,7,294387,294387,294437,0,50,294726,true,C-m-2 L-s-0 L-m-0 L-m-0 C-s-2 C-s-1 C-s-0 
job-5899,4,6,6,294429,294429,294449,0,20,294740,true,L-m-0 L-l-0 C-m-1 C-m-0 C-m-0 C-l-1 
job-5895,2,6,4,294247,294247,294499,0,252,294644,true,L-l-0 L-l-0 C-m-1 C-m-2 
job-5900,5,6,6,294488,294488,294530,0,42,294701,true,L-l-0 C-m-2 L-m-0 C-m-0 C-l-1 C-l-1 
job-5897,1,10,6,294338,294338,294540,0,202,294773,true,L-l-0 L-l-0 L-l-0 C-m-1 C-m-1 C-m-2 
job-5901,1,8,1,294543,294543,294572,0,29,294727,true,L-s-0 
job-5902,5,11,8,294598,294598,294661,0,63,294843,true,L-m-0 L-l-0 L-l-0 C-m-1 C-m-2 C-m-0 C-l-1 C-l-1 
job-5903,5,11,7,294643,294661,294721,18,60,294721,false,L-m-0 L-l-0 L-l-0 C-m-1 C-m-2 C-m-0 C-l-1 
job-5906,4,10,7,294806,294806,294834,0,28,295094,true,C-l-1 L-s-0 L-m-0 L-m-0 L-l-0 L-l-0 L-l-0 
job-5907,4,6,8,294848,294848,294874,0,26,294961,true,C-l-1 L-s-0 L-m-0 L-m-0 L-l-0 L-l-0 L-l-0 C-s-2 
job-5905,2,10,1,294758,294758,294884,0,126,295173,true,C-l-1 
job-5904,6,7,3,294699,294699,294965,0,266,295072,true,C-l-1 C-l-0 C-l-0 
job-5909,4,6,6,294940,294940,294972,0,32,295081,true,L-s-0 C-s-2 C-s-1 C-s-0 C-m-2 C-m-2 
job-5908,5,9,5,294897,294897,295040,0,143,295182,true,C-l-1 L-m-0 L-l-0 L-l-0 C-m-1 
job-5913,4,9,6,295128,295128,295168,0,40,295197,true,L-l-0 L-l-0 C-l-1 L-s-0 C-s-2 C-s-1 
job-5911,2,7,2,295020,295020,295207,0,187,295321,true,L-m-0 L-l-0 
job-5914,6,4,2,295177,295177,295227,0,50,295501,true,L-l-0 C-l-1 
job-5910,6,6,3,294978,294978,295244,0,266,295398,true,C-l-1 C-m-2 C-m-0 
job-5915,1,5,2,295220,295220,295250,0,30,295286,true,L-m-0 L-m-0 
job-5917,4,11,8,295313,295313,295363,0,50,295631,true,L-s-0 L-l-0 L-l-0 L-l-0 C-s-2 C-s-1 C-s-0 C-m-2 
job-5916,1,12,2,295262,295262,295379,0,117,295487,true,L-m-0 L-m-0 
job-5918,5,11,7,295367,295367,295413,0,46,295640,true,L-l-0 L-l-0 C-m-2 C-m-0 C-m-1 C-l-1 C-l-1 
job-5912,3,4,2,295067,295067,295492,0,425,295594,true,L-m-0 L-m-0 
job-5920,5,10,4,295463,295463,295572,0,109,295789,true,C-m-2 C-m-0 C-m-1 C-l-1 
job-5919,4,5,6,295421,295421,295581,0,160,295730,true,L-s-0 L-l-0 L-l-0 L-l-0 C-s-2 C-s-1 
job-5923,3,10,4,295601,295601,295623,0,22,295649,true,L-m-0 C-m-2 C-m-0 C-m-1 
job-5922,1,7,3,295545,295545,295701,0,156,295767,true,C-l-1 L-m-0 L-m-0 
job-5924,5,4,1,295657,295657,295735,0,78,295861,true,L-m-0 
job-5921,3,7,5,295512,295512,295751,0,239,296004,true,C-m-2 C-m-0 C-m-1 C-l-1 C-l-1 
job-5926,2,8,6,295756,295756,295823,0,67,295911,true,L-m-0 L-m-0 C-m-2 C-m-0 C-m-0 L-s-0 
job-5927,2,5,7,295790,295790,295829,0,39,296056,true,L-s-0 L-l-0 L-l-0 L-l-0 L-l-0 L-l-0 L-l-0 
job-5925,2,12,4,295706,295706,295926,0,220,295936,true,L-m-0 C-m-2 C-m-2 C-m-0 
job-5928,3,4,2,295837,295837,295950,0,113,296016,true,L-m-0 L-m-0 
job-5930,5,5,5,295942,295942,295963,0,21,296232,true,C-m-2 L-l-0 L-l-0 C-m-1 C-l-1 
job-5929,3,8,4,295877,295877,295975,0,98,296128,true,C-m-2 C-m-0 C-m-0 L-s-0 
job-5931,2,8,4,295995,295995,296079,0,84,296232,true,L-s-0 L-s-0 L-m-0 L-m-0 
job-5932,1,6,1,296044,296044,296113,0,69,296169,true,L-m-0 
job-5933,4,6,4,296086,296086,296123,0,37,296272,true,L-m-0 L-s-0 L-l-0 L-l-0 
job-5934,4,9,7,296155,296155,296183,0,28,296364,true,L-s-0 L-m-0 L-m-0 L-l-0 L-l-0 L-l-0 C-s-2 
job-5935,6,12,6,296205,296205,296232,0,27,296444,true,L-m-0 L-l-0 L-l-0 C-m-0 C-m-2 C-m-1 
job-5936,6,6,7,296262,296262,296345,0,83,296610,true,L-m-0 L-l-0 L-l-0 C-m-0 C-m-2 C-m-1 C-l-1 
job-5937,5,10,8,296326,296345,296361,19,16,296354,false,L-m-0 L-l-0 L-l-0 C-m-0 C-m-2 C-m-1 C-l-1 C-l-1 
job-5938,1,4,4,296394,296394,296424,0,30,296550,true,L-s-0 L-s-0 L-s-0 L-s-0 
job-5940,2,10,4,296488,296488,296512,0,24,296697,true,L-m-0 C-m-0 C-m-2 L-s-0 
job-5939,6,12,5,296437,296437,296539,0,102,296539,false,L-m-0 L-l-0 L-l-0 C-m-0 C-m-2 
job-5941,6,12,1,296543,296543,296652,0,109,296662,true,L-m-0 
job-5943,5,6,7,296644,296644,296672,0,28,296920,true,C-m-0 C-m-2 C-m-1 C-l-1 C-l-1 C-l-0 C-l-0 
job-5942,2,4,7,296593,296593,296726,0,133,296969,true,L-m-0 L-s-0 L-s-0 L-l-0 L-l-0 L-l-0 L-l-0 
job-5946,2,6,4,296787,296787,296859,0,72,296933,true,L-l-0 L-l-0 L-s-0 L-s-0 
job-5947,4,12,2,296839,296839,296936,0,97,297053,true,C-s-2 C-s-1 
job-5948,5,11,6,296884,296884,296960,0,76,296961,true,L-l-0 C-m-0 C-m-2 C-m-1 C-l-1 C-l-1 
job-5949,4,4,8,296944,296944,296999,0,55,297040,true,L-s-0 C-s-2 C-s-1 C-s-0 C-l-0 C-l-0 C-l-0 C-l-2 
job-5950,2,7,4,296995,296995,297006,0,11,297075,true,L-l-0 L-l-0 C-l-2 C-l-2 
job-5944,3,11,3,296700,296700,297048,0,348,297221,true,L-m-0 L-m-0 L-l-0 
job-5945,2,4,3,296746,296746,297075,0,329,297335,true,L-m-0 L-l-0 L-l-0 
job-5952,6,4,6,297083,297083,297230,0,147,297236,true,L-l-0 L-m-0 C-l-0 C-l-0 C-l-2 C-l-2 
job-5955,1,11,8,297243,297243,297254,0,11,297445,true,L-m-0 L-m-0 L-l-0 L-l-0 L-l-0 C-m-1 C-s-0 C-l-0 
job-5954,2,9,5,297186,297186,297336,0,150,297459,true,L-m-0 C-m-1 L-s-0 C-s-2 C-s-1 
job-5953,3,7,2,297137,297137,297342,0,205,297545,true,C-m-0 C-m-2 
job-5951,5,12,4,297039,297039,297386,0,347,297501,true,L-l-0 C-m-0 C-m-2 C-m-1 
job-5956,2,5,4,297321,297321,297394,0,73,297610,true,L-s-0 L-m-0 L-m-0 L-m-0 
job-5957,2,5,2,297365,297365,297430,0,65,297584,true,L-s-0 L-m-0 
job-5958,2,7,7,297414,297414,297491,0,77,297587,true,L-s-0 L-m-0 L-m-0 L-m-0 L-l-0 L-l-0 L-l-0 
job-5959,4,5,5,297457,297457,297509,0,52,297517,true,L-l-0 C-s-2 C-s-1 C-s-0 C-m-0 
job-5960,5,7,8,297512,297512,297598,0,86,297819,true,L-m-0 L-l-0 L-l-0 C-m-0 C-m-2 C-m-1 C-l-0 C-l-0 
job-5961,1,6,1,297568,297568,297713,0,145,297940,true,L-m-0 
job-5964,1,7,1,297739,297739,297798,0,59,298013,true,L-s-0 
job-5963,1,9,8,297693,297693,297838,0,145,297859,true,L-m-0 C-s-1 C-s-0 C-m-0 C-m-0 C-m-0 C-m-2 C-m-2 
job-5962,3,8,8,297626,297626,297875,0,249,298155,true,L-m-0 L-m-0 L-s-0 L-l-0 L-l-0 L-l-0 L-l-0 C-s-2 
job-5969,2,6,1,297978,297978,297998,0,20,298108,true,L-m-0 
job-5965,4,4,4,297779,297779,298000,0,221,298001,true,C-m-0 C-m-2 C-m-1 C-m-1 
job-5966,6,5,3,297827,297827,298006,0,179,298225,true,C-l-0 C-l-0 C-l-2 
job-5967,2,5,7,297875,297875,298048,0,173,298085,true,C-m-0 C-m-0 C-m-2 C-m-2 C-l-2 C-l-2 C-l-2 
job-5968,2,11,5,297926,297926,298065,0,139,298298,true,L-s-0 L-m-0 L-m-0 L-l-0 L-l-0 
job-5970,6,8,5,298042,298042,298091,0,49,298125,true,L-l-0 C-l-2 C-m-1 C-l-0 C-l-0 
job-5972,5,9,8,298140,298140,298155,0,15,298317,true,C-m-0 C-m-2 C-m-1 C-l-2 C-l-2 C-l-0 C-l-0 C-l-1 
job-5971,2,11,8,298100,298100,298258,0,158,298515,true,L-s-0 L-m-0 L-m-0 L-l-0 L-l-0 L-l-0 L-l-0 C-s-2 
job-5973,1,12,1,298193,298193,298288,0,95,298321,true,C-s-1 
job-5975,1,7,2,298303,298303,298376,0,73,298500,true,C-m-0 C-m-2 
job-5974,3,11,5,298249,298249,298415,0,166,298681,true,C-s-0 C-m-0 C-m-0 C-m-2 C-m-2 
job-5976,2,5,5,298364,298364,298420,0,56,298699,true,L-s-0 L-s-0 L-m-0 L-m-0 L-m-0 
job-5978,4,9,2,298476,298476,298497,0,21,298653,true,L-m-0 L-l-0 
job-5979,5,6,5,298517,298517,298566,0,49,298779,true,L-l-0 L-l-0 C-m-0 C-m-2 C-m-1 
job-5981,6,10,3,298612,298612,298626,0,14,298862,true,L-l-0 C-m-0 C-m-2 
job-5977,2,4,4,298429,298429,298644,0,215,298709,true,L-s-0 L-s-0 L-m-0 L-m-0 
job-5982,6,7,5,298661,298661,298706,0,45,298812,true,L-l-0 C-m-0 C-m-2 C-m-1 C-l-2 
job-5980,2,11,7,298561,298561,298752,0,191,298940,true,L-m-0 L-m-0 L-l-0 C-m-0 C-m-2 C-m-1 C-s-0 
job-5983,3,8,7,298709,298709,298759,0,50,298941,true,L-m-0 L-l-0 L-l-0 L-l-0 C-m-0 C-m-0 C-m-2 
job-5985,3,8,7,298830,298830,298847,0,17,298895,true,L-l-0 L-l-0 L-l-0 L-l-0 C-s-0 C-s-2 C-s-1 
job-5988,1,7,5,298963,298963,298981,0,18,299102,true,C-m-2 C-m-2 C-m-2 C-m-2 C-m-1 
job-5984,4,10,3,298767,298767,298983,0,216,299053,true,L-s-0 L-m-0 L-m-0 
job-5990,1,5,2,299076,299076,299107,0,31,299233,true,L-m-0 L-m-0 
job-5989,5,7,1,299030,299030,299132,0,102,299333,true,L-m-0 
job-5987,1,11,2,298918,298918,299140,0,222,299202,true,C-m-0 C-m-0 
job-5986,3,10,8,298874,298874,299197,0,323,299348,true,L-l-0 L-l-0 L-l-0 L-l-0 C-s-0 C-s-2 C-s-1 C-m-0 
job-5992,5,9,4,299185,299185,299226,0,41,299345,true,C-m-0 L-m-0 C-l-2 C-l-2 
job-5991,5,7,2,299130,299130,299234,0,104,299429,true,C-m-2 C-m-1 
job-5993,6,7,3,299218,299218,299290,0,72,299577,true,L-l-0 L-l-0 C-l-0 
job-5994,3,9,2,299275,299275,299401,0,126,299474,true,C-l-0 C-l-0 
job-5995,3,7,4,299326,299326,299442,0,116,299546,true,C-l-0 C-l-0 L-s-0 L-m-0 
job-5997,2,11,6,299422,299422,299442,0,20,299473,true,C-l-0 C-l-0 C-l-0 L-l-0 L-l-0 L-l-0 
job-5999,6,4,3,299507,299507,299536,0,29,299795,true,L-l-0 L-l-0 C-m-0 
job-6000,2,4,8,299548,299548,299586,0,38,299650,true,L-s-0 L-l-0 L-l-0 L-l-0 L-l-0 L-l-0 L-l-0 C-s-0 
job-5996,2,5,2,299376,299376,299591,0,215,299809,true,L-m-0 L-m-0 
job-5998,2,6,3,299467,299467,299717,0,250,299856,true,L-m-0 L-m-0 L-s-0 
job-6002,3,8,5,299654,299654,299718,0,64,299891,true,L-l-0 L-l-0 L-l-0 C-s-0 C-s-2 
job-6003,5,5,7,299695,299695,299824,0,129,300031,true,C-m-0 C-m-2 C-m-1 C-l-0 C-l-0 C-l-2 C-l-2 
job-6006,4,10,7,299839,299839,299865,0,26,300009,true,C-s-0 C-s-2 C-s-1 C-l-2 C-l-2 C-l-2 C-l-1 
job-6005,1,12,3,299798,299824,299917,26,93,300070,true,L-m-0 C-m-0 C-m-2 
job-6001,2,9,4,299600,299600,299948,0,348,300074,true,L-s-0 L-m-0 L-m-0 L-l-0 
job-6004,5,9,7,299747,299824,299973,77,149,300114,true,L-l-0 L-l-0 C-m-0 C-m-2 C-m-1 C-l-0 C-l-0 
job-6009,4,10,5,300008,300008,300077,0,69,300222,true,C-s-2 C-s-1 C-l-0 C-l-0 C-l-0 
job-6008,2,7,8,299950,299973,300113,23,140,300286,true,L-m-0 C-m-0 C-m-2 C-m-1 L-s-0 L-s-0 C-s-0 C-s-0 
job-6007,6,6,6,299895,299973,300141,78,168,300165,true,L-m-0 L-l-0 L-l-0 C-m-0 C-m-2 C-m-1 
job-6013,4,7,7,300197,300197,300229,0,32,300487,true,L-l-0 L-s-0 C-s-0 C-s-2 C-s-1 C-m-0 C-m-0 
job-6010,5,5,1,300052,300052,300283,0,231,300387,true,C-l-2 
job-6012,5,5,2,300149,300149,300324,0,175,300537,true,L-m-0 L-l-0 
job-6011,1,6,7,300105,300105,300376,0,271,300659,true,C-l-2 C-l-2 C-l-2 C-l-2 C-l-2 C-l-2 C-l-2 
job-6015,5,11,6,300298,300324,300406,26,82,300532,true,L-l-0 L-m-0 C-m-1 C-l-0 C-l-0 C-l-1 
job-6014,6,10,3,300252,300252,300456,0,204,300493,true,L-l-0 C-m-0 C-m-2 
job-6016,1,10,7,300349,300349,300480,0,131,300608,true,L-m-0 L-m-0 L-l-0 C-m-0 C-m-0 C-m-2 C-m-2 
job-6017,5,6,5,300392,300406,300511,14,105,300601,true,L-m-0 L-l-0 C-m-1 C-l-0 C-l-0 
job-6018,3,11,2,300432,300432,300545,0,113,300750,true,C-m-1 L-s-0 
job-6020,2,12,8,300524,300524,300592,0,68,300628,true,L-l-0 L-l-0 L-l-0 C-m-1 L-m-0 L-m-0 C-m-2 C-m-2 
job-6019,4,4,6,300480,300480,300598,0,118,300878,true,L-l-0 C-s-0 C-s-2 C-s-1 C-m-0 C-m-0 
job-6023,3,9,3,300668,300668,300683,0,15,300708,true,C-l-2 C-l-2 L-s-0 
job-6022,2,9,2,300624,300624,300769,0,145,301036,true,C-m-1 C-l-0 
job-6025,3,4,7,300760,300760,300776,0,16,300862,true,L-l-0 L-l-0 C-l-2 C-s-0 C-s-2 C-s-1 C-m-0 
job-6024,4,4,5,300705,300705,300793,0,88,300843,true,C-l-2 L-s-0 L-m-0 L-m-0 L-l-0 
job-6021,5,11,6,300570,300570,300823,0,253,300825,true,C-m-1 C-l-0 C-l-0 C-l-1 C-l-1 C-l-2 
job-6026,6,7,2,300803,300803,300965,0,162,301242,true,C-l-2 L-m-0 
job-6028,5,7,2,300908,300908,300975,0,67,301185,true,C-m-0 C-m-2 
job-6029,3,5,5,300958,300958,301051,0,93,301087,true,C-m-1 C-m-0 C-m-2 L-s-0 C-s-0 
job-6031,6,4,3,301058,301058,301085,0,27,301262,true,C-l-0 C-l-0 C-l-1 
job-6030,4,6,5,301006,301006,301189,0,183,301278,true,C-m-0 C-m-2 C-l-2 L-m-0 L-m-0 
job-6032,5,10,7,301096,301189,301249,93,60,301210,false,C-l-2 L-m-0 C-m-0 C-m-2 C-l-0 C-l-0 C-l-1 
job-6033,6,10,4,301140,301249,301286,109,37,301462,true,C-l-2 L-m-0 C-m-0 C-m-2 
job-6035,4,9,4,301255,301255,301309,0,54,301329,true,L-s-0 C-s-0 C-s-2 C-s-1 
job-6036,1,8,2,301302,301302,301318,0,16,301542,true,L-m-0 L-m-0 
job-6027,5,10,4,300865,300865,301362,0,497,301516,true,C-l-2 L-l-0 L-l-0 C-m-1 
job-6034,1,4,2,301199,301249,301419,50,170,301404,false,L-m-0 L-m-0 
job-6039,2,4,8,301464,301464,301485,0,21,301704,true,L-m-0 L-m-0 L-l-0 L-s-0 L-s-0 C-s-0 C-s-0 C-s-2 
job-6038,4,6,2,301407,301407,301524,0,117,301700,true,L-l-0 L-l-0 
job-6037,1,7,5,301355,301355,301549,0,194,301705,true,L-m-0 L-m-0 L-m-0 L-l-0 L-l-0 
job-6040,6,12,6,301514,301514,301585,0,71,301764,true,C-m-1 C-m-0 C-m-2 C-l-2 C-l-2 C-l-0 
job-6041,6,10,2,301567,301567,301613,0,46,301812,true,C-l-0 L-m-0 
job-6042,2,5,1,301618,301618,301693,0,75,301796,true,L-s-0 
job-6043,1,5,5,301676,301676,301787,0,111,302063,true,L-s-0 L-s-0 L-m-0 L-m-0 L-m-0 
job-6046,3,6,2,301814,301814,301846,0,32,302101,true,L-s-0 L-m-0 
job-6044,2,12,1,301723,301723,301854,0,131,302111,true,L-m-0 
job-6045,1,6,5,301771,301771,301866,0,95,301876,true,L-s-0 L-l-0 L-l-0 L-l-0 L-l-0 
job-6047,4,10,1,301865,301865,301915,0,50,302056,true,L-l-0 
job-6048,6,10,5,301917,301917,301943,0,26,302208,true,L-m-0 L-l-0 L-l-0 C-m-1 C-m-0 
job-6049,4,4,5,301975,301975,302017,0,42,302267,true,L-s-0 L-m-0 L-m-0 L-l-0 L-l-0 
job-6052,2,6,6,302122,302122,302137,0,15,302182,true,L-m-0 C-m-1 C-m-0 C-m-0 C-m-0 C-m-0 
job-6050,3,7,5,302030,302030,302149,0,119,302287,true,L-s-0 L-m-0 L-m-0 L-l-0 L-l-0 
job-6053,1,9,8,302177,302177,302187,0,10,302329,true,L-l-0 L-l-0 L-l-0 C-m-1 L-s-0 L-m-0 L-m-0 L-m-0 
job-6051,3,8,7,302061,302061,302191,0,130,302235,true,L-l-0 L-l-0 C-s-0 C-s-2 C-s-1 C-m-1 C-m-1 
job-6054,6,12,3,302245,302245,302255,0,10,302469,true,L-m-0 L-l-0 L-l-0 
job-6056,2,9,1,302339,302339,302361,0,22,302410,true,L-m-0 
job-6057,1,11,7,302392,302392,302534,0,142,302690,true,L-m-0 L-l-0 L-l-0 C-s-0 C-s-2 C-s-1 C-m-1 
job-6055,3,7,6,302291,302291,302546,0,255,302703,true,L-s-0 L-m-0 L-m-0 L-l-0 L-l-0 L-l-0 
job-6059,1,10,1,302492,302492,302584,0,92,302650,true,C-l-2 
job-6058,2,12,7,302446,302446,302608,0,162,302611,true,C-m-1 C-m-0 C-m-0 C-m-2 C-m-2 C-l-2 C-l-2 
job-6061,2,12,4,302593,302593,302611,0,18,302850,true,L-m-0 L-l-0 L-l-0 L-l-0 
job-6060,1,6,4,302544,302544,302618,0,74,302711,true,L-s-0 L-m-0 L-m-0 L-l-0 
job-6064,6,6,6,302736,302736,302771,0,35,302945,true,C-l-2 C-l-2 C-l-0 C-l-0 C-l-1 C-l-1 
job-6062,5,12,6,302642,302642,302836,0,194,302934,true,L-m-0 L-l-0 L-l-0 C-m-0 C-m-2 C-m-1 
job-6065,2,11,6,302782,302782,302884,0,102,303042,true,L-l-0 C-s-1 C-l-2 C-l-2 C-l-2 C-l-2 
job-6067,3,5,8,302868,302868,302963,0,95,303095,true,L-m-0 L-l-0 L-l-0 L-l-0 C-m-0 C-m-2 C-m-1 C-l-1 
job-6066,6,9,2,302818,302818,303000,0,182,303246,true,C-l-0 C-l-0 
job-6070,4,10,8,303013,303013,303065,0,52,303319,true,C-m-0 C-m-2 C-m-1 C-l-1 L-l-0 L-l-0 L-l-0 C-l-0 
job-6063,3,11,7,302688,302688,303105,0,417,303314,true,L-m-0 C-m-0 C-m-2 C-m-1 L-s-0 C-s-0 C-s-2 
job-6068,4,5,6,302911,302911,303122,0,211,303131,true,C-l-1 C-l-1 C-s-1 C-l-2 C-l-2 C-l-2 
job-6071,2,9,1,303068,303068,303184,0,116,303215,true,L-m-0 
job-6069,1,4,3,302963,302963,303230,0,267,303469,true,L-s-0 L-m-0 L-m-0 
job-6073,5,11,5,303181,303181,303249,0,68,303377,true,C-m-0 C-m-2 C-m-1 C-l-2 C-l-2 
job-6072,4,4,6,303131,303131,303276,0,145,303568,true,L-m-0 L-l-0 L-l-0 L-l-0 C-s-0 C-s-2 
job-6075,2,7,7,303273,303273,303330,0,57,303457,true,L-m-0 L-m-0 C-m-0 C-m-2 C-m-1 L-s-0 L-s-0 
job-6074,6,10,5,303230,303249,303373,19,124,303514,true,C-m-0 C-m-2 C-m-1 C-l-2 C-l-2 
job-6076,6,5,8,303340,303373,303443,33,70,303573,true,L-m-0 L-l-0 L-l-0 C-m-0 C-m-2 C-m-1 C-l-2 C-l-2 
job-6078,4,4,8,303432,303443,303467,11,24,303519,true,L-m-0 L-m-0 L-l-0 L-l-0 L-l-0 C-m-0 C-m-0 C-m-2 
job-6079,3,11,2,303487,303487,303537,0,50,303725,true,L-m-0 L-m-0 
job-6077,3,7,8,303387,303387,303547,0,160,303692,true,L-s-0 C-s-0 C-s-2 C-s-1 C-l-1 C-l-1 C-l-1 C-l-1 
job-6081,2,4,5,303576,303576,303594,0,18,303668,true,L-l-0 C-m-0 C-m-2 C-m-1 C-l-2 
job-6082,2,9,7,303620,303620,303667,0,47,303688,true,L-l-0 C-m-0 C-m-2 C-m-1 C-l-2 C-l-2 C-l-2 
job-6083,1,6,1,303677,303677,303711,0,34,303786,true,L-l-0 
job-6080,5,9,6,303528,303528,303756,0,228,304000,true,L-l-0 L-l-0 C-m-0 C-m-2 C-m-1 C-l-2 
job-6085,2,5,6,303776,303776,303804,0,28,304096,true,C-m-0 C-m-0 C-m-2 C-m-2 C-m-1 C-m-1 
job-6084,3,10,3,303724,303724,303891,0,167,303992,true,C-m-0 C-m-2 C-m-1 
job-6087,1,6,2,303873,303873,303926,0,53,303994,true,L-m-0 L-m-0 
job-6086,5,9,6,303829,303829,303985,0,156,304033,true,C-m-0 C-m-2 C-m-1 L-m-0 L-l-0 L-l-0 
job-6088,5,4,5,303934,303934,304060,0,126,304317,true,C-l-2 C-l-2 C-l-1 C-l-1 C-l-0 
job-6090,4,5,4,304026,304026,304084,0,58,304356,true,L-s-0 L-l-0 L-l-0 L-l-0 
job-6089,6,10,2,303980,303985,304130,5,145,304173,true,C-l-0 L-m-0 
job-6091,2,7,2,304080,304080,304152,0,72,304424,true,L-m-0 C-l-0 
job-6093,4,11,6,304190,304190,304293,0,103,304374,true,L-l-0 L-l-0 C-s-0 C-s-2 C-s-1 C-m-0 
job-6094,3,10,7,304233,304233,304296,0,63,304338,true,C-m-0 C-l-0 C-m-2 C-m-2 C-m-1 C-m-1 C-l-2 
job-6092,3,11,7,304136,304136,304298,0,162,304581,true,L-m-0 L-m-0 C-l-0 C-l-0 C-l-0 L-s-0 L-l-0 
job-6095,5,6,7,304279,304296,304448,17,152,304466,true,L-l-0 C-m-2 C-m-1 C-m-0 C-l-2 C-l-2 C-l-1 
job-6097,4,8,8,304387,304448,304476,61,28,304505,true,C-l-2 L-s-0 C-s-0 C-s-2 C-s-1 C-l-1 C-l-1 C-l-1 
job-6096,6,6,7,304325,304448,304512,123,64,304521,true,L-m-0 L-l-0 L-l-0 C-m-2 C-m-1 C-m-0 C-l-2 
job-6098,1,9,1,304435,304448,304518,13,70,304594,true,L-m-0 
job-6099,6,9,2,304477,304477,304575,0,98,304765,true,C-l-2 C-l-1 
job-6101,4,9,3,304584,304584,304723,0,139,304980,true,C-l-2 C-l-1 C-l-1 
job-6100,2,6,5,304529,304529,304786,0,257,304918,true,C-l-2 C-l-2 C-l-2 C-l-1 C-l-1 
job-6103,1,7,8,304692,304692,304788,0,96,304849,true,L-m-0 L-l-0 L-l-0 L-l-0 C-l-2 C-s-0 C-s-0 C-s-2 
job-6102,1,11,6,304638,304638,304813,0,175,305048,true,C-l-2 L-s-0 L-m-0 L-m-0 L-l-0 L-l-0 
job-6105,3,9,8,304786,304786,304818,0,32,304838,true,C-s-2 C-l-2 C-l-2 C-l-1 C-l-1 C-l-1 C-s-1 C-m-2 
job-6104,1,10,3,304747,304747,304827,0,80,304943,true,C-l-2 C-l-1 C-l-1 
job-6107,5,12,1,304889,304889,304969,0,80,305186,true,C-m-0 
job-6108,3,8,2,304937,304937,304985,0,48,304993,true,C-m-0 L-s-0 
job-6106,6,8,5,304846,304846,304988,0,142,305064,true,L-m-0 L-l-0 L-l-0 C-m-2 C-m-1 
job-6109,5,11,5,304994,304994,305029,0,35,305135,true,L-m-0 L-l-0 L-l-0 C-m-2 C-m-1 
job-6110,2,5,2,305040,305040,305059,0,19,305065,true,L-s-0 L-s-0 
job-6111,5,8,1,305093,305093,305106,0,13,305207,true,L-m-0 
job-6113,1,5,5,305192,305192,305221,0,29,305294,true,L-s-0 L-m-0 L-m-0 C-s-0 C-s-2 
job-6112,3,8,8,305133,305133,305358,0,225,305436,true,L-s-0 L-m-0 L-m-0 L-l-0 L-l-0 L-l-0 L-l-0 C-s-0 
job-6117,5,8,3,305392,305392,305458,0,66,305611,true,L-m-0 C-l-2 L-l-0 
job-6115,3,12,2,305304,305304,305469,0,165,305566,true,C-l-2 C-l-2 
job-6114,3,5,8,305251,305251,305521,0,270,305675,true,C-s-2 C-s-1 C-m-2 C-m-2 C-m-1 C-m-1 C-m-0 C-m-0 
job-6116,1,9,8,305342,305342,305521,0,179,305565,true,L-m-0 C-s-2 C-s-1 C-m-2 C-m-2 C-m-1 C-m-1 C-m-0 
job-6119,6,10,8,305492,305492,305578,0,86,305831,true,L-m-0 L-l-0 C-l-2 C-l-2 C-l-1 C-l-1 C-l-0 C-l-0 
job-6120,2,7,8,305543,305543,305659,0,116,305908,true,L-m-0 L-l-0 C-s-2 C-s-2 C-s-1 C-s-1 C-m-2 C-m-2 
job-6118,4,7,3,305440,305440,305693,0,253,305893,true,L-l-0 L-s-0 C-s-0 
job-6121,6,4,8,305587,305587,305912,0,325,305995,true,L-m-0 L-l-0 C-m-1 C-m-0 C-l-2 C-l-2 C-l-1 C-l-1 
job-6127,1,7,3,305885,305912,305927,27,15,306112,true,C-m-0 C-m-0 C-m-2 
job-6126,5,6,2,305831,305912,305930,81,18,306113,true,C-l-0 C-l-0 
job-6125,6,11,1,305793,305912,305932,119,20,305883,false,C-l-1 
job-6128,2,10,5,305934,305934,305948,0,14,306005,true,C-m-0 C-m-2 C-l-1 C-l-1 C-l-1 
job-6122,6,5,6,305638,305912,305959,274,47,305868,false,L-m-0 L-l-0 L-l-0 C-m-1 C-m-0 C-m-2 
job-6130,5,9,5,306039,306039,306063,0,24,306121,true,C-l-1 L-l-0 L-l-0 C-m-0 C-m-2 
job-6124,6,9,3,305741,305912,306088,171,176,306056,false,C-l-2 C-l-2 C-l-1 
job-6131,4,5,8,306086,306086,306171,0,85,306270,true,C-m-1 C-l-1 L-s-0 L-l-0 L-l-0 L-l-0 C-s-0 C-s-2 
job-6123,2,9,2,305692,305912,306171,220,259,306088,false,L-m-0 C-m-1 
job-6129,1,6,5,305998,305998,306275,0,277,306335,true,L-m-0 L-m-0 L-m-0 C-m-1 C-m-1 
job-6135,2,10,3,306276,306276,306297,0,21,306494,true,L-m-0 L-m-0 C-m-1 
job-6134,2,12,7,306211,306211,306322,0,111,306437,true,C-l-2 C-l-2 L-s-0 L-l-0 L-l-0 L-l-0 L-l-0 
job-6136,1,8,5,306328,306328,306407,0,79,306530,true,L-m-0 L-m-0 C-m-0 C-m-2 C-m-1 
job-6138,3,11,2,306417,306417,306443,0,26,306610,true,L-m-0 C-m-1 
job-6133,1,11,5,306182,306182,306446,0,264,306635,true,L-m-0 C-m-1 C-l-1 C-l-1 C-l-2 
job-6137,1,7,6,306375,306375,306481,0,106,306539,true,C-m-1 C-l-2 C-l-2 C-l-2 L-s-0 L-s-0 
job-6139,1,9,4,306468,306468,306514,0,46,306607,true,C-m-1 C-m-1 C-l-2 C-l-1 
job-6132,3,12,8,306144,306144,306537,0,393,306826,true,C-l-1 C-l-1 C-s-1 C-m-0 C-m-0 C-m-2 C-m-2 C-l-2 
job-6143,4,12,3,306667,306667,306740,0,73,306786,true,C-s-2 C-m-0 C-m-0 
job-6142,2,11,4,306621,306621,306748,0,127,306967,true,L-m-0 L-s-0 C-s-1 C-s-0 
job-6140,6,11,5,306521,306521,306807,0,286,306822,true,C-l-1 C-l-2 L-m-0 L-l-0 L-l-0 
job-6141,3,9,4,306578,306578,306812,0,234,306885,true,C-l-1 C-l-1 C-l-2 C-l-2 
job-6145,6,5,5,306755,306807,306913,52,106,307000,true,C-l-1 C-l-2 L-m-0 L-l-0 L-l-0 
job-6147,4,6,8,306858,306913,306936,55,23,307022,true,L-m-0 L-m-0 L-l-0 L-l-0 L-l-0 C-m-1 C-m-1 C-l-1 
job-6144,4,8,2,306717,306717,306977,0,260,306983,true,C-m-2 C-m-2 
job-6146,3,8,6,306810,306810,306986,0,176,306988,true,L-s-0 C-s-2 C-s-1 C-s-0 C-m-0 C-m-0 
job-6149,1,7,2,306955,306955,306988,0,33,307184,true,L-s-0 C-s-2 
job-6148,3,10,6,306901,306913,307064,12,151,307117,true,C-l-1 C-l-1 C-l-2 C-l-2 C-l-2 C-l-2 
job-6151,1,8,1,307044,307044,307078,0,34,307143,true,L-m-0 
job-6150,5,7,5,306989,306989,307112,0,123,307283,true,C-l-1 L-m-0 L-l-0 L-l-0 C-m-2 
job-6153,6,9,2,307153,307153,307171,0,18,307359,true,C-l-1 L-m-0 
job-6154,1,8,5,307199,307199,307292,0,93,307424,true,C-m-0 C-m-0 C-m-1 C-m-1 C-l-1 
job-6156,1,9,5,307295,307295,307305,0,10,307339,true,L-m-0 L-m-0 C-m-0 C-m-0 C-m-1 
job-6155,6,5,6,307254,307254,307367,0,113,307372,true,L-m-0 L-l-0 L-l-0 C-m-2 C-l-2 C-l-2 
job-6152,6,7,3,307107,307107,307398,0,291,307600,true,C-l-1 C-m-0 C-m-1 
job-6158,5,7,4,307408,307408,307426,0,18,307574,true,C-l-1 C-l-0 L-m-0 L-l-0 
job-6157,5,5,2,307351,307351,307552,0,201,307677,true,C-l-1 C-l-0 
job-6159,1,5,2,307462,307462,307575,0,113,307766,true,C-l-1 C-l-1 
job-6161,2,9,8,307558,307558,307643,0,85,307708,true,L-m-0 L-l-0 C-m-0 C-m-1 C-m-2 C-l-1 C-l-1 C-l-0 
job-6160,5,11,8,307513,307513,307677,0,164,307829,true,C-l-1 C-l-0 L-m-0 L-l-0 L-l-0 C-m-0 C-m-1 C-m-2 
job-6163,1,5,2,307647,307647,307677,0,30,307891,true,L-m-0 L-m-0 
job-6164,2,12,3,307698,307698,307791,0,93,307945,true,L-m-0 L-m-0 C-m-0 
job-6166,3,5,5,307798,307798,307848,0,50,308041,true,L-m-0 L-m-0 L-l-0 L-l-0 L-l-0 
job-6162,1,4,3,307600,307600,307855,0,255,307900,true,L-m-0 C-m-0 C-m-1 
job-6165,3,10,5,307741,307741,307899,0,158,308014,true,C-m-0 C-m-1 C-m-1 L-s-0 L-l-0 
job-6167,6,12,5,307849,307849,308005,0,156,308037,true,L-m-0 L-l-0 C-m-2 C-l-1 C-l-1 
job-6169,1,11,3,307955,307955,308021,0,66,308127,true,L-m-0 C-m-2 C-m-1 
job-6171,3,7,5,308042,308042,308053,0,11,308245,true,L-l-0 L-l-0 C-l-0 L-m-0 L-m-0 
job-6168,6,5,2,307906,307906,308159,0,253,308211,true,L-l-0 C-m-1 
job-6172,5,10,8,308086,308159,308185,73,26,308193,true,L-m-0 L-l-0 L-l-0 C-m-1 C-m-2 C-l-1 C-l-1 C-l-2 
job-6170,4,12,8,307999,307999,308294,0,295,308326,true,L-s-0 C-s-2 C-s-1 C-s-0 C-m-0 C-m-0 C-l-0 C-l-0 
job-6174,5,8,4,308198,308198,308297,0,99,308472,true,L-m-0 L-l-0 L-l-0 C-m-1 
job-6173,2,5,6,308148,308159,308391,11,232,308496,true,L-m-0 L-l-0 C-m-1 C-m-2 C-l-1 C-l-0 
job-6176,5,11,4,308314,308391,308421,77,30,308353,false,L-l-0 C-l-0 C-l-1 C-l-2 
job-6177,1,12,2,308357,308391,308485,34,94,308714,true,L-m-0 L-m-0 
job-6178,1,9,5,308401,308401,308566,0,165,308567,true,L-l-0 C-m-1 C-m-1 C-m-2 C-m-2 
job-6175,6,7,7,308253,308297,308639,44,342,308691,true,L-m-0 L-l-0 C-m-1 C-m-2 C-l-0 C-l-1 C-m-0 
job-6179,5,4,6,308444,308639,308661,195,22,308701,true,L-m-0 L-l-0 L-l-0 C-m-1 C-m-2 C-m-0 
job-6180,6,4,5,308506,308639,308680,133,41,308583,false,C-l-0 C-l-0 C-l-1 C-l-1 C-l-2 
job-6182,1,9,6,308602,308661,308769,59,108,308863,true,L-m-0 L-m-0 L-l-0 L-l-0 C-m-1 C-m-1 
job-6183,5,11,2,308648,308661,308880,13,219,308978,true,C-m-2 C-m-0 
job-6181,5,8,5,308555,308661,308892,106,231,308900,true,C-l-2 L-m-0 L-l-0 L-l-0 C-m-1 
job-6184,6,9,7,308709,308880,308948,171,68,308896,false,C-l-2 C-m-2 C-m-0 C-l-0 C-l-0 C-l-1 C-l-1 
job-6185,5,11,7,308752,308948,309031,196,83,309035,true,L-m-0 L-l-0 L-l-0 C-m-2 C-m-0 C-m-1 C-l-0 
job-6186,6,8,6,308806,309031,309058,225,27,309074,true,L-m-0 L-l-0 L-l-0 C-m-2 C-m-0 C-m-1 
job-6187,4,5,3,308849,309031,309085,182,54,308994,false,L-s-0 C-s-2 C-s-1 
job-6188,1,5,4,308900,309031,309106,131,75,309146,true,L-m-0 L-m-0 C-m-2 C-m-2 
job-6192,2,5,5,309091,309091,309128,0,37,309258,true,C-l-2 L-s-0 L-s-0 C-s-2 C-s-2 
job-6190,2,4,8,308999,309058,309155,59,97,309283,true,L-m-0 L-m-0 L-m-0 C-m-2 C-m-2 C-m-2 C-l-2 C-l-2 
job-6191,4,11,6,309042,309058,309212,16,154,309237,true,L-l-0 L-l-0 L-l-0 C-s-0 C-m-0 C-m-0 
job-6193,6,5,5,309135,309212,309254,77,42,309449,true,C-l-2 L-m-0 L-l-0 L-l-0 C-m-0 
job-6195,5,8,6,309230,309254,309350,24,96,309562,true,C-m-2 C-l-2 L-m-0 L-l-0 L-l-0 C-m-0 
job-6194,3,6,5,309183,309212,309370,29,158,309444,true,L-s-0 C-s-0 C-s-2 C-s-1 C-m-2 
job-6189,6,5,5,308948,309031,309535,83,504,309618,true,C-l-0 C-l-0 C-l-1 C-l-1 C-l-2 
job-6198,6,6,8,309377,309535,309561,158,26,309453,false,L-l-0 C-m-0 C-l-2 C-m-1 C-l-0 C-l-0 C-l-1 C-l-1 
job-6197,2,12,8,309329,309350,309567,21,217,309750,true,L-l-0 L-l-0 C-m-2 C-m-2 C-l-2 C-l-2 C-l-2 C-m-0 
job-6196,1,7,7,309277,309277,309590,0,313,309714,true,L-s-0 L-m-0 L-m-0 L-m-0 L-l-0 L-l-0 C-s-0 
job-6200,5,9,3,309458,309561,309603,103,42,309619,true,L-m-0 C-l-0 C-l-0 
job-6203,4,7,8,309610,309610,309641,0,31,309654,true,L-l-0 C-m-2 C-l-1 C-l-2 C-l-0 C-l-0 L-s-0 L-m-0 
job-6201,2,10,4,309509,309561,309644,52,83,309849,true,C-m-1 C-l-0 C-s-2 C-s-1 
job-6202,4,6,3,309558,309561,309689,3,128,309957,true,C-m-2 C-l-1 C-l-1 
job-6199,6,8,4,309421,309561,309713,140,152,309687,false,L-l-0 C-m-0 C-l-2 C-m-1 
job-6204,1,9,6,309670,309670,309765,0,95,309911,true,L-l-0 L-l-0 L-l-0 L-l-0 C-m-1 C-m-1 
job-6206,1,4,4,309777,309777,309813,0,36,309846,true,L-s-0 L-s-0 L-l-0 L-l-0 
job-6208,6,11,5,309893,309893,309917,0,24,310147,true,L-m-0 C-m-0 C-m-2 C-l-1 C-l-1 
job-6207,6,11,1,309827,309827,309990,0,163,310115,true,L-l-0 
job-6210,6,5,5,309998,309998,310029,0,31,310263,true,L-m-0 L-l-0 C-m-0 C-m-2 C-l-1 
job-6209,1,7,7,309950,309950,310063,0,113,310236,true,L-s-0 L-l-0 L-l-0 C-m-1 C-m-1 L-m-0 L-m-0 
job-6205,2,6,5,309721,309721,310077,0,356,310201,true,L-l-0 L-l-0 C-m-1 C-m-1 L-s-0 
job-6211,1,6,1,310037,310037,310082,0,45,310238,true,L-m-0 
job-6212,1,4,5,310087,310087,310101,0,14,310127,true,L-s-0 L-s-0 L-s-0 L-s-0 L-m-0 
job-6213,1,4,1,310147,310147,310217,0,70,310287,true,L-s-0 
job-6214,3,9,3,310200,310200,310279,0,79,310284,true,L-s-0 L-m-0 L-m-0 
job-6215,2,6,5,310258,310258,310322,0,64,310374,true,L-m-0 L-l-0 L-l-0 L-l-0 L-l-0 
job-6218,4,8,6,310405,310405,310474,0,69,310689,true,L-l-0 C-s-2 C-s-1 C-s-0 C-m-2 C-m-2 
job-6217,6,6,4,310357,310357,310507,0,150,310513,true,L-m-0 L-l-0 C-m-1 C-m-0 
job-6216,1,9,5,310295,310295,310531,0,236,310773,true,L-m-0 L-m-0 L-l-0 L-l-0 L-s-0 
job-6220,5,10,7,310506,310506,310569,0,63,310719,true,C-m-2 C-l-1 C-l-1 C-l-2 C-l-2 C-l-0 C-l-0 
job-6219,1,5,3,310457,310457,310591,0,134,310722,true,L-s-0 C-m-1 C-m-1 
job-6221,2,11,1,310566,310566,310601,0,35,310675,true,L-s-0 
job-6223,6,5,5,310657,310657,310780,0,123,310797,true,C-m-2 C-m-1 C-m-0 C-l-1 C-l-1 
job-6222,4,8,7,310614,310614,310852,0,238,310857,true,L-s-0 L-m-0 L-m-0 L-l-0 L-l-0 L-l-0 C-s-2 
job-6227,1,11,8,310852,310852,310931,0,79,311143,true,C-m-2 C-m-1 L-s-0 L-m-0 L-m-0 L-l-0 L-l-0 L-l-0 
job-6228,2,5,5,310906,310906,310960,0,54,311174,true,L-s-0 L-m-0 L-m-0 L-l-0 L-l-0 
job-6229,6,4,3,310949,310949,310972,0,23,311188,true,L-l-0 C-l-1 C-l-1 
job-6230,6,9,1,310999,310999,311019,0,20,311280,true,L-m-0 
job-6225,2,7,2,310757,310757,311054,0,297,311164,true,C-m-2 C-m-1 
job-6226,4,12,5,310808,310808,311063,0,255,311278,true,C-m-2 C-m-1 C-l-0 C-m-0 C-m-0 
job-6231,1,7,7,311040,311040,311115,0,75,311301,true,C-m-2 C-m-1 L-s-0 L-s-0 L-m-0 L-m-0 L-m-0 
job-6224,4,4,7,310716,310716,311126,0,410,311245,true,C-s-1 C-s-0 C-l-2 C-l-2 C-l-2 C-l-0 C-l-0 
job-6232,4,6,3,311091,311091,311170,0,79,311371,true,L-m-0 C-m-2 C-m-1 
job-6234,4,10,4,311186,311186,311227,0,41,311396,true,L-m-0 C-m-2 C-m-1 L-l-0 
job-6235,5,10,5,311236,311236,311323,0,87,311348,true,L-m-0 C-m-2 C-m-1 L-l-0 L-l-0 
job-6236,2,11,8,311278,311278,311337,0,59,311393,true,L-l-0 C-s-1 C-s-0 C-s-2 C-m-0 C-m-0 C-l-2 C-l-2 
job-6233,3,12,4,311139,311139,311378,0,239,311556,true,L-m-0 C-m-2 C-m-1 L-s-0 
job-6240,2,12,1,311461,311461,311487,0,26,311780,true,L-l-0 
job-6238,2,10,4,311366,311366,311499,0,133,311769,true,L-m-0 L-m-0 L-l-0 L-l-0 
job-6239,3,11,8,311412,311412,311624,0,212,311881,true,L-m-0 C-l-2 C-l-2 C-l-0 C-l-0 L-s-0 C-s-1 C-s-0 
job-6237,6,6,3,311329,311329,311632,0,303,311851,true,L-l-0 C-l-2 C-l-0 
job-6244,2,12,6,311648,311648,311693,0,45,311712,true,L-m-0 C-m-2 C-m-1 C-m-0 L-s-0 C-s-1 
job-6245,1,8,4,311700,311700,311710,0,10,311787,true,L-m-0 L-m-0 C-m-2 C-m-2 
job-6242,5,8,1,311558,311624,311725,66,101,311813,true,C-l-1 
job-6246,2,10,6,311739,311739,311785,0,46,311844,true,L-m-0 C-m-2 C-m-1 C-m-0 C-l-1 C-l-1 
job-6243,6,9,3,311605,311632,311786,27,154,311878,true,L-l-0 C-l-2 C-l-0 
job-6241,6,8,8,311515,311624,312076,109,452,312201,true,L-l-0 C-l-2 C-l-0 L-m-0 C-m-2 C-m-1 C-m-0 C-l-1 
job-6247,5,4,7,311799,312076,312096,277,20,312062,false,L-m-0 L-l-0 L-l-0 C-m-2 C-m-1 C-m-0 C-l-2 
job-6249,6,12,1,311913,312076,312115,163,39,312190,true,C-l-2 
job-6250,3,5,3,311981,312076,312121,95,45,312247,true,C-m-2 C-m-1 C-m-0 
job-6248,2,9,2,311864,312076,312133,212,57,311996,false,L-m-0 L-l-0 
job-6252,2,5,1,312095,312096,312182,1,86,312381,true,L-l-0 
job-6253,2,10,1,312150,312150,312198,0,48,312266,true,L-m-0 
job-6251,6,6,6,312034,312096,312231,62,135,312295,true,L-m-0 L-l-0 C-l-2 C-l-0 C-l-0 C-l-1 
job-6255,2,8,4,312257,312257,312313,0,56,312393,true,L-l-0 L-l-0 L-l-0 L-l-0 
job-6256,6,12,7,312303,312303,312386,0,83,312584,true,C-l-2 C-l-1 L-m-0 C-m-2 C-m-1 C-m-0 C-l-0 
job-6254,4,6,5,312200,312200,312389,0,189,312462,true,L-l-0 C-l-2 C-l-1 L-s-0 C-s-1 
job-6257,5,12,6,312348,312386,312469,38,83,312497,true,L-l-0 C-l-2 C-l-1 L-m-0 C-m-2 C-m-1 
job-6259,2,6,4,312457,312457,312485,0,28,312711,true,L-m-0 C-m-0 C-m-2 C-m-1 
job-6260,4,8,2,312507,312507,312547,0,40,312756,true,L-l-0 C-l-2 
job-6261,6,11,6,312560,312560,312581,0,21,312619,true,L-l-0 C-l-2 C-l-1 C-l-0 L-m-0 C-m-2 
job-6258,6,9,5,312394,312394,312609,0,215,312627,true,L-l-0 C-l-2 C-l-1 C-m-0 C-l-0 
job-6263,6,4,5,312655,312655,312679,0,24,312715,true,L-m-0 L-l-0 L-l-0 C-m-0 C-m-2 
job-6262,1,6,4,312610,312610,312738,0,128,313005,true,L-s-0 L-s-0 L-m-0 L-m-0 
job-6264,1,12,3,312704,312704,312756,0,52,312846,true,L-m-0 L-l-0 L-l-0 
job-6265,5,9,3,312765,312765,312895,0,130,313053,true,L-m-0 L-l-0 L-l-0 
job-6267,1,7,4,312864,312864,312972,0,108,313227,true,L-m-0 L-m-0 L-m-0 L-l-0 
job-6266,5,4,7,312807,312807,313007,0,200,313201,true,C-m-0 C-m-2 C-m-1 C-l-2 C-l-2 C-l-1 C-l-1 
job-6268,5,8,8,312917,313007,313029,90,22,312985,false,L-m-0 L-l-0 L-l-0 C-m-0 C-m-2 C-m-1 C-l-2 C-l-2 
job-6270,5,4,6,313030,313030,313071,0,41,313216,true,C-l-1 L-m-0 L-l-0 L-l-0 C-m-0 C-m-2 
job-6271,4,6,5,313078,313078,313101,0,23,313356,true,C-l-1 C-l-1 L-m-0 L-m-0 L-l-0 
job-6269,4,10,5,312979,313007,313118,28,111,313227,true,L-s-0 C-s-1 C-s-0 C-s-2 C-l-1 
job-6272,3,6,1,313124,313124,313257,0,133,313389,true,L-s-0 
job-6273,3,8,3,313171,313171,313265,0,94,313511,true,L-m-0 L-m-0 L-l-0 
job-6274,3,5,3,313222,313222,313293,0,71,313393,true,L-l-0 L-l-0 L-l-0 
job-6275,5,9,3,313271,313271,313336,0,65,313609,true,L-m-0 C-m-0 C-m-2 
job-6276,6,12,6,313325,313325,313547,0,222,313781,true,L-l-0 L-l-0 C-m-1 C-l-1 C-l-1 C-l-2 
job-6277,2,5,6,313376,313376,313556,0,180,313718,true,C-m-1 C-l-2 C-l-2 C-l-2 L-s-0 L-s-0 
job-6278,4,9,4,313424,313424,313566,0,142,313726,true,L-m-0 L-m-0 C-s-1 C-s-0 
job-6280,6,5,4,313513,313547,313578,34,31,313707,true,C-m-1 C-l-2 L-l-0 L-l-0 
job-6281,4,8,8,313566,313566,313602,0,36,313827,true,C-l-2 L-s-0 L-m-0 L-m-0 C-s-1 C-s-0 C-l-1 C-l-1 
job-6279,4,9,5,313478,313478,313606,0,128,313883,true,C-s-2 C-m-0 C-m-0 C-m-2 C-m-2 
job-6282,4,11,8,313629,313629,313675,0,46,313879,true,L-s-0 L-m-0 L-m-0 L-l-0 L-l-0 L-l-0 C-s-2 C-s-1 
job-6283,2,12,6,313679,313679,313693,0,14,313877,true,L-s-0 L-m-0 L-m-0 L-l-0 L-l-0 L-l-0 
job-6284,5,11,3,313724,313724,313742,0,18,313883,true,L-m-0 L-l-0 L-l-0 
job-6285,5,8,6,313778,313778,313789,0,11,313950,true,L-m-0 L-l-0 L-l-0 C-m-0 C-m-2 C-m-1 
job-6287,2,6,1,313885,313885,313897,0,12,314170,true,L-m-0 
job-6286,6,9,8,313834,313834,313953,0,119,314236,true,L-m-0 L-l-0 L-l-0 C-m-0 C-m-2 C-m-1 C-l-2 C-l-2 
job-6288,1,9,8,313932,313932,314000,0,68,314003,true,L-m-0 L-m-0 C-m-0 C-m-0 C-m-2 C-m-2 C-m-1 C-m-1 
job-6290,2,8,7,314035,314035,314102,0,67,314121,true,L-m-0 L-m-0 C-m-0 C-m-0 L-s-0 L-s-0 L-l-0 
job-6291,5,8,5,314084,314084,314150,0,66,314446,true,L-l-0 L-l-0 C-m-2 C-m-1 C-l-2 
job-6294,5,5,2,314234,314234,314277,0,43,314324,true,C-l-2 L-l-0 
job-6292,6,12,5,314132,314132,314301,0,169,314401,true,C-l-2 C-l-1 C-l-1 C-l-0 C-l-0 
job-6289,4,9,2,313979,313979,314326,0,347,314607,true,L-m-0 C-m-0 
job-6295,1,6,1,314295,314295,314333,0,38,314378,true,C-m-0 
job-6293,2,7,3,314192,314192,314360,0,168,314450,true,L-m-0 L-m-0 C-m-0 
job-6296,5,11,5,314346,314346,314467,0,121,314644,true,C-m-0 L-l-0 L-l-0 C-m-2 C-m-1 
job-6297,4,11,2,314402,314402,314540,0,138,314640,true,L-s-0 L-m-0 
job-6299,5,10,4,314487,314487,314574,0,87,314814,true,C-l-1 L-l-0 L-l-0 C-m-0 
job-6301,3,9,3,314577,314577,314615,0,38,314744,true,L-l-0 L-l-0 L-l-0 
job-6298,6,6,1,314445,314445,314722,0,277,314858,true,C-l-1 
job-6300,2,8,3,314544,314544,314736,0,192,314938,true,L-l-0 C-m-0 L-s-0 
job-6302,5,10,7,314613,314613,314771,0,158,314998,true,C-m-0 C-l-1 L-m-0 C-m-2 C-m-1 C-l-0 C-l-0 
job-6305,1,6,4,314756,314756,314792,0,36,315072,true,L-m-0 L-m-0 L-m-0 L-l-0 
job-6306,6,6,6,314817,314817,314829,0,12,314897,true,L-m-0 C-m-0 C-m-2 C-m-1 C-l-0 C-l-0 
job-6307,6,4,1,314869,314869,314891,0,22,315093,true,L-m-0 
job-6304,4,8,4,314707,314707,314893,0,186,315041,true,C-s-1 C-s-0 C-l-2 C-l-2 
job-6308,3,12,1,314911,314911,314949,0,38,315000,true,L-l-0 
job-6303,4,12,3,314659,314659,315019,0,360,315038,true,L-l-0 L-l-0 C-s-2 
job-6310,1,9,5,315020,315020,315030,0,10,315301,true,L-l-0 L-l-0 L-l-0 L-l-0 L-m-0 
job-6309,4,10,2,314969,314969,315054,0,85,315204,true,L-l-0 L-s-0 
job-6311,2,10,3,315069,315069,315122,0,53,315211,true,L-s-0 L-m-0 L-m-0 
job-6312,6,10,5,315114,315114,315174,0,60,315471,true,L-l-0 L-l-0 C-m-0 C-m-2 C-m-1 
job-6313,5,11,7,315178,315178,315246,0,68,315481,true,L-m-0 L-l-0 L-l-0 C-m-0 C-m-2 C-m-1 C-l-2 
job-6314,5,12,6,315232,315246,315387,14,141,315539,true,L-m-0 L-l-0 L-l-0 C-m-0 C-m-2 C-m-1 
job-6316,3,6,3,315342,315342,315399,0,57,315599,true,C-s-0 C-l-2 C-l-2 
job-6315,3,5,7,315284,315284,315432,0,148,315548,true,L-m-0 C-m-0 C-m-2 C-m-1 L-s-0 C-s-2 C-s-1 
job-6317,6,8,3,315384,315384,315470,0,86,315627,true,C-l-2 C-l-0 C-l-0 
job-6318,5,7,6,315428,315428,315536,0,108,315556,true,L-m-0 C-m-0 C-m-2 C-m-1 C-l-2 L-l-0 
job-6319,6,7,6,315476,315476,315552,0,76,315833,true,L-l-0 C-l-2 C-l-0 C-l-0 C-l-1 C-l-1 
job-6322,3,10,8,315614,315614,315646,0,32,315921,true,L-m-0 L-l-0 L-l-0 L-l-0 L-l-0 C-m-0 C-m-0 C-m-2 
job-6320,4,11,4,315516,315516,315675,0,159,315934,true,L-s-0 C-s-2 C-s-1 C-s-0 
job-6323,2,12,7,315675,315675,315727,0,52,315938,true,L-m-0 L-s-0 L-l-0 L-l-0 L-l-0 L-l-0 C-s-2 
job-6324,5,9,5,315722,315722,315776,0,54,315908,true,C-m-0 C-m-2 C-m-1 C-l-0 C-l-0 
job-6325,6,4,7,315769,315776,315833,7,57,316043,true,L-l-0 L-l-0 C-m-0 C-m-2 C-m-1 C-l-0 C-l-0 
job-6326,1,10,5,315822,315822,315837,0,15,316030,true,L-m-0 L-m-0 C-m-0 C-m-0 C-m-2 
job-6321,4,11,1,315572,315572,315894,0,322,315944,true,L-m-0 
job-6327,5,10,4,315875,315875,315898,0,23,316170,true,L-l-0 L-l-0 C-m-0 C-m-2 
job-6328,4,6,4,315929,315929,315969,0,40,315983,true,L-s-0 L-m-0 L-m-0 L-l-0 
job-6329,3,12,2,315974,315974,315992,0,18,316209,true,L-s-0 L-m-0 
job-6330,2,11,7,316021,316021,316078,0,57,316348,true,L-s-0 L-m-0 L-m-0 L-l-0 L-l-0 L-l-0 L-l-0 
job-6331,4,11,7,316062,316062,316095,0,33,316266,true,C-s-2 C-s-1 C-s-0 C-m-0 C-m-0 C-m-2 C-m-2 
job-6334,1,7,6,316216,316216,316271,0,55,316478,true,L-l-0 L-l-0 L-l-0 L-l-0 C-s-2 C-s-2 
job-6333,3,11,1,316158,316158,316334,0,176,316490,true,L-l-0 
job-6335,4,6,8,316269,316269,316339,0,70,316578,true,C-s-1 C-s-0 C-m-0 C-m-0 C-m-2 C-m-2 C-m-1 C-m-1 
job-6336,4,12,4,316328,316328,316358,0,30,316397,true,L-l-0 C-s-2 C-l-0 C-l-0 
job-6337,3,6,5,316370,316370,316534,0,164,316562,true,L-l-0 L-l-0 C-s-1 C-s-0 C-s-2 
job-6332,4,7,4,316111,316111,316546,0,435,316774,true,L-s-0 L-m-0 L-m-0 L-l-0 
job-6340,4,5,2,316509,316509,316590,0,81,316617,true,C-m-1 C-m-1 
job-6341,1,6,5,316563,316563,316628,0,65,316888,true,L-l-0 L-l-0 L-l-0 L-l-0 L-l-0 
job-6339,6,9,2,316467,316467,316635,0,168,316643,true,C-m-0 C-m-2 
job-6338,2,7,1,316417,316417,316664,0,247,316799,true,L-l-0 
job-6343,2,11,1,316646,316646,316827,0,181,316971,true,L-l-0 
job-6342,4,7,4,316601,316601,316854,0,253,316999,true,L-l-0 L-s-0 L-m-0 L-m-0 
job-6345,6,10,7,316759,316854,316922,95,68,317038,true,L-l-0 C-l-0 L-m-0 C-l-1 C-l-1 C-l-2 C-l-2 
job-6344,6,11,5,316689,316689,316987,0,298,317033,true,L-l-0 C-m-0 C-m-2 C-m-1 C-l-0 
job-6349,2,9,6,316967,316987,317012,20,25,317179,true,L-m-0 C-m-0 C-m-2 C-m-1 C-l-1 L-s-0 
job-6350,3,7,4,317006,317006,317025,0,19,317201,true,C-s-1 C-s-0 C-s-2 C-l-2 
job-6347,6,9,3,316867,316987,317054,120,67,317220,true,L-l-0 C-l-0 C-m-0 
job-6346,5,7,5,316811,316922,317060,111,138,316972,false,L-l-0 C-l-0 L-m-0 C-l-1 C-l-1 
job-6351,1,11,2,317059,317059,317080,0,21,317344,true,L-m-0 L-m-0 
job-6353,2,7,4,317158,317158,317182,0,24,317436,true,C-m-2 C-m-1 C-s-1 C-s-1 
job-6352,4,9,6,317110,317110,317230,0,120,317523,true,L-s-0 L-m-0 L-m-0 L-l-0 L-l-0 L-l-0 
job-6354,4,9,7,317212,317212,317243,0,31,317444,true,C-s-1 C-s-0 C-s-2 C-m-0 C-m-0 C-l-1 C-l-1 
job-6356,4,7,5,317318,317318,317458,0,140,317562,true,L-m-0 L-l-0 L-l-0 L-l-0 C-s-1 
job-6358,2,9,7,317410,317410,317464,0,54,317687,true,C-m-1 C-s-0 C-s-2 C-m-0 C-m-0 C-m-0 C-l-1 
job-6355,4,5,2,317263,317263,317564,0,301,317861,true,L-s-0 L-m-0 
job-6348,5,12,2,316920,316987,317575,67,588,317654,true,C-m-2 C-m-1 
job-6359,2,8,7,317469,317469,317618,0,149,317776,true,L-m-0 L-m-0 C-m-1 L-l-0 L-l-0 L-l-0 L-l-0 
job-6361,4,12,8,317580,317580,317684,0,104,317761,true,L-m-0 L-l-0 C-m-1 C-m-2 L-s-0 C-s-1 C-s-0 C-s-2 
job-6364,1,12,1,317733,317733,317763,0,30,317840,true,L-m-0 
job-6363,5,11,6,317680,317680,317770,0,90,318055,true,L-l-0 C-l-1 C-l-1 C-l-0 C-l-0 C-l-2 
job-6362,2,8,1,317630,317630,317814,0,184,317940,true,L-m-0 
job-6357,1,8,3,317372,317372,317851,0,479,317878,true,C-m-2 C-m-2 C-m-1 
job-6360,6,8,1,317523,317523,317897,0,374,317940,true,C-m-0 
job-6366,4,10,7,317854,317854,317958,0,104,318184,true,C-l-0 L-s-0 C-s-1 C-s-0 C-s-2 C-l-2 C-l-2 
job-6365,5,8,8,317793,317793,317989,0,196,318174,true,L-m-0 C-m-2 C-m-1 L-l-0 L-l-0 C-l-1 C-l-1 C-l-0 
job-6369,3,11,5,317997,317997,318124,0,127,318179,true,L-s-0 C-s-1 C-s-0 C-s-2 C-l-2 
job-6367,6,12,2,317901,317958,318140,57,182,318307,true,C-l-0 C-m-0 
job-6368,6,11,8,317956,317989,318176,33,187,318312,true,C-l-0 L-m-0 L-l-0 L-l-0 C-m-2 C-m-1 C-l-1 C-l-1 
job-6370,6,12,4,318041,318140,318185,99,45,318263,true,C-l-0 C-m-0 C-l-2 C-l-2 
job-6372,4,10,1,318139,318176,318216,37,40,318201,false,L-l-0 
job-6374,1,4,8,318215,318215,318244,0,29,318302,true,L-m-0 L-m-0 L-l-0 L-l-0 C-m-0 C-m-0 C-m-2 C-m-2 
job-6375,3,6,4,318266,318266,318293,0,27,318474,true,L-l-0 L-l-0 L-s-0 C-s-1 
job-6373,6,11,8,318180,318185,318306,5,121,318406,true,C-l-0 C-m-0 C-m-2 C-m-1 C-l-2 C-l-2 C-l-1 C-l-1 
job-6371,6,10,3,318091,318176,318319,85,143,318512,true,C-l-0 L-m-0 L-l-0 
job-6376,2,4,1,318326,318326,318388,0,62,318661,true,L-s-0 
job-6377,4,11,3,318378,318378,318425,0,47,318707,true,L-m-0 L-m-0 L-l-0 
job-6378,6,4,4,318425,318425,318539,0,114,318725,true,L-m-0 L-l-0 L-l-0 C-m-0 
job-6380,6,9,5,318532,318532,318553,0,21,318695,true,C-m-2 C-m-1 C-l-2 C-l-2 C-l-1 
job-6381,4,7,2,318588,318588,318621,0,33,318680,true,L-m-0 C-m-0 
job-6379,1,10,4,318476,318476,318624,0,148,318879,true,L-m-0 L-m-0 C-m-0 C-m-0 
job-6383,3,5,4,318695,318695,318725,0,30,318785,true,L-m-0 L-m-0 L-l-0 L-l-0 
job-6382,3,4,1,318650,318650,318793,0,143,318871,true,L-s-0 
job-6384,2,5,5,318753,318753,318912,0,159,319122,true,L-m-0 L-m-0 L-m-0 L-m-0 L-l-0 
job-6385,1,8,7,318797,318797,318930,0,133,318998,true,L-l-0 L-l-0 L-l-0 L-l-0 L-l-0 L-s-0 L-s-0 
job-6386,3,6,7,318853,318853,318984,0,131,319078,true,C-s-1 C-s-0 C-s-2 C-m-0 C-m-0 C-m-2 C-m-2 
job-6388,4,11,6,318946,318946,319006,0,60,319167,true,L-s-0 L-m-0 L-m-0 L-l-0 L-l-0 L-l-0 
job-6390,1,10,8,319057,319057,319067,0,10,319265,true,L-m-0 L-m-0 C-m-1 C-m-0 C-m-0 C-m-2 C-m-2 L-s-0 
job-6391,1,5,5,319103,319103,319144,0,41,319415,true,L-m-0 L-m-0 C-m-1 C-m-1 C-m-0 
job-6387,3,8,6,318894,318894,319166,0,272,319404,true,C-m-1 C-m-1 C-l-2 C-l-2 C-l-2 C-l-2 
job-6389,6,5,7,319000,319006,319202,6,196,319391,true,L-m-0 L-l-0 L-l-0 C-m-0 C-m-2 C-l-1 C-l-1 
job-6393,2,6,7,319206,319206,319230,0,24,319280,true,L-m-0 L-m-0 L-m-0 L-m-0 L-l-0 L-l-0 L-l-0 
job-6392,4,11,2,319159,319159,319240,0,81,319493,true,L-s-0 C-s-1 
job-6396,6,6,8,319362,319362,319452,0,90,319616,true,C-m-0 C-m-2 C-l-2 C-l-2 C-l-1 C-l-1 C-l-0 C-l-0 
job-6394,3,11,7,319252,319252,319474,0,222,319634,true,L-s-0 L-m-0 L-m-0 L-l-0 L-l-0 L-l-0 L-l-0 
job-6395,1,9,7,319321,319321,319478,0,157,319687,true,L-m-0 C-s-1 C-s-0 C-s-2 C-m-1 C-m-1 C-m-1 
job-6398,1,8,2,319454,319454,319525,0,71,319608,true,C-m-0 C-m-0 
job-6397,5,12,7,319411,319452,319616,41,164,319860,true,C-m-0 C-m-2 C-l-2 C-l-2 C-l-1 C-l-1 C-l-0 
job-6400,2,9,4,319550,319550,319699,0,149,319932,true,C-m-0 C-m-2 C-l-2 C-l-1 
job-6401,6,8,2,319606,319606,319717,0,111,319754,true,L-m-0 L-l-0 
job-6402,4,11,4,319661,319661,319725,0,64,320006,true,L-l-0 C-m-0 C-m-2 C-l-0 
job-6399,6,11,1,319505,319505,319731,0,226,319743,true,C-l-0 
job-6403,1,8,6,319714,319714,319741,0,27,319743,true,L-m-0 L-m-0 L-l-0 L-l-0 C-m-0 C-m-0 
job-6404,2,12,2,319766,319766,319866,0,100,319869,true,L-s-0 L-m-0 
job-6406,4,11,7,319871,319871,319903,0,32,319911,true,L-s-0 C-s-1 C-s-0 C-s-2 C-m-2 C-m-2 C-m-1 
job-6405,6,7,4,319819,319819,319921,0,102,320058,true,L-m-0 L-l-0 L-l-0 C-m-0 
job-6407,1,8,8,319912,319912,320060,0,148,320124,true,L-m-0 L-m-0 C-m-0 C-m-0 L-s-0 L-s-0 C-s-1 C-s-1 
job-6409,6,6,7,320019,320019,320073,0,54,320272,true,L-l-0 C-m-2 C-m-1 C-l-0 C-l-0 C-l-2 C-l-2 
job-6411,3,10,3,320119,320119,320155,0,36,320226,true,L-m-0 C-m-0 L-s-0 
job-6408,5,10,3,319961,319961,320169,0,208,320224,true,L-m-0 C-m-0 L-l-0 
job-6412,3,8,6,320166,320166,320246,0,80,320478,true,L-m-0 C-m-0 L-s-0 C-s-1 C-s-0 C-s-2 
job-6410,5,9,1,320078,320078,320246,0,168,320370,true,L-l-0 
job-6413,5,7,3,320225,320225,320266,0,41,320280,true,L-m-0 L-l-0 C-m-0 
job-6414,3,12,4,320272,320272,320308,0,36,320558,true,L-s-0 L-m-0 L-m-0 L-l-0 
job-6415,2,10,4,320323,320323,320383,0,60,320411,true,L-s-0 L-m-0 L-m-0 L-m-0 
job-6416,1,8,4,320372,320372,320399,0,27,320553,true,L-l-0 L-l-0 L-l-0 L-l-0 
job-6417,5,4,4,320435,320435,320477,0,42,320730,true,L-m-0 L-l-0 L-l-0 C-m-0 
job-6418,1,12,1,320487,320487,320551,0,64,320760,true,L-s-0 
job-6419,6,8,6,320542,320542,320562,0,20,320799,true,L-m-0 L-l-0 L-l-0 C-m-0 C-m-2 C-m-1 
job-6420,1,5,8,320590,320590,320618,0,28,320699,true,L-s-0 L-s-0 L-s-0 L-m-0 L-m-0 L-m-0 L-m-0 L-m-0 
job-6421,4,8,1,320653,320653,320684,0,31,320842,true,L-s-0 
job-6422,5,7,5,320699,320699,320762,0,63,320770,true,L-m-0 L-l-0 L-l-0 C-m-0 C-m-2 
job-6424,4,10,8,320803,320803,320886,0,83,320900,true,L-m-0 L-l-0 L-l-0 C-m-0 C-m-2 L-s-0 C-s-1 C-s-0 
job-6425,5,6,4,320848,320848,320916,0,68,321019,true,C-m-1 C-l-0 C-l-0 C-l-2 
job-6423,1,11,8,320757,320757,320928,0,171,321122,true,L-m-0 L-m-0 L-l-0 L-l-0 C-m-0 C-m-0 C-m-2 C-m-2 
job-6429,6,8,5,321033,321033,321070,0,37,321185,true,C-m-1 C-l-0 C-l-0 C-l-1 C-l-1 
job-6426,4,8,7,320896,320896,321072,0,176,321149,true,L-m-0 L-l-0 L-l-0 C-m-0 C-m-2 C-l-2 L-s-0 
job-6428,3,12,5,320990,320990,321109,0,119,321195,true,L-l-0 C-m-0 C-m-2 C-l-2 C-l-2 
job-6431,3,12,5,321133,321133,321154,0,21,321165,true,L-l-0 L-l-0 L-l-0 L-s-0 C-s-1 
job-6432,5,8,5,321172,321172,321197,0,25,321481,true,L-l-0 L-l-0 C-m-0 C-m-2 C-m-1 
job-6430,1,5,7,321088,321088,321233,0,145,321508,true,L-m-0 L-m-0 L-m-0 L-m-0 L-m-0 L-l-0 L-l-0 
job-6435,6,8,1,321314,321314,321340,0,26,321428,true,C-l-2 
job-6436,3,9,1,321356,321356,321413,0,57,321451,true,C-s-1 
job-6433,6,12,4,321227,321227,321426,0,199,321427,true,L-l-0 C-m-0 C-m-2 C-m-1 
job-6437,4,6,5,321422,321422,321434,0,12,321516,true,C-s-1 C-s-0 C-s-2 C-l-2 C-l-2 
job-6434,4,11,3,321274,321274,321437,0,163,321472,true,L-m-0 L-l-0 L-s-0 
job-6427,3,7,1,320943,320943,321486,0,543,321598,true,L-m-0 
job-6439,6,11,4,321508,321508,321603,0,95,321882,true,L-l-0 L-l-0 C-m-0 C-m-2 
job-6441,2,12,1,321603,321603,321621,0,18,321847,true,C-m-1 
job-6438,2,8,3,321466,321466,321627,0,161,321733,true,L-m-0 L-m-0 L-s-0 
job-6442,6,6,8,321650,321650,321662,0,12,321802,true,C-l-2 L-l-0 L-l-0 C-m-0 C-m-2 C-l-0 C-l-0 C-l-1 
job-6440,3,5,7,321560,321560,321696,0,136,321903,true,L-m-0 C-s-1 C-s-0 C-s-2 C-m-1 C-m-1 C-l-2 
job-6443,4,5,2,321706,321706,321724,0,18,321941,true,L-s-0 L-m-0 
job-6446,4,7,7,321830,321830,321945,0,115,321990,true,C-s-1 C-s-0 C-s-2 C-l-2 C-l-2 C-l-2 C-l-0 
job-6444,1,10,7,321749,321749,321994,0,245,322095,true,L-s-0 L-m-0 L-m-0 L-m-0 L-l-0 L-l-0 L-l-0 
job-6445,6,4,4,321791,321791,321998,0,207,322098,true,L-l-0 C-m-1 C-m-0 C-m-2 
job-6448,2,7,8,321935,321935,322003,0,68,322291,true,C-m-0 C-m-2 C-l-0 C-l-0 C-l-0 C-l-0 C-l-1 C-l-1 
job-6450,6,9,8,322055,322055,322068,0,13,322343,true,L-l-0 C-m-1 C-l-0 L-m-0 C-m-0 C-m-2 C-l-1 C-l-1 
job-6449,4,5,2,321997,321997,322083,0,86,322183,true,L-l-0 C-l-0 
job-6451,6,10,7,322100,322100,322172,0,72,322279,true,L-l-0 C-m-1 L-m-0 C-m-0 C-m-2 C-l-0 C-l-0 
job-6453,5,4,5,322198,322198,322245,0,47,322248,true,L-l-0 C-m-1 L-m-0 C-m-0 C-m-2 
job-6452,4,6,1,322153,322153,322254,0,101,322350,true,L-l-0 
job-6455,3,9,5,322286,322286,322372,0,86,322451,true,L-m-0 L-l-0 L-l-0 L-l-0 C-m-0 
job-6456,2,4,5,322336,322336,322395,0,59,322585,true,L-m-0 L-l-0 C-m-0 C-m-2 C-m-2 
job-6457,3,6,2,322385,322385,322398,0,13,322644,true,L-m-0 L-l-0 
job-6458,5,4,5,322444,322444,322464,0,20,322709,true,L-m-0 L-l-0 L-l-0 C-m-2 C-m-0 
job-6447,1,11,2,321888,321888,322468,0,580,322514,true,L-l-0 C-m-1 
job-6454,3,4,4,322242,322242,322487,0,245,322760,true,L-m-0 C-m-0 C-m-2 L-s-0 
job-6459,4,12,4,322491,322491,322571,0,80,322816,true,L-s-0 L-m-0 L-m-0 L-l-0 
job-6461,2,7,5,322603,322603,322625,0,22,322857,true,L-l-0 L-l-0 L-l-0 C-m-2 C-m-0 
job-6462,1,11,2,322652,322652,322683,0,31,322780,true,L-l-0 L-l-0 
job-6465,4,6,1,322792,322792,322806,0,14,323041,true,C-l-1 
job-6460,5,6,6,322547,322547,322826,0,279,322872,true,L-l-0 C-m-2 C-m-0 C-m-1 C-l-0 C-l-0 
job-6464,3,6,2,322746,322746,322847,0,101,322996,true,L-l-0 C-m-2 
job-6463,4,6,7,322697,322697,322862,0,165,322950,true,L-l-0 L-s-0 L-m-0 L-m-0 C-s-1 C-s-0 C-s-2 
job-6468,4,9,4,322938,322938,322977,0,39,323125,true,C-m-2 C-m-0 L-s-0 C-s-1 
job-6466,3,4,3,322841,322841,322984,0,143,323061,true,L-l-0 C-m-2 C-m-0 
job-6467,6,5,3,322895,322895,322994,0,99,323147,true,L-l-0 L-m-0 C-m-1 
job-6469,6,11,6,322987,322987,323006,0,19,323061,true,L-l-0 C-m-2 C-m-0 C-l-0 C-l-0 C-l-1 
job-6471,1,12,3,323096,323096,323110,0,14,323225,true,L-l-0 L-l-0 L-l-0 
job-6470,4,4,5,323032,323032,323133,0,101,323419,true,L-s-0 L-m-0 L-m-0 L-l-0 L-l-0 
job-6473,2,8,7,323212,323212,323232,0,20,323485,true,L-m-0 L-m-0 L-l-0 L-l-0 L-l-0 L-l-0 L-l-0 
job-6474,2,7,8,323257,323257,323273,0,16,323364,true,L-m-0 L-m-0 L-l-0 L-l-0 L-l-0 L-l-0 L-l-0 L-l-0 
job-6475,3,6,4,323312,323312,323344,0,32,323406,true,L-m-0 L-l-0 L-l-0 L-l-0 
job-6476,3,10,8,323366,323366,323444,0,78,323541,true,L-m-0 L-l-0 L-l-0 L-l-0 L-l-0 C-s-1 C-s-0 C-s-2 
job-6472,4,7,2,323153,323153,323450,0,297,323496,true,L-s-0 L-m-0 
job-6477,2,12,1,323411,323411,323476,0,65,323711,true,C-m-1 
job-6478,2,7,8,323462,323462,323558,0,96,323857,true,C-m-1 C-m-1 L-s-0 L-s-0 L-m-0 L-m-0 L-m-0 L-m-0 
job-6480,2,5,5,323561,323561,323656,0,95,323716,true,C-m-1 C-m-1 L-s-0 L-s-0 L-m-0 
job-6481,5,12,4,323616,323616,323662,0,46,323836,true,L-m-0 C-m-2 C-m-0 C-l-0 
job-6482,3,7,1,323664,323664,323690,0,26,323854,true,C-m-1 
job-6479,4,12,7,323514,323514,323712,0,198,323962,true,C-m-1 L-l-0 L-l-0 L-l-0 C-s-1 C-s-0 C-s-2 
job-6483,2,12,5,323716,323716,323835,0,119,323898,true,L-s-0 L-m-0 L-m-0 L-l-0 L-l-0 
job-6487,6,11,5,323916,323916,323939,0,23,324078,true,C-m-2 C-m-0 C-l-0 C-l-0 C-l-1 
job-6485,1,5,6,323817,323817,324029,0,212,324199,true,L-l-0 L-l-0 C-s-1 C-s-0 C-s-2 C-m-1 
job-6489,5,6,5,324010,324010,324029,0,19,324048,true,C-m-0 C-l-0 C-l-0 C-l-1 C-l-1 
job-6484,3,6,7,323757,323757,324033,0,276,324282,true,L-m-0 L-l-0 L-l-0 C-s-1 C-s-0 C-s-2 C-m-1 
job-6490,4,8,4,324061,324061,324148,0,87,324219,true,L-m-0 L-l-0 L-l-0 C-m-1 
job-6488,3,8,3,323959,323959,324163,0,204,324219,true,C-m-1 C-m-2 C-m-2 
job-6486,1,11,7,323865,323865,324180,0,315,324260,true,L-m-0 L-m-0 L-l-0 L-l-0 C-m-1 L-s-0 C-m-2 
job-6493,2,7,7,324209,324209,324269,0,60,324544,true,L-m-0 L-l-0 C-m-2 C-m-1 L-s-0 L-s-0 C-s-1 
job-6496,3,12,1,324335,324335,324379,0,44,324484,true,C-s-1 
job-6494,6,11,2,324246,324246,324408,0,162,324486,true,C-l-2 C-l-2 
job-6495,2,8,5,324292,324292,324446,0,154,324617,true,L-m-0 L-l-0 C-m-2 C-m-1 L-s-0 
job-6497,3,8,4,324385,324408,324447,23,39,324696,true,C-s-1 C-s-0 C-s-2 C-l-2 
job-6498,4,10,2,324445,324445,324487,0,42,324767,true,C-l-2 C-l-2 
job-6492,2,10,7,324169,324169,324501,0,332,324570,true,C-m-0 C-m-2 C-m-2 C-m-1 C-m-1 C-l-0 C-l-1 
job-6491,5,6,8,324113,324148,324629,35,481,324731,true,L-m-0 L-l-0 L-l-0 C-m-0 C-l-0 C-l-0 C-l-1 C-l-1 
job-6500,1,4,3,324534,324629,324678,95,49,324815,true,L-m-0 L-m-0 C-m-0 
job-6499,6,4,5,324484,324629,324683,145,54,324702,true,L-m-0 L-l-0 L-l-0 C-m-0 C-m-2 
job-6502,1,10,8,324633,324633,324692,0,59,324816,true,C-m-0 C-m-1 C-m-1 C-m-2 C-m-2 C-l-2 C-l-2 C-l-2 
job-6503,2,8,4,324672,324672,324741,0,69,324920,true,C-l-2 L-s-0 L-s-0 C-s-1 
job-6501,6,8,6,324582,324629,324750,47,121,324784,true,C-m-1 C-l-0 C-l-0 C-l-1 C-l-1 C-l-2 
job-6504,3,8,6,324728,324728,324763,0,35,324778,true,C-l-2 L-m-0 L-m-0 L-l-0 L-l-0 L-l-0 
job-6505,5,10,2,324773,324773,324801,0,28,324918,true,L-m-0 L-l-0 
job-6506,6,5,1,324810,324810,324826,0,16,325078,true,L-m-0 
job-6508,6,8,7,324902,324902,324992,0,90,325147,true,L-l-0 C-m-1 C-m-2 C-m-0 C-l-0 C-l-0 C-l-1 
job-6507,2,7,8,324862,324862,325082,0,220,325131,true,L-s-0 L-s-0 L-m-0 L-m-0 L-m-0 L-m-0 L-l-0 L-l-0 
job-6509,6,4,7,324956,324992,325126,36,134,325384,true,L-l-0 C-m-1 C-m-2 C-m-0 C-l-0 C-l-0 C-l-1 
job-6510,4,7,8,325006,325082,325143,76,61,325286,true,L-l-0 C-l-1 L-s-0 L-m-0 L-m-0 C-s-1 C-s-0 C-s-2 
job-6511,6,12,2,325075,325082,325152,7,70,325330,true,C-l-2 C-l-2 
job-6512,3,7,7,325122,325126,325195,4,69,325266,true,L-l-0 L-l-0 C-l-1 C-l-1 C-m-1 C-m-1 C-m-2 
job-6514,6,8,7,325214,325214,325301,0,87,325563,true,L-l-0 C-l-1 C-m-1 C-m-0 C-l-2 C-l-2 C-l-0 
job-6517,1,8,5,325363,325363,325402,0,39,325446,true,L-l-0 C-m-2 C-m-1 C-m-1 C-l-1 
job-6518,4,12,4,325410,325410,325460,0,50,325702,true,C-m-1 C-m-0 C-m-0 C-l-2 
job-6515,4,10,7,325262,325301,325470,39,169,325505,true,L-l-0 C-m-2 C-l-1 C-s-1 C-s-0 C-s-2 C-m-1 
job-6519,5,8,4,325464,325464,325481,0,17,325723,true,C-m-0 C-l-2 C-l-2 C-l-0 
job-6516,1,7,4,325310,325310,325485,0,175,325562,true,L-s-0 L-m-0 L-m-0 L-l-0 
job-6513,3,9,8,325164,325164,325492,0,328,325754,true,L-l-0 L-l-0 C-m-2 C-l-1 C-l-1 L-s-0 L-m-0 L-m-0 
job-6520,1,4,2,325513,325513,325611,0,98,325839,true,L-s-0 L-s-0 
job-6521,3,9,1,325576,325576,325642,0,66,325645,true,L-m-0 
job-6522,2,9,5,325628,325628,325707,0,79,325830,true,L-m-0 L-m-0 L-s-0 L-l-0 L-l-0 
job-6523,5,8,7,325682,325682,325780,0,98,325975,true,L-l-0 C-m-2 C-m-1 C-m-0 C-l-1 C-l-1 C-l-2 
job-6527,6,9,1,325891,325891,325901,0,10,326151,true,C-l-2 
job-6525,4,12,4,325786,325786,325911,0,125,326028,true,L-l-0 L-l-0 L-s-0 L-m-0 
job-6524,3,12,1,325730,325730,325977,0,247,326008,true,L-l-0 
job-6529,4,7,2,325983,325983,326000,0,17,326088,true,L-l-0 L-s-0 
job-6526,5,5,5,325838,325838,326026,0,188,326211,true,C-m-2 C-m-1 C-m-0 C-l-1 C-l-1 
job-6531,3,5,1,326059,326059,326070,0,11,326108,true,L-l-0 
job-6528,1,4,5,325938,325938,326092,0,154,326179,true,L-l-0 L-l-0 L-l-0 L-l-0 L-l-0 
job-6532,5,4,6,326113,326113,326318,0,205,326513,true,L-l-0 C-m-2 C-m-1 C-m-0 C-l-1 C-l-1 
job-6536,5,4,3,326312,326318,326347,6,29,326548,true,C-l-1 C-l-2 C-l-2 
job-6534,1,8,7,326215,326318,326361,103,43,326471,true,L-l-0 L-l-0 L-l-0 C-m-2 C-m-2 C-m-1 C-m-1 
job-6535,1,7,1,326266,326318,326364,52,46,326388,true,C-m-2 
job-6533,5,9,5,326169,326318,326419,149,101,326285,false,L-l-0 C-m-2 C-m-1 C-m-0 C-l-1 
job-6530,4,6,7,326015,326015,326438,0,423,326652,true,L-l-0 L-s-0 L-m-0 L-m-0 C-s-1 C-s-0 C-s-2 
job-6537,2,7,1,326353,326353,326452,0,99,326572,true,C-m-0 
job-6539,4,4,8,326461,326461,326700,0,239,326990,true,L-l-0 L-l-0 C-m-2 C-m-1 C-l-1 C-l-2 C-l-2 L-s-0 
job-6538,3,8,6,326405,326405,326710,0,305,327006,true,L-l-0 C-m-2 C-m-1 C-l-1 C-l-1 C-l-2 
job-6541,3,4,7,326565,326700,326719,135,19,326591,false,L-l-0 L-l-0 L-l-0 C-m-2 C-m-1 C-l-1 C-l-1 
job-6543,1,11,1,326663,326710,326786,47,76,326989,true,L-m-0 
job-6542,4,10,6,326618,326710,326854,92,144,326999,true,C-m-2 C-m-1 C-l-1 C-l-0 C-l-0 L-s-0 
job-6544,5,7,3,326722,326722,326895,0,173,326907,true,C-l-1 L-l-0 L-l-0 
job-6546,5,5,4,326830,326854,326896,24,42,327168,true,C-m-2 C-l-1 C-l-0 C-m-1 
job-6540,3,10,8,326508,326508,326901,0,393,326917,true,L-m-0 L-m-0 C-s-1 C-s-0 C-s-2 C-m-0 C-m-0 C-l-0 
job-6548,3,11,6,326921,326921,326971,0,50,327098,true,L-m-0 L-m-0 C-m-2 L-s-0 L-l-0 L-l-0 
job-6549,5,7,7,326969,326969,327048,0,79,327049,true,L-l-0 C-m-0 C-m-1 C-l-1 C-l-1 C-l-0 C-l-0 
job-6547,1,6,1,326871,326871,327057,0,186,327060,true,L-m-0 
job-6545,3,4,1,326772,326772,327090,0,318,327107,true,C-m-2 
job-6551,1,6,3,327068,327068,327099,0,31,327154,true,L-m-0 L-m-0 L-l-0 
job-6550,2,9,8,327012,327012,327149,0,137,327423,true,L-m-0 L-m-0 L-l-0 L-l-0 L-l-0 C-m-0 C-m-1 C-m-2 
job-6552,1,4,6,327116,327116,327158,0,42,327389,true,L-m-0 L-m-0 L-m-0 L-l-0 L-l-0 L-l-0 
job-6553,3,8,3,327158,327158,327174,0,16,327427,true,L-s-0 L-m-0 L-m-0 
job-6555,5,8,1,327254,327254,327296,0,42,327388,true,L-m-0 
job-6556,4,11,6,327315,327315,327330,0,15,327492,true,L-m-0 L-l-0 L-l-0 L-l-0 C-s-1 C-s-0 
job-6554,2,4,3,327200,327200,327407,0,207,327497,true,L-s-0 L-s-0 L-m-0 
job-6557,3,9,4,327367,327367,327467,0,100,327472,true,L-m-0 L-m-0 L-l-0 L-l-0 
job-6559,5,10,7,327463,327463,327546,0,83,327552,true,C-m-2 C-m-0 C-m-1 C-l-1 C-l-1 C-l-0 C-l-0 
job-6560,6,7,6,327504,327546,327571,42,25,327801,true,L-l-0 L-m-0 C-m-2 C-m-0 C-m-1 C-l-1 
job-6561,3,5,1,327561,327561,327617,0,56,327915,true,C-l-1 
job-6562,2,7,2,327620,327620,327692,0,72,327815,true,L-l-0 L-l-0 
job-6563,3,4,6,327675,327675,327751,0,76,327834,true,L-s-0 L-m-0 L-m-0 C-s-1 C-s-0 C-s-2 
job-6558,3,10,2,327416,327416,327794,0,378,327809,true,L-l-0 L-l-0 
job-6565,5,8,6,327768,327768,327816,0,48,327883,true,L-m-0 C-m-1 C-l-1 C-l-1 C-l-0 C-l-0 
job-6564,4,10,4,327726,327726,327879,0,153,327936,true,L-l-0 C-m-2 C-m-2 C-m-0 
job-6566,5,6,6,327818,327818,327887,0,69,328019,true,L-l-0 L-m-0 C-m-1 C-l-1 C-l-1 C-l-0 
job-6567,5,12,6,327869,327879,327971,10,92,327974,true,L-l-0 C-l-0 C-m-2 C-m-0 C-l-2 C-l-2 
job-6569,2,6,2,327949,327949,327976,0,27,328034,true,L-m-0 L-l-0 
job-6568,5,11,4,327910,327910,328076,0,166,328353,true,L-l-0 C-l-0 L-m-0 C-m-1 
job-6572,1,8,5,328111,328111,328135,0,24,328226,true,L-m-0 L-m-0 L-l-0 L-l-0 C-m-1 
job-6573,2,10,5,328158,328158,328180,0,22,328334,true,L-m-0 L-l-0 L-l-0 C-m-1 C-m-1 
job-6571,3,9,8,328057,328057,328213,0,156,328231,true,L-l-0 L-l-0 C-m-1 C-l-0 C-l-0 L-s-0 C-s-1 C-s-0 
job-6574,4,9,8,328207,328207,328255,0,48,328497,true,L-m-0 L-l-0 C-m-1 C-l-0 C-s-2 C-m-2 C-m-2 C-m-0 
job-6575,6,10,3,328245,328245,328268,0,23,328458,true,L-l-0 C-l-0 C-l-2 
job-6576,1,4,6,328292,328292,328367,0,75,328515,true,L-m-0 L-m-0 L-m-0 L-m-0 L-l-0 L-l-0 
job-6577,3,6,4,328341,328341,328367,0,26,328521,true,L-l-0 L-l-0 L-l-0 L-s-0 
job-6570,1,8,3,328003,328003,328434,0,431,328436,true,L-m-0 L-m-0 L-l-0 
job-6578,5,12,5,328389,328389,328483,0,94,328622,true,L-m-0 L-l-0 L-l-0 C-m-2 C-m-1 
job-6579,5,8,8,328436,328483,328500,47,17,328507,true,L-m-0 L-l-0 L-l-0 C-m-2 C-m-1 C-m-0 C-l-0 C-l-0 
job-6581,1,7,7,328540,328540,328557,0,17,328661,true,L-m-0 L-m-0 L-l-0 L-l-0 L-l-0 L-l-0 L-l-0 
job-6580,2,12,4,328490,328490,328635,0,145,328763,true,L-m-0 L-l-0 C-m-2 C-m-1 
job-6583,5,4,4,328648,328648,328745,0,97,328991,true,L-l-0 C-m-2 C-m-1 C-m-0 
job-6584,1,12,3,328701,328701,328751,0,50,328860,true,L-m-0 L-l-0 C-m-2 
job-6582,6,11,2,328598,328598,328774,0,176,328782,true,L-m-0 L-l-0 
job-6585,2,6,6,328748,328748,328847,0,99,328993,true,L-l-0 L-l-0 C-m-2 C-m-2 C-m-2 L-s-0 
job-6587,6,7,8,328836,328836,328853,0,17,329117,true,L-l-0 L-m-0 C-m-1 C-m-0 C-l-0 C-l-0 C-l-2 C-l-2 
job-6586,1,5,1,328800,328800,328860,0,60,328923,true,L-s-0 
job-6588,4,11,4,328879,328879,328898,0,19,329187,true,L-s-0 L-m-0 L-m-0 L-l-0 
job-6590,5,7,3,328973,328973,328998,0,25,329141,true,L-l-0 C-m-2 C-m-1 
job-6591,6,12,5,329033,329033,329061,0,28,329278,true,L-l-0 C-m-2 C-m-1 C-m-0 C-l-0 
job-6589,3,7,5,328930,328930,329107,0,177,329318,true,L-s-0 L-m-0 L-m-0 L-l-0 L-l-0 
job-6592,2,9,3,329084,329084,329119,0,35,329262,true,L-m-0 L-l-0 L-l-0 
job-6593,1,5,1,329144,329144,329174,0,30,329428,true,L-s-0 
job-6594,3,4,4,329189,329189,329199,0,10,329337,true,L-s-0 L-m-0 L-m-0 L-l-0 
job-6595,2,4,5,329252,329252,329299,0,47,329397,true,L-s-0 L-s-0 L-m-0 L-m-0 L-m-0 
job-6597,6,11,8,329347,329347,329454,0,107,329663,true,L-m-0 C-m-2 C-m-1 C-m-0 C-l-0 C-l-0 C-l-2 C-l-2 
job-6596,1,12,8,329292,329292,329503,0,211,329684,true,L-m-0 L-l-0 L-l-0 L-l-0 L-l-0 C-s-2 C-s-1 C-s-0 
job-6599,2,4,4,329455,329455,329522,0,67,329709,true,L-m-0 L-m-0 C-s-2 C-s-1 
job-6600,2,8,6,329503,329503,329539,0,36,329709,true,C-s-2 C-s-1 C-m-2 C-m-1 C-m-0 C-m-0 
job-6601,5,11,4,329557,329557,329568,0,11,329794,true,L-m-0 C-m-0 L-l-0 L-l-0 
job-6598,3,12,7,329410,329454,329582,44,128,329704,true,L-m-0 L-s-0 C-m-2 C-m-2 C-m-1 C-m-1 C-m-0 
job-6602,1,4,8,329597,329597,329630,0,33,329821,true,L-s-0 L-s-0 L-s-0 L-s-0 L-m-0 L-m-0 L-m-0 L-m-0 
job-6603,6,9,6,329635,329635,329739,0,104,329868,true,L-m-0 L-l-0 L-l-0 C-m-2 C-m-1 C-m-0 
job-6605,2,9,1,329706,329706,329771,0,65,329779,true,L-m-0 
job-6606,5,8,7,329746,329746,329778,0,32,330028,true,L-m-0 L-l-0 L-l-0 C-m-2 C-m-1 C-m-0 C-l-1 
job-6604,5,7,4,329667,329667,329792,0,125,329880,true,C-l-0 C-l-0 C-l-2 C-l-2 
job-6608,4,10,1,329849,329849,329877,0,28,330052,true,L-m-0 
job-6607,1,8,4,329801,329801,329910,0,109,330202,true,L-s-0 L-s-0 L-m-0 L-m-0 
job-6610,4,10,3,329934,329934,329964,0,30,330014,true,L-s-0 C-s-2 C-s-1 
job-6611,5,10,2,329988,329988,330032,0,44,330048,true,C-m-2 C-m-1 
job-6612,1,10,6,330039,330039,330144,0,105,330247,true,L-m-0 L-m-0 L-s-0 C-s-2 C-s-1 C-s-0 
job-6609,3,5,6,329892,329892,330193,0,301,330287,true,L-m-0 L-m-0 L-l-0 L-l-0 L-l-0 L-l-0 
job-6613,4,10,4,330090,330090,330194,0,104,330235,true,C-m-2 C-m-2 C-m-1 C-m-1 
job-6616,2,10,2,330232,330232,330249,0,17,330354,true,L-m-0 L-m-0 
job-6614,5,9,6,330127,330127,330294,0,167,330468,true,C-m-0 C-l-0 C-l-0 C-l-2 C-l-2 C-l-1 
job-6617,4,11,5,330283,330283,330306,0,23,330484,true,L-m-0 C-l-1 L-s-0 L-l-0 L-l-0 
job-6615,1,8,1,330173,330173,330398,0,225,330470,true,L-m-0 
job-6620,3,8,5,330451,330451,330464,0,13,330702,true,L-m-0 C-m-0 C-m-2 C-s-2 C-s-1 
job-6619,5,12,2,330401,330401,330559,0,158,330772,true,C-m-0 C-m-2 
job-6621,5,6,2,330499,330499,330563,0,64,330840,true,L-m-0 C-m-1 
job-6618,1,11,7,330335,330335,330616,0,281,330771,true,L-m-0 L-m-0 L-s-0 L-l-0 L-l-0 L-l-0 L-l-0 
job-6623,4,5,5,330583,330583,330656,0,73,330915,true,L-m-0 C-l-2 C-l-2 C-m-0 C-m-0 
job-6622,4,7,7,330541,330541,330659,0,118,330717,true,C-s-2 C-s-1 C-s-0 C-l-0 C-l-0 C-l-0 C-l-2 
job-6624,6,4,7,330634,330656,330810,22,154,331048,true,C-l-2 L-m-0 L-l-0 L-l-0 C-m-0 C-m-2 C-m-1 
job-6626,6,7,1,330732,330732,330850,0,118,330953,true,C-l-0 
job-6628,1,4,1,330831,330831,330870,0,39,331057,true,L-m-0 
job-6625,4,7,3,330680,330680,330887,0,207,331072,true,C-l-2 L-s-0 C-s-2 
job-6629,3,12,7,330885,330885,330907,0,22,330925,true,C-m-1 C-l-2 C-l-2 L-l-0 L-l-0 L-l-0 L-l-0 
job-6630,2,4,2,330943,330943,330969,0,26,331092,true,L-m-0 L-m-0 
job-6627,1,11,7,330780,330780,331051,0,271,331314,true,L-m-0 L-m-0 C-m-0 C-m-0 C-m-2 C-m-2 C-m-1 
job-6631,4,7,4,331002,331002,331129,0,127,331169,true,L-m-0 C-m-0 C-m-2 C-m-1 
job-6633,1,9,4,331087,331087,331144,0,57,331353,true,L-m-0 L-m-0 L-l-0 L-l-0 
job-6635,5,12,1,331188,331188,331206,0,18,331428,true,L-m-0 
job-6632,1,8,5,331038,331038,331210,0,172,331243,true,C-m-1 L-s-0 L-s-0 L-l-0 L-l-0 
job-6636,6,8,6,331243,331243,331259,0,16,331348,true,L-l-0 L-l-0 C-m-1 C-m-0 C-m-2 C-l-2 
job-6637,5,7,4,331293,331293,331320,0,27,331457,true,L-m-0 L-l-0 L-l-0 C-m-1 
job-6634,3,11,1,331139,331139,331360,0,221,331638,true,L-m-0 
job-6638,5,12,2,331334,331334,331475,0,141,331639,true,L-m-0 L-l-0 
job-6639,3,4,4,331377,331377,331573,0,196,331606,true,L-m-0 L-l-0 L-l-0 L-s-0 
job-6643,4,5,2,331580,331580,331600,0,20,331865,true,L-m-0 L-l-0 
job-6642,4,8,4,331542,331542,331627,0,85,331906,true,L-m-0 C-s-2 C-s-1 C-s-0 
job-6641,6,11,3,331490,331490,331662,0,172,331722,true,L-l-0 C-l-1 C-l-1 
job-6644,1,11,8,331623,331623,331701,0,78,331754,true,L-m-0 L-m-0 L-l-0 L-l-0 L-l-0 C-m-1 C-m-1 C-m-0 
job-6645,3,8,1,331679,331679,331714,0,35,331751,true,L-m-0 
job-6646,6,12,5,331734,331734,331746,0,12,331851,true,L-m-0 L-l-0 L-l-0 C-l-1 C-l-1 
job-6647,1,5,2,331783,331783,331870,0,87,331998,true,C-m-1 C-m-1 
job-6649,6,4,2,331884,331884,331969,0,85,332224,true,L-m-0 L-l-0 
job-6651,3,10,5,331987,331987,332017,0,30,332059,true,L-l-0 L-l-0 L-m-0 L-m-0 C-s-0 
job-6650,4,8,4,331939,331939,332024,0,85,332086,true,L-l-0 L-s-0 C-s-2 C-s-1 
job-6640,5,7,7,331439,331439,332084,0,645,332360,true,C-m-1 C-m-0 C-m-2 C-l-2 C-l-2 C-l-0 C-l-0 
job-6652,6,5,4,332049,332049,332084,0,35,332245,true,L-m-0 L-l-0 L-l-0 C-l-1 
job-6654,1,12,7,332155,332155,332178,0,23,332405,true,C-m-2 C-m-1 C-m-1 L-s-0 L-m-0 L-m-0 L-l-0 
job-6653,3,9,2,332104,332104,332192,0,88,332192,false,C-m-0 C-m-2 
job-6648,1,5,6,331827,331827,332218,0,391,332353,true,C-m-1 C-m-0 C-m-0 C-m-0 C-m-2 C-m-2 
job-6655,6,11,8,332196,332196,332230,0,34,332465,true,C-m-2 C-m-1 L-m-0 L-l-0 L-l-0 C-l-2 C-l-2 C-l-0 
job-6656,1,12,8,332247,332247,332301,0,54,332429,true,L-s-0 L-m-0 L-m-0 L-l-0 L-l-0 L-l-0 L-l-0 C-s-2 
job-6657,1,10,7,332314,332314,332387,0,73,332630,true,L-s-0 L-m-0 L-m-0 L-m-0 L-l-0 L-l-0 L-l-0 
job-6658,6,4,2,332368,332368,332527,0,159,332670,true,L-l-0 C-m-0 
job-6661,3,4,5,332537,332537,332594,0,57,332859,true,L-l-0 L-l-0 C-m-0 C-m-0 C-m-2 
job-6659,4,8,7,332429,332429,332637,0,208,332928,true,L-l-0 L-s-0 L-m-0 L-m-0 C-s-2 C-s-1 C-s-0 
job-6660,1,12,6,332486,332486,332659,0,173,332791,true,L-l-0 L-l-0 C-m-0 C-m-0 C-m-2 C-m-2 
job-6662,5,9,8,332590,332594,332721,4,127,332826,true,L-l-0 C-m-1 C-l-2 C-l-2 C-l-0 C-l-0 C-l-1 C-l-1 
job-6664,1,7,2,332684,332684,332793,0,109,332992,true,L-l-0 L-l-0 
job-6663,4,5,7,332630,332637,332793,7,156,332982,true,L-l-0 C-m-0 C-m-2 L-s-0 L-m-0 L-m-0 C-s-2 
job-6665,3,11,5,332728,332728,332813,0,85,332839,true,L-l-0 L-l-0 C-m-0 C-m-2 C-s-1 
job-6667,5,5,4,332834,332834,332906,0,72,333111,true,C-l-2 C-l-2 L-m-0 L-l-0 
job-6666,2,4,7,332777,332777,332942,0,165,333102,true,C-s-0 C-s-0 C-m-1 C-m-1 C-m-1 C-m-1 C-l-2 
job-6668,1,10,4,332889,332889,333077,0,188,333276,true,L-m-0 L-m-0 L-l-0 L-l-0 
job-6669,5,9,6,332943,332943,333147,0,204,333335,true,L-m-0 L-l-0 L-l-0 C-m-1 C-m-0 C-m-2 
job-6671,6,6,3,333063,333147,333186,84,39,333278,true,C-l-1 L-m-0 L-l-0 
job-6673,1,10,5,333163,333186,333205,23,19,333207,true,L-m-0 L-m-0 C-m-1 C-m-1 C-m-0 
job-6672,6,9,7,333111,333186,333223,75,37,333435,true,C-l-1 L-m-0 L-l-0 L-l-0 C-m-1 C-m-0 C-m-2 
job-6674,4,5,7,333225,333225,333257,0,32,333295,true,C-l-1 L-s-0 L-m-0 L-m-0 L-l-0 L-l-0 L-l-0 
job-6670,6,6,5,333004,333004,333262,0,258,333514,true,C-l-2 C-l-2 C-l-0 C-l-0 C-l-1 
job-6675,5,9,7,333285,333285,333301,0,16,333397,true,L-m-0 L-l-0 L-l-0 C-m-1 C-m-0 C-m-2 C-l-2 
job-6676,2,12,3,333344,333344,333459,0,115,333576,true,L-s-0 L-m-0 L-m-0 
job-6678,2,8,1,333429,333429,333489,0,60,333512,true,L-m-0 
job-6677,1,11,5,333391,333391,333502,0,111,333782,true,L-l-0 L-l-0 L-l-0 L-l-0 C-s-0 
job-6679,2,6,7,333470,333470,333553,0,83,333596,true,L-m-0 L-m-0 L-m-0 L-s-0 L-s-0 C-s-1 C-s-1 
job-6680,3,4,4,333517,333517,333593,0,76,333637,true,L-l-0 L-l-0 L-l-0 L-l-0 
job-6683,1,4,8,333659,333659,333697,0,38,333801,true,L-l-0 L-l-0 L-l-0 L-l-0 L-l-0 L-l-0 L-l-0 C-s-2 
job-6681,4,11,5,333564,333564,333781,0,217,333833,true,L-s-0 L-m-0 L-m-0 C-s-1 C-s-0 
job-6685,4,5,2,333765,333765,333828,0,63,333922,true,C-s-2 C-m-1 
job-6682,5,5,1,333614,333614,333863,0,249,334002,true,L-l-0 
job-6684,1,6,4,333706,333706,333874,0,168,333933,true,L-l-0 L-l-0 L-l-0 L-l-0 
job-6687,1,8,3,333870,333870,333953,0,83,334186,true,L-m-0 L-m-0 L-l-0 
job-6686,4,11,3,333812,333812,333982,0,170,334249,true,C-m-1 L-s-0 L-m-0 
job-6688,4,10,1,333917,333917,334039,0,122,334262,true,L-l-0 
job-6690,1,12,1,334027,334027,334083,0,56,334217,true,L-m-0 
job-6689,2,10,7,333967,333967,334119,0,152,334126,true,L-m-0 L-m-0 L-l-0 L-l-0 L-l-0 C-m-1 C-m-1 
job-6692,1,8,6,334126,334126,334175,0,49,334195,true,L-l-0 L-l-0 L-l-0 L-l-0 L-l-0 L-s-0 
job-6691,1,5,1,334076,334076,334271,0,195,334336,true,L-l-0 
job-6693,1,11,2,334171,334171,334300,0,129,334375,true,L-m-0 L-m-0 
job-6695,2,12,2,334268,334268,334401,0,133,334411,true,L-l-0 C-s-0 
job-6697,6,4,2,334382,334382,334405,0,23,334434,true,C-m-1 C-m-0 
job-6698,6,12,7,334445,334445,334463,0,18,334487,true,C-m-1 C-m-0 C-m-2 C-l-2 C-l-2 C-l-0 C-l-0 
job-6696,1,10,5,334323,334323,334486,0,163,334777,true,L-s-0 L-m-0 L-m-0 L-l-0 C-s-2 
job-6694,3,6,7,334224,334224,334543,0,319,334694,true,L-m-0 L-l-0 L-l-0 L-l-0 L-s-0 C-s-2 C-s-1 
job-6699,4,4,7,334492,334492,334570,0,78,334749,true,L-m-0 C-s-0 C-m-1 C-m-1 C-m-0 C-m-0 C-m-2 
job-6702,5,7,5,334632,334632,334743,0,111,334866,true,C-m-1 C-m-0 C-l-2 C-l-2 C-l-0 
job-6703,1,5,6,334686,334686,334744,0,58,335002,true,L-s-0 L-m-0 L-m-0 C-s-2 C-m-1 C-m-1 
job-6701,1,12,5,334583,334583,334832,0,249,335025,true,L-m-0 C-m-2 C-s-0 C-s-1 C-m-1 
job-6705,5,7,7,334772,334772,334845,0,73,334997,true,C-m-1 C-m-0 C-l-0 C-l-2 C-l-2 C-l-1 C-l-1 
job-6704,3,4,5,334722,334722,334872,0,150,335097,true,C-s-0 C-s-1 C-m-2 C-m-0 C-l-0 
job-6700,3,10,8,334543,334543,334886,0,343,334978,true,L-m-0 C-m-2 L-s-0 L-l-0 L-l-0 L-l-0 L-l-0 C-s-2 
job-6706,6,10,7,334825,334872,334956,47,84,334997,true,C-m-0 C-m-1 C-l-0 C-l-0 C-l-2 C-l-2 C-l-1 
job-6708,2,12,4,334926,334926,334982,0,56,335278,true,L-m-0 L-m-0 C-m-0 C-m-1 
job-6710,4,8,6,335028,335028,335119,0,91,335415,true,L-m-0 C-m-0 C-m-1 C-m-2 C-l-1 C-l-1 
job-6711,6,8,5,335074,335074,335150,0,76,335323,true,L-l-0 L-l-0 C-l-0 C-l-0 C-l-2 
job-6707,4,4,4,334882,334882,335165,0,283,335447,true,L-m-0 C-m-2 C-l-1 C-s-0 
job-6709,4,12,2,334973,334973,335170,0,197,335399,true,C-m-0 C-m-1 
job-6713,5,8,8,335184,335184,335295,0,111,335434,true,C-m-0 C-m-1 C-l-2 C-l-2 L-l-0 L-l-0 C-l-0 C-l-0 
job-6714,3,5,5,335222,335222,335359,0,137,335385,true,L-m-0 C-m-2 L-s-0 C-s-0 C-s-2 
job-6715,5,11,4,335274,335295,335362,21,67,335443,true,C-m-0 C-m-1 C-l-2 C-l-2 
job-6716,1,4,6,335340,335340,335424,0,84,335523,true,L-s-0 L-m-0 C-s-0 C-s-2 C-m-2 C-m-0 
job-6718,3,7,8,335449,335449,335481,0,32,335642,true,L-m-0 C-m-2 L-s-0 C-s-0 C-s-2 C-l-0 C-l-0 C-l-0 
job-6712,2,11,7,335118,335119,335487,1,368,335630,true,L-m-0 L-m-0 C-m-0 C-m-1 C-m-2 C-m-2 C-l-2 
job-6717,4,5,8,335389,335389,335612,0,223,335683,true,C-m-0 C-m-1 C-l-2 C-l-2 L-l-0 L-l-0 L-l-0 C-s-1 
job-6721,2,5,6,335604,335604,335648,0,44,335661,true,C-m-1 C-m-1 C-l-2 C-l-2 L-s-0 L-s-0 
job-6719,2,8,1,335501,335501,335653,0,152,335824,true,C-m-0 
job-6720,1,9,2,335554,335554,335709,0,155,335765,true,C-m-0 C-m-0 
job-6722,1,4,8,335641,335641,335720,0,79,335847,true,C-m-0 C-m-1 C-m-1 C-m-1 C-m-1 C-l-2 C-l-2 C-l-2 
job-6724,1,6,5,335733,335733,335759,0,26,335985,true,L-m-0 L-m-0 L-m-0 C-l-2 C-l-2 
job-6723,5,11,2,335686,335686,335785,0,99,336079,true,C-l-2 L-m-0 
job-6725,1,4,7,335765,335765,335829,0,64,336080,true,L-m-0 L-m-0 L-m-0 C-l-2 C-l-2 C-l-2 C-l-2 
job-6727,4,11,2,335865,335865,335878,0,13,335941,true,L-l-0 C-l-2 
job-6726,6,4,2,335810,335810,335930,0,120,336085,true,C-l-2 L-l-0 
job-6730,4,10,1,336031,336031,336045,0,14,336167,true,L-l-0 
job-6729,1,6,2,335983,335983,336088,0,105,336287,true,L-l-0 L-l-0 
job-6728,4,9,5,335926,335926,336110,0,184,336112,true,L-l-0 C-l-2 L-s-0 L-m-0 L-m-0 
job-6731,5,8,3,336069,336069,336125,0,56,336221,true,L-l-0 C-l-2 C-m-0 
job-6732,3,7,4,336125,336125,336221,0,96,336329,true,L-s-0 L-m-0 L-m-0 L-l-0 
job-6734,6,6,3,336224,336224,336257,0,33,336438,true,L-l-0 L-m-0 C-l-0 
job-6733,6,9,6,336168,336168,336346,0,178,336355,true,L-l-0 C-m-0 C-m-1 C-m-2 C-l-2 C-l-2 
job-6736,5,5,7,336324,336346,336356,22,10,336535,true,L-l-0 C-l-0 C-m-0 C-m-1 C-m-2 C-l-2 C-l-2 
job-6737,1,6,8,336365,336365,336422,0,57,336568,true,L-m-0 L-m-0 L-l-0 L-l-0 L-l-0 L-l-0 L-l-0 L-l-0 
job-6738,4,6,4,336421,336421,336438,0,17,336574,true,C-l-0 L-s-0 C-s-1 C-s-0 
job-6735,6,7,3,336271,336271,336737,0,466,336784,true,L-l-0 L-m-0 C-l-0 
job-6739,6,9,5,336474,336474,336739,0,265,336901,true,L-l-0 C-l-0 C-m-0 C-m-1 C-m-2 
job-6740,6,11,7,336518,336737,336783,219,46,336785,true,L-l-0 C-l-0 L-m-0 C-l-2 C-l-2 C-l-1 C-l-1 
job-6742,6,4,6,336639,336783,336876,144,93,336951,true,L-m-0 L-l-0 L-l-0 C-m-0 C-m-1 C-m-2 
job-6741,4,5,3,336570,336737,336903,167,166,336893,false,L-s-0 C-s-1 C-s-0 
job-6744,3,5,7,336737,336783,336925,46,142,336993,true,C-l-2 C-l-2 C-s-2 C-l-1 C-l-1 C-l-1 C-l-1 
job-6745,4,12,3,336788,336788,336940,0,152,337076,true,C-l-0 C-l-0 C-l-0 
job-6747,5,6,8,336879,336940,336952,61,12,336920,false,C-l-2 C-m-0 C-m-1 C-m-2 C-l-0 C-l-0 C-l-1 C-l-1 
job-6746,3,12,5,336840,336876,337016,36,140,337188,true,L-m-0 L-m-0 L-l-0 L-l-0 L-l-0 
job-6748,2,4,1,336921,336940,337045,19,105,337260,true,L-m-0 
job-6751,6,11,1,337055,337055,337085,0,30,337267,true,L-l-0 
job-6752,3,8,3,337108,337108,337150,0,42,337198,true,L-m-0 L-l-0 L-l-0 
job-6750,5,5,3,337005,337016,337209,11,193,337480,true,L-m-0 C-l-1 L-l-0 
job-6743,5,4,1,336697,336783,337222,86,439,337381,true,C-l-2 
job-6753,5,8,2,337152,337209,337242,57,33,337347,true,C-l-1 L-m-0 
job-6754,1,6,7,337215,337215,337313,0,98,337424,true,L-m-0 L-m-0 L-m-0 C-m-0 C-m-0 C-m-1 C-m-1 
job-6755,1,12,4,337266,337266,337329,0,63,337375,true,L-m-0 C-m-2 C-l-1 C-l-1 
job-6756,2,9,3,337315,337315,337348,0,33,337470,true,L-m-0 L-m-0 C-m-0 
job-6749,6,9,7,336960,336960,337363,0,403,337457,true,C-l-2 C-m-0 C-m-1 C-m-2 C-l-0 C-l-0 C-l-1 
job-6758,6,8,5,337418,337418,337537,0,119,337678,true,C-m-0 C-m-1 C-l-0 C-l-0 C-l-1 
job-6759,3,6,3,337468,337468,337559,0,91,337565,true,L-m-0 C-m-2 C-l-1 
job-6760,5,12,3,337520,337537,337583,17,46,337629,true,C-l-1 C-m-0 C-m-1 
job-6757,5,7,4,337364,337364,337584,0,220,337626,true,L-m-0 L-l-0 L-l-0 C-m-2 
job-6764,3,11,5,337696,337696,337707,0,11,337897,true,L-l-0 L-l-0 L-l-0 L-l-0 C-s-2 
job-6763,4,10,4,337665,337665,337731,0,66,337766,true,C-m-0 C-m-1 C-m-2 C-l-1 
job-6761,3,10,7,337577,337577,337810,0,233,338098,true,L-m-0 C-m-0 C-m-1 C-m-2 C-l-1 C-l-1 L-s-0 
job-6765,1,12,3,337738,337738,337817,0,79,338084,true,C-m-0 C-m-1 C-m-2 
job-6762,2,12,1,337620,337620,337873,0,253,338117,true,L-m-0 
job-6767,4,8,1,337824,337824,337874,0,50,338095,true,L-m-0 
job-6766,2,5,7,337783,337783,337924,0,141,338185,true,L-m-0 C-m-0 C-m-0 C-m-1 C-m-1 C-m-2 C-m-2 
job-6769,2,7,5,337926,337926,337977,0,51,338115,true,L-l-0 L-s-0 L-s-0 L-m-0 L-m-0 
job-6768,5,4,2,337870,337870,338052,0,182,338052,false,L-l-0 L-l-0 
job-6771,5,8,2,338008,338008,338098,0,90,338183,true,C-l-1 L-m-0 
job-6770,5,8,4,337972,337972,338119,0,147,338190,true,C-m-0 C-m-1 C-m-2 C-l-1 
job-6772,6,7,7,338067,338098,338230,31,132,338380,true,C-l-1 L-m-0 L-l-0 L-l-0 C-l-0 C-l-0 C-l-2 
job-6775,4,5,1,338207,338207,338233,0,26,338440,true,C-s-1 
job-6774,2,7,8,338160,338160,338313,0,153,338438,true,L-m-0 C-l-1 C-l-1 C-l-1 L-s-0 L-s-0 C-s-2 C-s-2 
job-6777,2,9,2,338298,338298,338326,0,28,338486,true,L-l-0 L-l-0 
job-6778,6,11,5,338350,338350,338405,0,55,338546,true,C-l-1 L-l-0 L-l-0 C-m-0 C-m-1 
job-6779,2,5,2,338401,338401,338467,0,66,338531,true,L-m-0 C-m-0 
job-6780,3,7,3,338450,338450,338468,0,18,338543,true,C-m-0 C-m-0 C-l-1 
job-6776,6,6,3,338249,338249,338480,0,231,338622,true,L-m-0 C-l-1 C-l-2 
job-6782,1,8,2,338559,338559,338569,0,10,338738,true,L-m-0 L-m-0 
job-6781,6,5,4,338503,338503,338599,0,96,338771,true,C-l-2 L-m-0 L-l-0 L-l-0 
job-6773,6,11,1,338112,338112,338622,0,510,338713,true,C-l-2 
job-6783,4,11,4,338614,338614,338690,0,76,338766,true,C-l-2 L-s-0 L-m-0 L-m-0 
job-6784,2,10,2,338665,338665,338735,0,70,338781,true,C-l-2 C-l-2 
job-6785,6,11,2,338709,338709,338758,0,49,339024,true,C-l-2 L-m-0 
job-6787,4,9,6,338810,338810,338873,0,63,339076,true,L-m-0 L-l-0 L-l-0 L-l-0 C-s-2 C-s-1 
job-6788,6,9,3,338862,338862,338917,0,55,339206,true,C-m-0 C-m-1 C-m-2 
job-6786,1,9,3,338763,338763,338963,0,200,339252,true,L-s-0 L-m-0 L-m-0 
job-6789,6,9,3,338916,338916,339080,0,164,339299,true,L-m-0 L-l-0 L-l-0 
job-6791,6,9,2,339022,339022,339156,0,134,339260,true,C-m-0 C-m-1 
job-6794,5,11,6,339180,339180,339191,0,11,339470,true,C-m-0 C-m-1 C-m-2 C-l-2 C-l-2 C-l-1 
job-6792,4,12,1,339065,339065,339212,0,147,339379,true,C-s-0 
job-6793,3,12,5,339116,339116,339216,0,100,339479,true,L-m-0 L-m-0 L-l-0 L-l-0 L-l-0 
job-6795,4,5,2,339223,339223,339244,0,21,339316,true,L-m-0 L-m-0 
job-6797,3,6,5,339307,339307,339344,0,37,339608,true,L-l-0 L-l-0 L-l-0 L-l-0 C-s-0 
job-6799,5,7,8,339403,339403,339418,0,15,339601,true,C-m-0 C-m-1 C-m-2 C-l-2 C-l-2 C-l-1 C-l-1 C-l-0 
job-6790,2,7,4,338959,338959,339449,0,490,339503,true,L-s-0 C-s-2 C-s-2 C-s-1 
job-6796,3,12,2,339270,339270,339466,0,196,339517,true,L-m-0 L-m-0 
job-6798,3,8,5,339359,339359,339479,0,120,339522,true,L-l-0 L-l-0 L-l-0 L-l-0 C-s-0 
job-6801,1,5,3,339499,339499,339567,0,68,339812,true,C-m-0 C-m-0 C-m-1 
job-6802,3,12,8,339541,339541,339573,0,32,339853,true,L-s-0 L-m-0 L-m-0 L-l-0 L-l-0 L-l-0 L-l-0 C-s-0 
job-6804,6,4,6,339633,339633,339651,0,18,339930,true,C-l-2 C-l-2 C-l-1 C-l-1 C-l-0 C-l-0 
job-6800,6,9,2,339451,339451,339686,0,235,339828,true,C-m-0 C-m-1 
job-6803,6,11,4,339585,339585,339686,0,101,339800,true,L-m-0 L-l-0 L-l-0 C-m-2 
job-6805,2,10,3,339680,339680,339723,0,43,339786,true,L-m-0 C-m-2 C-m-0 
job-6807,6,7,5,339784,339784,339817,0,33,339837,true,L-l-0 C-m-2 C-m-0 C-m-1 C-l-2 
job-6808,6,12,1,339839,339839,339878,0,39,340108,true,L-l-0 
job-6810,1,7,7,339919,339919,339932,0,13,340004,true,L-l-0 L-l-0 L-l-0 L-l-0 C-s-0 C-s-2 C-s-1 
job-6806,1,8,8,339733,339733,339950,0,217,340111,true,L-s-0 L-s-0 L-m-0 L-m-0 L-m-0 L-m-0 L-l-0 L-l-0 
job-6811,5,4,4,339980,339980,340034,0,54,340150,true,L-l-0 L-m-0 C-m-2 C-m-0 
job-6809,3,4,3,339874,339874,340060,0,186,340230,true,L-l-0 C-s-0 C-s-2 
job-6812,4,7,6,340018,340018,340062,0,44,340073,true,L-l-0 L-s-0 C-s-1 C-m-1 C-m-1 C-l-2 
job-6813,1,6,8,340059,340059,340095,0,36,340343,true,L-l-0 L-l-0 L-l-0 L-l-0 L-l-0 C-s-0 C-s-2 C-l-2 
job-6816,3,9,4,340202,340202,340242,0,40,340293,true,L-l-0 L-l-0 L-l-0 C-s-1 
job-6814,2,6,1,340111,340111,340270,0,159,340505,true,L-s-0 
job-6815,3,11,3,340151,340151,340351,0,200,340416,true,L-m-0 L-m-0 L-l-0 
job-6817,6,9,5,340254,340254,340371,0,117,340499,true,L-l-0 C-m-1 C-m-2 C-m-0 C-l-2 
job-6818,3,11,4,340295,340295,340405,0,110,340554,true,L-l-0 C-l-2 C-l-2 L-s-0 
job-6819,1,9,2,340352,340352,340449,0,97,340553,true,L-l-0 L-l-0 
job-6821,6,7,2,340447,340447,340498,0,51,340537,true,C-m-1 C-m-2 
job-6823,4,5,3,340542,340542,340567,0,25,340807,true,C-s-2 C-m-1 C-m-1 
job-6822,2,11,2,340500,340500,340594,0,94,340831,true,L-m-0 L-l-0 
job-6824,3,5,3,340596,340596,340614,0,18,340695,true,L-l-0 C-s-2 C-m-1 
job-6826,4,5,7,340694,340694,340742,0,48,340791,true,C-m-1 C-m-2 C-m-0 C-l-2 C-l-2 C-l-2 C-l-1 
job-6828,2,5,1,340784,340784,340847,0,63,341081,true,C-m-1 
job-6827,6,11,4,340733,340742,340939,9,197,341186,true,C-m-0 C-l-2 C-l-2 C-l-1 
job-6825,2,12,8,340642,340642,340977,0,335,341182,true,L-m-0 L-l-0 C-s-2 C-m-1 C-m-1 C-m-2 C-m-2 C-m-0 
job-6829,1,10,8,340825,340825,340991,0,166,341247,true,L-l-0 C-l-1 C-l-1 C-l-1 C-l-0 C-l-0 C-l-0 C-l-0 
job-6830,4,7,7,340871,340939,341022,68,83,341174,true,C-m-1 C-m-2 C-m-0 C-l-0 C-l-1 C-l-1 C-l-2 
job-6820,3,7,8,340406,340406,341080,0,674,341319,true,L-l-0 L-l-0 L-l-0 L-s-0 L-m-0 L-m-0 C-s-1 C-s-0 
job-6833,1,12,8,341022,341022,341146,0,124,341204,true,L-m-0 C-m-1 C-m-1 C-m-2 C-m-2 C-m-0 C-m-0 C-l-0 
job-6835,4,4,7,341137,341137,341151,0,14,341260,true,L-m-0 L-l-0 L-l-0 C-l-2 C-l-2 L-s-0 C-s-1 
job-6831,6,5,3,340916,341022,341154,106,132,341291,true,C-m-1 C-m-2 C-m-0 
job-6832,3,6,8,340975,341022,341207,47,185,341418,true,L-l-0 C-s-2 C-l-1 C-l-1 C-l-1 C-l-1 C-l-0 C-l-0 
job-6836,5,5,6,341192,341192,341228,0,36,341448,true,L-l-0 C-l-2 L-m-0 C-m-1 C-m-2 C-m-0 
job-6837,4,7,5,341248,341248,341315,0,67,341321,true,C-l-0 C-l-0 C-l-2 C-l-2 L-s-0 
job-6839,2,4,6,341345,341345,341357,0,12,341613,true,L-m-0 L-m-0 C-l-0 C-l-0 C-l-0 C-l-0 
job-6838,3,12,1,341296,341296,341371,0,75,341434,true,L-m-0 
job-6834,2,6,4,341070,341070,341418,0,348,341434,true,C-l-0 C-l-0 C-l-2 C-l-2 
job-6841,6,12,5,341438,341438,341480,0,42,341739,true,C-l-0 L-m-0 L-l-0 L-l-0 C-m-1 
job-6842,3,12,2,341488,341488,341509,0,21,341566,true,C-l-0 C-l-0 
job-6844,2,6,1,341595,341595,341658,0,63,341684,true,C-l-0 
job-6840,4,5,1,341393,341393,341669,0,276,341836,true,C-l-0 
job-6845,1,7,4,341654,341654,341696,0,42,341951,true,C-l-0 C-l-0 C-l-0 L-s-0 
job-6846,5,10,1,341708,341708,341784,0,76,341831,true,C-l-0 
job-6847,4,6,5,341754,341754,341799,0,45,341975,true,C-l-0 L-s-0 L-m-0 L-m-0 L-l-0 
job-6850,2,6,2,341918,341918,341949,0,31,342129,true,C-l-0 C-s-2 
job-6843,1,6,2,341536,341536,341951,0,415,342127,true,C-l-0 C-l-0 
job-6848,4,11,2,341810,341810,341955,0,145,342033,true,C-l-0 C-l-0 
job-6852,2,12,3,342011,342011,342058,0,47,342097,true,C-m-1 C-m-2 C-m-0 
job-6853,5,10,7,342059,342059,342082,0,23,342299,true,C-m-0 C-l-0 C-l-0 C-l-2 C-l-2 C-l-1 C-l-1 
job-6851,3,6,8,341969,341969,342117,0,148,342300,true,C-s-2 C-s-1 C-s-0 C-m-1 C-m-1 C-m-2 C-m-2 C-m-0 
job-6849,4,6,6,341868,341868,342185,0,317,342289,true,L-s-0 L-m-0 L-m-0 L-l-0 L-l-0 L-l-0 
job-6855,5,12,1,342177,342177,342236,0,59,342483,true,C-l-2 
job-6854,6,11,6,342133,342133,342285,0,152,342436,true,C-m-1 C-m-2 C-m-0 C-l-0 C-l-0 C-l-2 
job-6856,5,6,2,342239,342239,342321,0,82,342447,true,C-l-2 L-m-0 
job-6858,4,4,8,342350,342350,342386,0,36,342452,true,L-m-0 L-s-0 L-l-0 L-l-0 L-l-0 C-s-2 C-s-1 C-s-0 
job-6857,1,4,1,342288,342288,342420,0,132,342425,true,L-m-0 
job-6859,1,6,4,342410,342410,342424,0,14,342587,true,L-m-0 L-m-0 L-m-0 L-m-0 
job-6862,1,9,2,342551,342551,342566,0,15,342590,true,L-m-0 C-m-1 
job-6861,6,10,5,342507,342507,342634,0,127,342892,true,C-m-1 C-m-2 C-m-0 C-l-2 C-l-2 
job-6863,2,6,3,342598,342598,342660,0,62,342721,true,L-m-0 C-m-1 C-m-2 
job-6860,3,9,8,342461,342461,342720,0,259,342963,true,L-s-0 L-m-0 L-m-0 L-l-0 L-l-0 L-l-0 L-l-0 C-s-2 
job-6864,3,11,8,342645,342645,342753,0,108,342857,true,C-m-1 C-m-1 C-m-2 C-m-2 C-s-1 C-s-0 C-m-0 C-m-0 
job-6867,4,11,7,342795,342795,342829,0,34,343065,true,L-l-0 C-m-1 C-m-2 C-m-0 C-s-1 C-s-0 C-l-2 
job-6865,1,7,7,342689,342689,342846,0,157,342928,true,L-s-0 L-m-0 L-m-0 C-s-2 C-m-1 C-m-2 C-m-0 
job-6868,6,11,1,342853,342853,342874,0,21,343089,true,L-l-0 
job-6869,1,7,2,342906,342906,342959,0,53,343103,true,L-m-0 L-m-0 
job-6866,5,11,2,342737,342737,343119,0,382,343141,true,L-m-0 L-l-0 
job-6870,6,11,1,342960,342960,343145,0,185,343406,true,L-l-0 
job-6872,5,7,7,343071,343071,343170,0,99,343277,true,C-m-1 C-m-2 C-m-0 C-l-2 C-l-2 C-l-0 C-l-0 
job-6874,5,6,1,343161,343161,343173,0,12,343310,true,L-m-0 
job-6875,5,7,7,343202,343202,343234,0,32,343487,true,L-m-0 C-m-1 C-m-2 C-m-0 C-l-1 L-l-0 L-l-0 
job-6871,3,9,3,343020,343020,343261,0,241,343351,true,L-m-0 L-s-0 C-s-2 
job-6877,3,8,5,343320,343320,343342,0,22,343494,true,C-l-1 C-l-1 L-s-0 L-m-0 L-m-0 
job-6873,3,7,7,343117,343117,343441,0,324,343739,true,C-m-1 C-m-2 C-m-0 C-s-1 C-s-0 C-l-1 C-l-1 
job-6876,4,7,3,343270,343270,343466,0,196,343640,true,C-m-1 C-m-2 C-m-0 
job-6878,1,6,3,343364,343364,343505,0,141,343747,true,C-s-1 C-s-0 C-m-1 
job-6880,6,7,6,343460,343466,343555,6,89,343833,true,C-m-1 C-l-1 C-m-2 C-m-0 C-l-2 C-l-2 
job-6882,5,4,5,343562,343562,343638,0,76,343936,true,C-l-1 C-m-1 C-m-2 C-m-0 C-l-2 
job-6881,4,10,6,343509,343509,343654,0,145,343897,true,C-s-1 C-s-0 C-s-2 C-l-0 C-l-0 C-l-0 
job-6884,2,7,3,343664,343664,343696,0,32,343977,true,C-s-1 C-s-1 C-s-0 
job-6879,4,7,7,343416,343416,343770,0,354,343907,true,C-l-1 L-s-0 L-m-0 L-m-0 L-l-0 L-l-0 L-l-0 
job-6885,4,6,6,343729,343729,343825,0,96,343871,true,C-s-1 C-s-0 C-s-2 C-m-2 C-m-2 C-m-0 
job-6883,4,9,4,343607,343638,343839,31,201,344036,true,C-l-1 C-l-1 C-m-1 C-m-1 
job-6886,3,8,4,343777,343777,343846,0,69,343946,true,C-m-0 C-l-1 L-s-0 L-m-0 
job-6887,2,4,6,343820,343820,343860,0,40,343972,true,L-m-0 L-m-0 L-l-0 L-l-0 L-l-0 L-l-0 
job-6888,2,6,1,343869,343869,343945,0,76,344135,true,L-s-0 
job-6889,1,7,6,343911,343911,343981,0,70,344237,true,L-s-0 L-m-0 L-m-0 L-m-0 L-m-0 L-l-0 
job-6890,3,10,5,343969,343969,343996,0,27,344257,true,L-l-0 L-l-0 L-l-0 C-s-1 C-s-0 
job-6891,5,6,5,344021,344021,344108,0,87,344244,true,L-m-0 L-l-0 L-l-0 C-m-1 C-m-2 
job-6894,3,8,1,344145,344145,344200,0,55,344238,true,L-m-0 
job-6893,5,10,3,344099,344099,344217,0,118,344407,true,C-m-0 C-l-1 C-l-1 
job-6892,1,12,6,344065,344065,344263,0,198,344430,true,L-m-0 L-m-0 L-l-0 L-l-0 C-m-1 C-m-1 
job-6895,6,6,8,344200,344200,344450,0,250,344608,true,L-m-0 L-l-0 C-m-1 C-m-2 C-l-0 C-l-0 C-l-2 C-l-2 
job-6897,4,11,3,344286,344450,344470,164,20,344394,false,C-l-0 L-s-0 C-s-1 
job-6898,2,6,5,344338,344450,344478,112,28,344469,false,L-m-0 L-l-0 C-m-1 C-m-2 C-m-0 
job-6900,6,10,1,344455,344455,344497,0,42,344706,true,C-l-2 
job-6896,5,9,7,344242,344450,344503,208,53,344436,false,L-m-0 L-l-0 L-l-0 C-m-1 C-m-2 C-m-0 C-l-0 
job-6899,4,5,1,344396,344450,344559,54,109,344553,false,C-s-0 
job-6902,1,4,1,344564,344564,344575,0,11,344639,true,L-m-0 
job-6901,2,5,6,344502,344502,344578,0,76,344618,true,L-m-0 L-l-0 C-m-1 C-m-2 C-m-0 C-l-0 
job-6903,4,7,8,344616,344616,344659,0,43,344701,true,L-s-0 L-m-0 L-m-0 L-l-0 L-l-0 L-l-0 C-s-0 C-s-1 
job-6904,1,11,8,344662,344662,344773,0,111,345003,true,L-s-0 L-m-0 L-m-0 L-l-0 L-l-0 L-l-0 L-l-0 C-s-0 
job-6906,6,4,8,344760,344760,344777,0,17,344976,true,L-l-0 C-m-1 C-m-2 C-m-0 C-l-0 C-l-0 C-l-2 C-l-2 
job-6905,1,8,4,344704,344704,344831,0,127,344967,true,L-m-0 C-s-1 C-s-1 C-s-2 
job-6907,2,8,7,344802,344802,344846,0,44,344972,true,L-m-0 L-m-0 L-m-0 C-s-2 L-s-0 L-s-0 L-l-0 
job-6908,3,8,2,344849,344849,344950,0,101,345100,true,L-s-0 L-m-0 
job-6910,3,6,7,344935,344935,344952,0,17,345199,true,C-s-0 C-m-1 C-m-1 C-m-2 C-m-2 C-m-0 C-m-0 
job-6909,3,9,7,344898,344898,344965,0,67,345245,true,L-m-0 L-l-0 L-l-0 L-l-0 L-l-0 C-s-1 C-s-2 
job-6911,4,6,8,344980,344980,345001,0,21,345227,true,L-s-0 L-m-0 L-m-0 L-l-0 L-l-0 L-l-0 C-s-1 C-s-2 
job-6913,3,8,5,345080,345080,345112,0,32,345241,true,L-m-0 L-s-0 C-s-1 C-s-2 C-s-0 
job-6914,5,9,3,345121,345121,345160,0,39,345366,true,C-m-1 C-m-2 C-m-0 
job-6915,4,10,1,345162,345162,345297,0,135,345513,true,L-s-0 
job-6916,2,7,8,345200,345200,345306,0,106,345452,true,L-m-0 L-l-0 C-s-1 C-s-1 C-s-2 C-s-2 C-s-0 C-s-0 
job-6917,4,5,3,345253,345253,345326,0,73,345551,true,C-m-1 C-m-1 C-m-2 
job-6912,5,10,3,345028,345028,345369,0,341,345453,true,L-m-0 L-l-0 L-l-0 
job-6919,5,6,2,345345,345345,345416,0,71,345488,true,C-l-1 C-m-1 
job-6920,2,7,1,345402,345402,345448,0,46,345547,true,C-m-0 
job-6918,6,5,6,345303,345303,345502,0,199,345788,true,C-m-0 C-l-0 C-l-0 C-l-2 C-l-2 C-l-1 
job-6922,6,10,1,345513,345513,345531,0,18,345682,true,C-l-1 
job-6921,5,12,6,345464,345464,345539,0,75,345636,true,C-l-1 L-m-0 L-l-0 L-l-0 C-m-1 C-m-2 
job-6925,5,9,1,345670,345670,345721,0,51,345938,true,L-l-0 
job-6926,6,5,8,345726,345726,345758,0,32,345836,true,L-l-0 C-m-1 C-m-2 C-m-0 C-l-1 C-l-1 C-l-0 C-l-0 
job-6924,5,12,2,345622,345622,345788,0,166,345822,true,L-m-0 L-l-0 
job-6923,3,11,2,345566,345566,345863,0,297,346002,true,L-s-0 L-m-0 
job-6928,2,4,1,345840,345840,345905,0,65,346101,true,L-m-0 
job-6929,2,9,6,345899,345899,346042,0,143,346307,true,L-m-0 L-m-0 L-m-0 L-l-0 L-l-0 L-l-0 
job-6927,2,4,5,345781,345781,346113,0,332,346306,true,L-l-0 L-l-0 L-l-0 C-s-1 C-s-1 
job-6931,4,11,3,346000,346000,346115,0,115,346306,true,L-s-0 C-s-2 C-s-0 
job-6930,5,5,3,345944,345944,346126,0,182,346260,true,C-m-1 C-m-2 C-m-0 
job-6932,2,4,5,346055,346055,346159,0,104,346264,true,L-l-0 L-l-0 L-l-0 C-m-1 C-m-2 
job-6935,3,6,8,346197,346197,346207,0,10,346344,true,L-l-0 L-l-0 C-m-0 C-m-0 L-s-0 C-s-2 C-s-0 C-s-1 
job-6933,2,6,4,346109,346109,346208,0,99,346450,true,C-m-0 L-m-0 L-m-0 L-m-0 
job-6936,1,9,7,346236,346236,346251,0,15,346414,true,L-m-0 L-m-0 L-l-0 L-l-0 L-s-0 C-s-2 C-s-0 
job-6938,1,8,7,346341,346341,346397,0,56,346605,true,L-l-0 L-s-0 L-s-0 C-s-2 C-s-2 C-s-0 C-s-0 
job-6934,1,5,8,346154,346154,346403,0,249,346429,true,L-m-0 L-m-0 L-l-0 L-l-0 L-l-0 L-l-0 L-l-0 L-l-0 
job-6940,5,9,4,346439,346439,346474,0,35,346726,true,L-l-0 L-l-0 C-m-0 C-m-1 
job-6939,1,6,2,346386,346386,346475,0,89,346563,true,C-s-1 C-s-1 
job-6937,2,9,3,346287,346287,346524,0,237,346669,true,L-m-0 L-m-0 L-l-0 
job-6943,3,10,8,346582,346582,346608,0,26,346620,true,L-s-0 C-s-1 C-s-2 C-s-0 C-m-2 C-m-2 C-l-1 C-l-1 
job-6942,6,5,5,346540,346540,346684,0,144,346787,true,L-m-0 L-l-0 L-l-0 C-m-0 C-m-1 
job-6944,4,12,4,346633,346633,346693,0,60,346967,true,L-s-0 C-s-1 C-s-2 C-s-0 
job-6945,1,9,5,346674,346674,346761,0,87,346790,true,C-m-0 C-m-0 C-m-1 C-m-1 C-m-2 
job-6946,1,9,4,346718,346718,346774,0,56,346803,true,L-m-0 L-m-0 C-m-0 C-m-1 
job-6941,2,12,1,346480,346480,346803,0,323,346897,true,L-m-0 
job-6947,6,10,2,346756,346756,346847,0,91,347105,true,C-m-2 L-l-0 
job-6949,4,9,3,346848,346848,346874,0,26,347037,true,L-l-0 L-s-0 C-s-1 
job-6950,4,5,2,346904,346904,346922,0,18,346974,true,L-l-0 L-s-0 
job-6948,6,8,6,346807,346807,346990,0,183,347124,true,L-l-0 L-m-0 C-m-0 C-m-1 C-l-1 C-l-1 
job-6951,3,11,2,346956,346956,347088,0,132,347242,true,L-l-0 L-l-0 
job-6955,5,6,4,347150,347150,347283,0,133,347524,true,C-m-2 C-l-1 C-l-1 C-l-0 
job-6953,1,11,4,347056,347056,347298,0,242,347514,true,L-m-0 L-m-0 C-m-0 C-m-0 
job-6954,3,5,5,347109,347109,347298,0,189,347405,true,L-l-0 L-l-0 L-s-0 C-s-1 C-s-2 
job-6956,6,10,6,347210,347283,347305,73,22,347427,true,C-m-2 C-l-1 C-l-1 C-l-0 C-l-0 C-l-2 
job-6958,1,6,7,347306,347306,347385,0,79,347486,true,L-m-0 L-m-0 L-l-0 C-m-0 C-m-0 C-m-1 C-m-1 
job-6959,3,4,8,347370,347370,347434,0,64,347653,true,C-m-2 C-l-0 C-l-0 L-s-0 C-s-1 C-s-2 C-s-0 C-l-2 
job-6960,3,11,2,347427,347427,347483,0,56,347673,true,C-l-2 C-l-2 
job-6952,6,6,4,347005,347005,347494,0,489,347686,true,L-l-0 L-m-0 C-m-0 C-m-1 
job-6957,5,6,5,347250,347305,347509,55,204,347704,true,L-l-0 C-m-2 C-l-1 C-l-1 C-l-0 
job-6961,1,7,8,347481,347481,347548,0,67,347592,true,L-m-0 L-m-0 L-l-0 C-m-0 C-m-0 C-m-1 C-m-1 C-m-2 
job-6964,1,12,5,347615,347615,347648,0,33,347776,true,C-m-0 L-s-0 C-s-1 C-s-2 C-s-0 
job-6962,1,10,6,347532,347532,347680,0,148,347880,true,L-m-0 L-l-0 L-l-0 L-l-0 L-l-0 C-m-0 
job-6966,3,5,1,347728,347728,347747,0,19,348010,true,L-s-0 
job-6965,1,10,3,347686,347686,347793,0,107,347821,true,L-m-0 L-s-0 L-l-0 
job-6967,2,9,4,347781,347781,347799,0,18,348030,true,L-l-0 L-l-0 L-l-0 L-l-0 
job-6963,3,7,2,347577,347577,347830,0,253,348127,true,L-m-0 L-m-0 
job-6968,3,11,6,347819,347819,347916,0,97,348026,true,L-s-0 L-l-0 L-l-0 L-l-0 L-l-0 C-s-1 
job-6969,1,9,6,347870,347870,347963,0,93,348075,true,L-m-0 L-m-0 L-m-0 C-s-2 C-s-0 C-m-0 
job-6972,3,5,1,348013,348013,348026,0,13,348142,true,L-m-0 
job-6971,1,11,2,347967,347967,348039,0,72,348229,true,L-m-0 L-m-0 
job-6970,1,4,3,347918,347918,348096,0,178,348360,true,L-m-0 C-s-2 C-s-0 
job-6973,2,11,8,348076,348076,348162,0,86,348181,true,L-m-0 L-m-0 C-s-2 C-s-0 L-s-0 L-l-0 L-l-0 L-l-0 
job-6974,5,4,8,348124,348124,348174,0,50,348355,true,L-l-0 C-m-0 C-m-1 C-m-2 C-l-1 C-l-1 C-l-2 C-l-2 
job-6976,2,6,6,348235,348235,348351,0,116,348455,true,L-m-0 C-m-0 C-m-1 C-m-2 L-s-0 L-s-0 
job-6975,6,10,8,348181,348181,348378,0,197,348635,true,L-m-0 L-l-0 L-l-0 C-m-0 C-m-1 C-m-2 C-l-1 C-l-1 
job-6979,4,4,3,348389,348389,348417,0,28,348668,true,L-s-0 L-m-0 L-m-0 
job-6980,3,7,7,348443,348443,348483,0,40,348559,true,C-l-2 L-s-0 L-m-0 L-m-0 L-l-0 L-l-0 L-l-0 
job-6977,3,6,4,348281,348281,348498,0,217,348637,true,C-s-2 C-s-0 C-s-1 C-l-2 
job-6978,2,8,3,348341,348341,348567,0,226,348585,true,C-l-2 C-l-2 C-l-2 
job-6981,6,6,4,348480,348480,348644,0,164,348811,true,C-m-0 C-m-1 C-m-2 C-l-1 
job-6983,1,12,3,348594,348594,348679,0,85,348754,true,L-s-0 L-m-0 L-m-0 
job-6985,3,12,5,348700,348700,348735,0,35,348925,true,C-m-0 C-m-1 C-s-2 C-s-0 C-s-1 
job-6984,5,9,6,348647,348647,348761,0,114,348799,true,C-l-1 C-l-2 L-l-0 L-l-0 C-m-0 C-m-1 
job-6986,5,4,5,348739,348761,348774,22,13,349034,true,C-l-1 C-l-2 L-l-0 L-l-0 C-m-0 
job-6987,2,6,2,348792,348792,348827,0,35,349101,true,L-m-0 C-l-1 
job-6982,3,4,7,348537,348537,348893,0,356,349029,true,C-l-2 C-l-2 C-l-1 C-l-1 L-s-0 L-m-0 L-m-0 
job-6988,5,6,1,348840,348840,348946,0,106,348989,true,C-l-1 
job-6990,4,12,2,348940,348940,349054,0,114,349341,true,L-m-0 L-l-0 
job-6992,1,4,6,349046,349046,349119,0,73,349170,true,L-m-0 L-m-0 L-l-0 L-l-0 L-l-0 C-m-0 
job-6994,4,7,6,349141,349141,349194,0,53,349391,true,C-s-2 C-s-0 C-s-1 C-l-0 C-l-0 C-l-0 
job-6989,2,4,6,348895,348895,349316,0,421,349554,true,C-l-1 C-l-1 C-l-1 L-s-0 L-s-0 L-m-0 
job-6995,1,12,4,349195,349195,349340,0,145,349565,true,L-m-0 L-l-0 L-l-0 C-m-0 
job-6991,5,9,7,348992,348992,349359,0,367,349438,true,L-l-0 C-l-1 C-m-0 C-m-1 C-m-2 C-l-2 C-l-2 
job-6993,4,9,2,349087,349087,349386,0,299,349456,true,L-m-0 L-l-0 
job-6998,2,9,5,349327,349359,349392,32,33,349586,true,L-m-0 L-m-0 L-l-0 C-m-0 C-l-2 
job-6996,3,4,5,349237,349237,349421,0,184,349466,true,C-m-1 C-m-2 C-s-2 C-s-0 C-s-1 
job-6997,5,5,6,349285,349359,349457,74,98,349534,true,L-l-0 C-m-1 C-m-2 C-m-0 C-l-2 C-l-2 
job-6999,4,8,8,349377,349386,349478,9,92,349492,true,L-m-0 L-l-0 L-s-0 C-l-1 C-l-1 C-l-1 C-l-0 C-l-0 
job-7001,6,8,4,349471,349478,349552,7,74,349830,true,C-l-0 C-l-0 C-l-2 C-l-2 
job-7000,6,10,8,349425,349478,349556,53,78,349515,false,L-m-0 L-l-0 L-l-0 C-m-0 C-m-1 C-m-2 C-l-1 C-l-1 
job-7003,4,10,5,349562,349562,349589,0,27,349675,true,C-l-1 L-s-0 C-s-2 C-s-0 C-s-1 
job-7002,5,10,7,349513,349556,349616,43,60,349855,true,L-m-0 L-l-0 L-l-0 C-m-0 C-m-1 C-m-2 C-l-1 
job-7006,3,7,7,349705,349705,349763,0,58,349769,true,L-l-0 L-l-0 L-s-0 C-s-2 C-s-0 C-s-1 C-m-0 
job-7004,1,9,4,349612,349612,349798,0,186,349865,true,L-m-0 L-m-0 L-l-0 L-l-0 
job-7008,6,12,4,349793,349793,349808,0,15,349995,true,L-l-0 C-m-0 C-l-0 C-l-0 
job-7005,2,7,4,349663,349663,349841,0,178,349879,true,L-m-0 L-m-0 L-l-0 L-l-0 
job-7007,6,8,4,349754,349754,349854,0,100,349959,true,C-m-1 C-m-2 C-l-1 C-l-1 
job-7009,2,4,1,349835,349835,349869,0,34,349945,true,L-m-0 
job-7010,1,7,5,349881,349881,349983,0,102,350072,true,L-s-0 L-s-0 L-m-0 L-m-0 L-m-0 
job-7013,4,4,6,350034,350034,350077,0,43,350323,true,C-s-0 C-s-1 C-m-1 C-m-1 C-m-2 C-m-2 
job-7012,3,7,3,349985,349985,350082,0,97,350138,true,L-m-0 L-s-0 C-s-2 
job-7011,2,4,7,349926,349926,350095,0,169,350114,true,L-m-0 L-m-0 L-l-0 L-l-0 L-l-0 L-l-0 L-l-0 
job-7016,4,12,7,350175,350175,350207,0,32,350215,true,L-l-0 L-l-0 L-l-0 C-s-2 C-m-2 C-m-2 C-m-0 
job-7014,4,11,3,350079,350079,350231,0,152,350373,true,C-s-0 C-s-1 C-m-1 
job-7015,2,11,4,350131,350131,350304,0,173,350338,true,C-m-1 L-s-0 L-m-0 L-m-0 
job-7017,6,11,8,350225,350225,350368,0,143,350443,true,L-l-0 L-l-0 C-m-2 C-m-0 C-l-1 C-l-1 C-l-0 C-l-0 
job-7020,1,6,1,350366,350368,350463,2,95,350486,true,L-m-0 
job-7018,6,5,6,350275,350368,350494,93,126,350624,true,L-m-0 L-l-0 L-l-0 C-m-2 C-m-0 C-m-1 
job-7019,4,12,2,350326,350368,350500,42,132,350475,false,L-s-0 C-s-0 
job-7021,1,5,5,350430,350430,350685,0,255,350798,true,L-m-0 C-m-2 C-m-2 C-m-0 C-m-0 
job-7022,6,11,5,350478,350478,350886,0,408,351085,true,C-l-1 C-l-1 C-l-0 C-l-0 C-l-2 
job-7025,4,7,2,350646,350886,350923,240,37,350757,false,C-s-2 C-l-0 
job-7026,6,12,1,350690,350886,350982,196,96,350949,false,C-l-0 
job-7023,5,4,8,350533,350886,351016,353,130,350857,false,L-m-0 L-l-0 L-l-0 C-m-2 C-m-0 C-m-1 C-l-1 C-l-1 
job-7031,1,12,1,350927,351016,351026,89,10,351026,false,C-m-1 
job-7024,3,6,7,350583,350886,351073,303,187,350960,false,L-m-0 C-m-2 C-m-0 C-m-1 L-s-0 C-s-0 C-s-1 
job-7027,2,8,4,350748,350886,351111,138,225,351233,true,L-l-0 C-l-0 C-l-1 C-l-2 
job-7028,3,12,8,350791,351016,351123,225,107,351039,false,L-m-0 L-l-0 L-l-0 L-l-0 C-m-2 C-m-0 C-m-1 C-l-1 
job-7033,4,9,6,351028,351123,351178,95,55,351152,false,C-l-2 L-l-0 L-l-0 L-l-0 C-s-2 C-m-1 
job-7032,5,9,5,350977,351123,351233,146,110,351160,false,L-m-0 C-m-2 C-m-0 C-l-1 C-l-2 
job-7034,2,11,8,351084,351178,351269,94,91,351385,true,L-m-0 C-m-2 C-m-0 C-l-0 C-l-2 C-l-2 L-l-0 L-l-0 
job-7037,2,8,7,351237,351269,351282,32,13,351493,true,L-s-0 L-l-0 L-l-0 C-s-0 C-s-1 C-l-2 C-l-0 
job-7036,2,11,1,351188,351269,351304,81,35,351431,true,L-l-0 
job-7029,3,4,6,350830,351016,351325,186,309,351224,false,C-l-1 C-l-1 C-l-0 C-l-0 C-l-0 C-l-2 
job-7035,6,9,6,351138,351269,351332,131,63,351481,true,L-m-0 C-m-2 C-m-0 C-l-1 C-l-2 L-l-0 
job-7039,6,6,8,351350,351350,351395,0,45,351674,true,L-m-0 L-l-0 C-m-2 C-m-0 C-l-2 C-l-0 C-l-1 C-l-1 
job-7030,1,8,6,350875,351016,351420,141,404,351451,true,L-s-0 L-m-0 C-s-0 C-s-1 C-m-2 C-m-0 
job-7042,3,6,2,351489,351489,351519,0,30,351794,true,L-m-0 C-m-2 
job-7038,3,11,6,351299,351299,351525,0,226,351650,true,L-l-0 C-l-2 C-l-0 C-s-2 C-m-1 C-m-1 
job-7041,5,6,1,351447,351447,351542,0,95,351669,true,C-l-2 
job-7040,2,12,7,351398,351398,351610,0,212,351843,true,L-m-0 L-m-0 L-l-0 L-l-0 L-l-0 C-m-2 C-m-2 
job-7043,5,12,7,351531,351531,351643,0,112,351752,true,L-l-0 C-l-2 C-m-1 C-m-0 C-l-0 C-l-0 C-l-1 
job-7044,5,7,7,351582,351643,351726,61,83,351952,true,L-m-0 L-l-0 L-l-0 C-m-1 C-m-0 C-m-2 C-l-0 
job-7045,5,5,7,351632,351726,351736,94,10,351842,true,L-m-0 L-l-0 L-l-0 C-m-1 C-m-0 C-m-2 C-l-0 
job-7046,1,9,5,351694,351726,351754,32,28,351845,true,L-m-0 L-m-0 L-m-0 L-l-0 L-l-0 
job-7047,2,7,8,351753,351753,351802,0,49,352010,true,L-l-0 L-l-0 L-l-0 L-l-0 L-s-0 L-s-0 C-s-2 C-s-2 
job-7050,3,9,6,351895,351895,351905,0,10,352052,true,C-m-1 C-m-0 C-m-2 C-s-2 C-s-0 C-s-1 
job-7051,4,11,6,351939,351939,352012,0,73,352254,true,C-s-2 C-s-0 C-s-1 C-l-0 C-l-0 C-l-0 
job-7052,3,5,7,351991,351991,352048,0,57,352121,true,C-m-1 C-m-0 C-m-2 C-l-2 C-l-2 C-l-2 C-l-2 
job-7048,2,10,7,351806,351806,352068,0,262,352307,true,L-s-0 L-m-0 L-m-0 L-m-0 L-l-0 L-l-0 L-l-0 
job-7049,5,12,4,351851,351851,352093,0,242,352303,true,L-l-0 C-m-1 C-m-0 C-m-2 
job-7053,3,12,7,352040,352040,352106,0,66,352144,true,C-s-2 C-s-0 C-s-1 C-l-0 C-l-0 C-l-0 C-l-0 
job-7054,1,12,7,352084,352084,352185,0,101,352242,true,L-l-0 L-l-0 L-l-0 C-m-1 C-m-0 C-m-2 L-s-0 
job-7055,1,11,6,352130,352130,352219,0,89,352382,true,L-l-0 C-m-1 C-m-0 C-m-2 L-m-0 L-m-0 
job-7056,4,7,5,352184,352184,352235,0,51,352402,true,L-m-0 C-m-1 C-m-0 C-m-2 C-s-2 
job-7057,2,6,4,352239,352239,352251,0,12,352484,true,L-s-0 L-s-0 L-m-0 L-m-0 
job-7058,6,9,2,352293,352293,352341,0,48,352594,true,L-m-0 L-l-0 
job-7060,5,11,5,352404,352404,352477,0,73,352760,true,C-m-2 C-l-0 C-l-0 C-l-2 C-l-2 
job-7059,5,6,5,352346,352346,352524,0,178,352785,true,L-m-0 L-l-0 L-l-0 C-m-1 C-m-0 
job-7063,3,12,4,352555,352555,352626,0,71,352656,true,L-m-0 L-l-0 L-l-0 C-l-2 
job-7061,1,9,6,352462,352462,352655,0,193,352773,true,L-m-0 L-m-0 L-l-0 L-l-0 C-m-2 C-m-2 
job-7064,5,5,2,352594,352594,352719,0,125,352743,true,C-m-1 C-m-0 
job-7062,6,8,4,352504,352504,352749,0,245,352781,true,C-m-2 C-l-0 C-l-0 C-l-2 
job-7065,4,8,7,352647,352647,352769,0,122,352996,true,L-m-0 L-l-0 L-l-0 C-l-2 L-s-0 C-s-2 C-s-0 
job-7066,1,10,1,352698,352698,352785,0,87,352886,true,L-m-0 
job-7068,2,10,2,352807,352807,352858,0,51,353134,true,L-m-0 L-m-0 
job-7067,2,10,7,352754,352754,352872,0,118,353041,true,L-m-0 L-l-0 L-l-0 C-l-2 C-l-2 C-l-2 C-l-2 
job-7070,6,9,4,352913,352913,353004,0,91,353231,true,L-l-0 L-m-0 C-m-2 C-m-1 
job-7072,5,10,3,352999,352999,353013,0,14,353027,true,C-m-0 C-l-2 C-l-2 
job-7071,1,12,5,352958,352958,353037,0,79,353068,true,L-m-0 L-l-0 C-m-2 C-m-1 C-s-0 
job-7073,2,7,6,353056,353056,353093,0,37,353290,true,L-l-0 L-l-0 L-l-0 L-m-0 L-m-0 L-m-0 
job-7069,1,12,4,352854,352854,353106,0,252,353186,true,L-l-0 L-l-0 L-s-0 C-s-2 
job-7076,6,4,2,353203,353203,353274,0,71,353451,true,C-m-2 C-m-1 
job-7077,5,8,6,353252,353252,353288,0,36,353455,true,C-m-0 C-l-2 C-l-2 C-l-0 C-l-0 C-l-1 
job-7074,2,8,1,353099,353099,353289,0,190,353497,true,L-l-0 
job-7075,6,10,2,353153,353153,353555,0,402,353588,true,L-l-0 L-m-0 
job-7078,5,6,7,353309,353309,353629,0,320,353811,true,L-l-0 C-m-2 C-m-1 C-m-0 C-l-2 C-l-2 C-l-0 
job-7082,2,11,2,353530,353629,353641,99,12,353795,true,L-m-0 C-m-2 
job-7080,6,9,6,353419,353629,353654,210,25,353510,false,C-l-0 L-m-0 L-l-0 L-l-0 C-m-2 C-m-1 
job-7081,5,11,4,353472,353629,353670,157,41,353677,true,C-m-0 C-l-2 C-l-2 C-l-1 
job-7083,4,8,6,353574,353654,353714,80,60,353908,true,C-l-1 C-l-0 C-l-0 L-m-0 L-m-0 L-l-0 
job-7079,4,12,2,353364,353364,353769,0,405,353969,true,C-l-0 L-s-0 
job-7086,4,6,2,353708,353708,353829,0,121,354091,true,C-s-0 C-s-1 
job-7085,3,12,1,353658,353670,353861,12,191,353998,true,C-s-2 
job-7084,6,12,7,353613,353670,353996,57,326,354203,true,L-l-0 C-l-1 C-m-0 C-m-2 C-m-1 C-l-2 C-l-2 
job-7091,1,6,2,353954,353996,354012,42,16,354067,true,L-s-0 C-l-2 
job-7090,2,6,7,353916,353996,354052,80,56,354265,true,L-m-0 C-m-0 C-m-2 C-m-1 C-l-2 C-l-2 C-l-2 
job-7088,3,8,1,353794,353996,354054,202,58,353971,false,L-s-0 
job-7089,4,6,3,353858,353996,354079,138,83,353999,false,C-s-2 C-s-0 C-s-1 
job-7087,6,12,6,353745,353996,354106,251,110,354018,false,L-m-0 L-l-0 L-l-0 C-m-0 C-m-2 C-m-1 
job-7092,6,6,2,354020,354020,354130,0,110,354178,true,C-l-2 C-l-1 
job-7094,2,12,8,354131,354131,354187,0,56,354470,true,L-m-0 C-m-0 C-m-2 L-s-0 L-l-0 L-l-0 L-l-0 L-l-0 
job-7096,6,7,4,354252,354252,354296,0,44,354497,true,L-m-0 C-m-0 L-l-0 L-l-0 
job-7095,3,6,3,354184,354184,354390,0,206,354463,true,C-m-2 C-s-2 C-s-0 
job-7097,1,9,7,354293,354293,354404,0,111,354668,true,C-s-2 C-s-0 C-m-2 L-s-0 C-s-1 C-m-1 C-m-1 
job-7099,1,7,7,354389,354389,354405,0,16,354649,true,L-s-0 L-l-0 C-s-1 C-m-2 C-l-2 C-l-2 C-l-2 
job-7100,2,4,7,354439,354439,354479,0,40,354553,true,L-m-0 L-l-0 L-l-0 C-m-0 C-m-1 C-m-1 C-m-1 
job-7102,5,7,2,354529,354529,354606,0,77,354821,true,C-m-1 C-m-2 
job-7103,3,7,1,354579,354579,354641,0,62,354720,true,L-s-0 
job-7101,1,6,1,354486,354486,354683,0,197,354721,true,L-l-0 
job-7104,3,9,8,354632,354632,354692,0,60,354769,true,C-m-1 C-m-1 C-m-2 C-m-2 C-s-2 C-s-0 C-s-1 C-l-2 
job-7098,2,10,7,354344,354344,354692,0,348,354771,true,L-m-0 C-m-0 C-m-1 L-l-0 L-l-0 L-l-0 L-l-0 
job-7106,2,4,4,354733,354733,354744,0,11,354979,true,L-s-0 L-m-0 L-m-0 C-m-0 
job-7105,2,4,7,354679,354679,354904,0,225,354946,true,L-m-0 C-m-0 C-l-2 C-l-2 C-l-2 C-l-2 L-s-0 
job-7109,4,12,2,354885,354885,354913,0,28,355035,true,C-l-2 L-l-0 
job-7107,2,4,1,354785,354785,354995,0,210,355167,true,L-s-0 
job-7111,6,9,6,354986,354986,355002,0,16,355285,true,C-m-1 C-l-2 C-l-2 C-l-1 C-l-1 C-l-0 
job-7110,3,12,6,354936,354936,355011,0,75,355023,true,L-l-0 L-l-0 L-l-0 L-l-0 C-s-2 C-s-0 
job-7108,3,4,4,354831,354831,355033,0,202,355077,true,L-m-0 C-m-0 C-m-2 C-m-2 
job-7112,1,10,1,355034,355034,355059,0,25,355190,true,L-m-0 
job-7093,1,9,5,354068,354068,355132,0,1064,355181,true,L-m-0 L-m-0 C-m-0 C-m-0 C-m-2 
job-7113,6,5,8,355084,355084,355198,0,114,355418,true,L-m-0 C-m-0 C-m-2 L-l-0 L-l-0 C-m-1 C-l-2 C-l-2 
job-7114,6,7,2,355143,355143,355301,0,158,355459,true,C-l-1 C-l-1 
job-7115,5,6,6,355197,355198,355323,1,125,355387,true,L-m-0 L-l-0 L-l-0 C-m-0 C-m-2 C-m-1 
job-7116,3,4,3,355237,355237,355335,0,98,355389,true,L-m-0 C-m-0 C-m-2 
job-7117,4,5,1,355298,355298,355441,0,143,355644,true,L-s-0 
job-7118,1,12,5,355354,355354,355452,0,98,355666,true,L-m-0 L-m-0 L-l-0 L-l-0 L-l-0 
job-7120,1,6,6,355438,355438,355630,0,192,355795,true,L-l-0 C-m-0 C-m-0 C-m-2 C-m-2 C-m-1 
job-7122,1,9,4,355542,355630,355705,88,75,355684,false,L-m-0 L-m-0 C-m-0 C-m-0 
job-7119,6,6,7,355394,355394,355788,0,394,356017,true,L-m-0 L-l-0 C-m-0 C-m-2 C-m-1 C-l-1 C-l-1 
job-7121,6,9,5,355489,355630,355860,141,230,355865,true,L-l-0 C-l-2 C-l-2 C-l-0 C-l-0 
job-7123,5,10,7,355601,355788,356259,187,471,356275,true,L-l-0 L-m-0 C-m-0 C-m-2 C-m-1 C-l-1 C-l-1 
job-7125,4,10,8,355710,356259,356484,549,225,355973,false,C-l-1 L-s-0 C-s-2 C-s-0 C-s-1 C-l-2 C-l-2 C-l-2 
job-7124,5,10,7,355660,356259,356493,599,234,355977,false,L-m-0 L-l-0 L-l-0 C-m-0 C-m-2 C-m-1 C-l-1 
job-7129,5,4,3,355927,356493,356519,566,26,356032,false,C-l-2 C-l-2 C-l-0 
job-7130,1,6,4,355977,356493,356541,516,48,356083,false,L-s-0 L-m-0 C-s-2 C-s-0 
job-7127,2,10,6,355801,356493,356651,692,158,356070,false,L-m-0 L-l-0 C-m-0 C-m-2 C-m-1 C-l-1 
job-7126,5,9,8,355754,356493,356737,739,244,356018,false,L-m-0 L-l-0 L-l-0 C-m-0 C-m-2 C-m-1 C-l-1 C-l-1 
job-7132,2,5,2,356079,356737,356764,658,27,356189,false,C-m-2 C-m-2 
job-7136,1,6,2,356289,356737,356768,448,31,356351,false,C-m-1 C-l-2 
job-7135,2,10,7,356242,356737,356768,495,31,356433,false,C-m-2 C-l-2 C-l-2 C-l-2 C-l-0 C-l-0 C-l-0 
job-7128,3,7,4,355867,356493,356773,626,280,356160,false,L-s-0 C-s-2 C-s-0 C-s-1 
job-7133,1,4,4,356138,356737,356775,599,38,356427,false,L-s-0 C-s-2 C-s-0 C-s-1 
job-7131,4,10,7,356025,356737,356812,712,75,356174,false,L-m-0 L-m-0 L-l-0 L-l-0 L-l-0 C-m-0 C-m-0 
job-7137,3,11,8,356344,356768,356834,424,66,356539,false,C-m-2 C-l-2 C-l-2 C-l-2 C-l-0 C-l-0 C-l-0 C-l-0 
job-7140,2,5,2,356489,356812,356847,323,35,356623,false,L-s-0 C-s-2 
job-7134,1,12,8,356187,356737,356880,550,143,356404,false,C-m-2 C-m-1 C-m-1 C-l-1 C-l-1 C-l-1 C-l-1 C-l-2 
job-7141,5,9,7,356558,356880,356910,322,30,356702,false,C-m-2 C-m-1 C-l-1 C-l-1 C-l-2 C-l-2 C-l-0 
job-7147,5,4,1,356861,356910,356923,49,13,357080,true,C-l-2 
job-7143,3,7,2,356650,356880,356931,230,51,356741,false,C-l-0 C-l-0 
job-7145,2,10,2,356770,356910,356939,140,29,356977,true,C-l-0 C-l-0 
job-7146,4,4,2,356815,356910,356942,95,32,356948,true,C-l-1 C-l-1 
job-7138,2,4,5,356391,356773,356946,382,173,356700,false,L-s-0 C-s-2 C-s-0 C-s-1 C-m-2 
job-7144,6,8,2,356703,356910,356965,207,55,356768,false,C-m-2 C-m-1 
job-7142,2,4,6,356604,356880,356974,276,94,356799,false,L-s-0 C-s-2 C-s-0 C-s-1 C-m-1 C-l-1 
job-7148,5,9,6,356914,356942,357024,28,82,357174,true,C-l-1 C-l-1 C-l-0 C-l-0 C-l-2 C-l-2 
job-7150,3,7,4,357014,357024,357109,10,85,357127,true,C-m-2 C-l-1 C-l-1 C-l-1 
job-7149,3,4,7,356960,356974,357120,14,146,357229,true,L-s-0 C-s-2 C-s-0 C-s-1 C-m-1 C-m-1 C-m-2 
job-7152,6,7,5,357117,357117,357166,0,49,357464,true,C-l-0 C-l-1 C-l-1 C-l-2 C-l-2 
job-7139,4,9,7,356444,356812,357167,368,355,356864,false,L-m-0 L-m-0 L-l-0 L-l-0 L-l-0 C-m-0 C-m-0 
job-7154,1,9,8,357220,357220,357233,0,13,357457,true,C-l-0 L-s-0 L-m-0 L-m-0 L-m-0 L-l-0 L-l-0 L-l-0 
job-7153,1,6,5,357174,357174,357238,0,64,357406,true,C-l-0 C-l-0 C-l-0 C-l-0 C-l-0 
job-7151,6,9,1,357065,357065,357310,0,245,357332,true,C-l-0 
job-7156,3,4,1,357313,357313,357325,0,12,357458,true,C-l-0 
job-7157,5,10,2,357356,357356,357372,0,16,357562,true,C-l-0 L-m-0 
job-7155,1,10,3,357273,357273,357386,0,113,357653,true,C-l-0 C-l-0 C-l-0 
job-7158,2,5,8,357403,357403,357455,0,52,357474,true,L-s-0 L-s-0 L-m-0 L-m-0 L-m-0 L-m-0 L-l-0 L-l-0 
job-7159,1,11,5,357446,357446,357464,0,18,357608,true,L-l-0 L-l-0 L-l-0 C-s-2 C-s-0 
job-7161,3,8,4,357535,357535,357558,0,23,357671,true,L-s-0 C-s-2 C-s-0 C-s-1 
job-7162,1,8,1,357566,357566,357587,0,21,357708,true,L-m-0 
job-7163,4,10,8,357604,357604,357671,0,67,357889,true,L-s-0 C-s-2 C-s-0 C-s-1 C-l-0 C-l-0 C-l-0 C-l-1 
job-7160,6,11,6,357486,357486,357739,0,253,357747,true,L-m-0 L-l-0 L-l-0 C-m-0 C-m-1 C-m-2 
job-7164,1,10,8,357652,357652,357753,0,101,357836,true,L-m-0 L-m-0 C-m-0 C-m-0 C-m-1 C-m-1 C-m-2 C-m-2 
job-7165,3,9,2,357711,357711,357769,0,58,358012,true,L-s-0 C-s-2 
job-7166,3,12,4,357752,357752,357773,0,21,357920,true,L-m-0 C-m-0 C-m-1 C-m-2 
job-7167,5,8,7,357792,357792,357846,0,54,357866,true,L-m-0 L-l-0 L-l-0 C-m-0 C-m-1 C-m-2 C-l-0 
job-7168,1,11,1,357838,357838,357879,0,41,358126,true,L-m-0 
job-7170,4,7,7,357933,357933,357947,0,14,358004,true,L-s-0 C-s-2 C-s-0 C-s-1 C-m-1 C-m-1 C-m-2 
job-7172,1,9,8,358034,358034,358066,0,32,358118,true,L-s-0 C-s-2 C-s-0 C-s-1 C-m-1 C-m-1 C-m-1 C-m-2 
job-7169,6,12,4,357890,357890,358129,0,239,358151,true,L-m-0 L-l-0 L-l-0 C-m-0 
job-7173,3,10,1,358083,358083,358143,0,60,358213,true,L-s-0 
job-7171,1,12,2,357985,357985,358163,0,178,358364,true,L-m-0 C-m-0 
job-7175,6,4,3,358192,358192,358202,0,10,358369,true,L-l-0 C-m-1 C-m-2 
job-7178,5,8,6,358365,358365,358446,0,81,358565,true,C-m-1 C-m-2 C-l-0 C-l-0 C-l-1 C-l-1 
job-7179,3,7,7,358425,358425,358446,0,21,358459,true,C-m-0 C-m-1 C-m-2 C-s-2 C-s-0 C-s-1 C-l-2 
job-7180,1,4,6,358475,358475,358511,0,36,358704,true,L-l-0 L-l-0 C-m-0 C-m-0 C-m-0 C-s-2 
job-7174,2,9,7,358148,358148,358583,0,435,358743,true,L-m-0 L-m-0 C-m-0 C-m-0 L-s-0 L-l-0 L-l-0 
job-7181,5,10,3,358516,358516,358602,0,86,358892,true,C-m-1 C-m-2 C-l-0 
job-7182,2,12,8,358565,358565,358667,0,102,358727,true,L-l-0 C-m-0 C-m-1 C-m-2 C-l-0 C-l-0 C-l-0 C-s-2 
job-7183,6,10,1,358613,358613,358668,0,55,358918,true,C-m-0 
job-7177,2,5,5,358299,358299,358714,0,415,358866,true,L-m-0 L-m-0 L-l-0 L-l-0 L-l-0 
job-7185,6,9,7,358704,358704,358731,0,27,359000,true,C-m-0 C-m-2 C-l-0 C-l-0 C-l-1 C-l-1 C-l-2 
job-7176,1,5,1,358249,358249,358826,0,577,358858,true,L-s-0 
job-7184,2,5,7,358651,358651,358840,0,189,359074,true,L-s-0 L-m-0 L-m-0 L-l-0 L-l-0 C-m-1 C-m-1 
job-7187,4,6,7,358812,358812,358878,0,66,359165,true,L-m-0 C-m-1 C-s-2 C-s-0 C-s-1 C-l-1 C-l-1 
job-7188,5,8,1,358865,358865,358887,0,22,358896,true,L-l-0 
job-7186,5,11,5,358766,358766,359008,0,242,359267,true,L-l-0 C-m-0 C-m-2 C-l-0 C-l-0 
job-7189,3,5,3,358920,358920,359022,0,102,359183,true,L-l-0 L-l-0 C-m-0 
job-7191,1,8,4,359019,359019,359029,0,10,359216,true,L-l-0 L-l-0 L-l-0 L-l-0 
job-7190,4,11,3,358967,358967,359033,0,66,359102,true,L-s-0 L-m-0 L-m-0 
job-7195,4,7,1,359229,359229,359261,0,32,359262,true,C-l-1 
job-7192,4,10,7,359067,359067,359305,0,238,359554,true,L-s-0 L-m-0 L-m-0 L-l-0 L-l-0 L-l-0 C-s-2 
job-7197,4,11,4,359335,359335,359348,0,13,359465,true,C-l-2 L-s-0 C-s-2 C-s-0 
job-7194,1,9,5,359183,359183,359364,0,181,359398,true,C-m-0 C-m-0 C-m-2 C-m-2 C-m-1 
job-7196,5,12,5,359277,359305,359407,28,102,359607,true,C-l-1 L-m-0 L-l-0 L-l-0 C-l-2 
job-7193,5,10,6,359131,359131,359428,0,297,359666,true,C-m-0 C-m-2 C-m-1 C-l-0 C-l-0 C-l-1 
job-7199,1,5,4,359417,359417,359448,0,31,359611,true,L-m-0 L-m-0 L-m-0 L-m-0 
job-7200,2,6,3,359455,359455,359468,0,13,359562,true,L-m-0 L-m-0 L-m-0 
job-7201,3,6,5,359502,359502,359555,0,53,359737,true,L-m-0 L-m-0 L-l-0 L-l-0 L-l-0 
job-7202,4,7,2,359547,359547,359583,0,36,359690,true,C-m-0 C-m-2 
job-7198,2,6,8,359378,359378,359746,0,368,359993,true,L-m-0 L-l-0 C-m-0 C-m-2 C-m-1 C-l-1 C-l-0 C-l-2 
job-7204,3,8,6,359637,359637,359777,0,140,359972,true,C-m-2 C-m-2 C-m-1 C-m-1 C-l-0 C-l-0 
job-7205,1,7,2,359699,359699,359782,0,83,359918,true,L-m-0 C-m-0 
job-7203,5,6,4,359583,359583,359922,0,339,359994,true,L-m-0 L-l-0 L-l-0 C-m-0 
job-7210,1,10,3,359936,359936,359986,0,50,360009,true,L-m-0 L-m-0 L-l-0 
job-7207,2,12,5,359803,359803,359996,0,193,360214,true,L-m-0 L-l-0 C-m-0 C-l-0 C-l-0 
job-7209,3,8,1,359904,359904,360002,0,98,360213,true,C-l-0 
job-7211,1,9,5,359984,359984,360014,0,30,360293,true,L-l-0 L-l-0 C-m-2 C-m-2 C-m-1 
job-7206,5,7,1,359753,359753,360026,0,273,360319,true,C-l-0 
job-7212,6,10,5,360024,360024,360118,0,94,360400,true,C-l-1 C-l-0 L-m-0 L-l-0 L-l-0 
job-7208,6,10,3,359849,359849,360129,0,280,360277,true,C-m-2 C-m-1 C-l-1 
job-7216,6,6,5,360187,360187,360208,0,21,360304,true,C-m-2 C-l-0 L-l-0 L-l-0 C-m-1 
job-7213,5,10,4,360077,360077,360242,0,165,360386,true,C-l-0 C-m-0 C-l-2 C-l-2 
job-7215,5,7,1,360149,360149,360247,0,98,360330,true,L-m-0 
job-7214,1,10,4,360116,360116,360294,0,178,360321,true,L-m-0 L-m-0 C-m-2 C-m-2 
job-7217,2,9,2,360233,360233,360335,0,102,360343,true,C-m-0 C-m-2 
job-7218,2,7,8,360287,360287,360440,0,153,360621,true,L-m-0 C-m-0 C-m-0 C-m-0 L-s-0 L-s-0 L-l-0 L-l-0 
job-7219,2,9,8,360327,360327,360454,0,127,360602,true,L-m-0 L-m-0 L-l-0 L-l-0 L-l-0 C-m-2 C-m-2 C-s-2 
job-7221,2,6,6,360424,360424,360497,0,73,360595,true,C-m-0 C-m-2 C-m-2 C-s-0 C-s-0 C-s-1 
job-7222,2,11,1,360464,360464,360516,0,52,360550,true,L-m-0 
job-7220,2,4,3,360377,360377,360575,0,198,360839,true,L-m-0 L-l-0 C-s-2 
job-7224,4,12,3,360564,360564,360605,0,41,360733,true,L-m-0 L-l-0 L-s-0 
job-7225,6,12,1,360610,360610,360673,0,63,360925,true,L-l-0 
job-7223,5,12,1,360510,360510,360713,0,203,360817,true,L-l-0 
job-7226,2,9,6,360659,360659,360770,0,111,361035,true,L-s-0 L-m-0 L-m-0 L-m-0 C-s-2 C-s-0 
job-7228,5,10,3,360748,360748,360865,0,117,361078,true,L-l-0 C-m-1 C-l-2 
job-7227,5,6,3,360704,360704,360897,0,193,361171,true,L-l-0 C-m-2 C-m-0 
job-7230,1,10,7,360832,360832,360917,0,85,361150,true,L-l-0 L-l-0 C-m-1 C-m-1 C-m-2 C-m-2 C-m-0 
job-7229,6,11,1,360785,360785,360935,0,150,361141,true,C-l-2 
job-7231,5,4,2,360884,360884,360947,0,63,361091,true,L-l-0 C-m-1 
job-7232,6,5,8,360937,360937,360991,0,54,361046,true,L-l-0 L-m-0 C-m-2 C-m-0 C-l-2 C-l-2 C-l-0 C-l-0 
job-7233,1,5,7,360982,360982,361016,0,34,361025,true,L-m-0 L-m-0 L-l-0 L-l-0 L-l-0 L-l-0 L-l-0 
job-7234,1,11,1,361031,361031,361057,0,26,361209,true,L-s-0 
job-7236,6,10,3,361138,361138,361357,0,219,361422,true,C-l-2 C-l-2 C-l-0 
job-7235,6,5,6,361083,361083,361475,0,392,361540,true,L-m-0 L-l-0 L-l-0 C-m-2 C-m-0 C-m-1 
job-7238,6,6,4,361251,361475,361518,224,43,361359,false,C-l-2 C-l-0 C-l-0 C-l-1 
job-7239,1,4,5,361306,361475,361527,169,52,361600,true,L-m-0 L-m-0 L-m-0 L-l-0 L-l-0 
job-7237,5,7,7,361201,361475,361528,274,53,361274,false,L-m-0 L-l-0 L-l-0 C-m-2 C-m-0 C-m-1 C-l-2 
job-7240,4,5,8,361359,361518,361529,159,11,361521,false,C-l-2 L-s-0 C-s-2 C-s-0 C-s-1 C-l-0 C-l-0 C-l-0 
job-7242,3,10,2,361468,361518,361564,50,46,361575,true,C-l-1 C-l-1 
job-7244,5,6,4,361556,361556,361636,0,80,361713,true,C-l-2 C-l-2 L-m-0 L-l-0 
job-7243,6,7,3,361520,361528,361677,8,149,361929,true,C-m-2 C-m-0 C-m-1 
job-7246,6,5,6,361683,361683,361704,0,21,361877,true,L-m-0 L-l-0 C-m-2 C-m-0 C-m-1 C-l-1 
job-7247,5,7,4,361729,361729,361747,0,18,361935,true,L-m-0 L-l-0 L-l-0 C-m-2 
job-7248,3,10,6,361786,361786,361820,0,34,362048,true,L-m-0 L-m-0 L-l-0 L-l-0 L-l-0 C-m-2 
job-7245,2,9,2,361614,361614,361835,0,221,362107,true,L-m-0 L-l-0 
job-7250,3,11,1,361916,361916,361933,0,17,362006,true,C-m-0 
job-7241,2,6,6,361410,361518,361967,108,449,361884,false,C-m-2 C-m-0 C-m-1 C-l-2 C-l-1 C-l-1 
job-7249,6,8,1,361850,361850,361980,0,130,362142,true,C-m-2 
job-7252,2,7,4,362028,362028,362052,0,24,362149,true,L-m-0 L-m-0 C-m-2 C-m-2 
job-7251,2,12,3,361971,361971,362117,0,146,362349,true,C-m-2 L-s-0 L-m-0 
job-7254,3,12,5,362120,362120,362210,0,90,362331,true,L-m-0 C-m-2 L-s-0 C-s-2 C-s-0 
job-7255,4,12,4,362159,362159,362215,0,56,362371,true,C-s-1 C-m-0 C-m-0 C-m-1 
job-7253,4,8,5,362084,362084,362236,0,152,362421,true,L-m-0 C-m-2 L-l-0 L-l-0 L-l-0 
job-7257,5,10,8,362262,362262,362306,0,44,362492,true,L-m-0 C-m-2 L-l-0 L-l-0 C-m-0 C-m-1 C-l-1 C-l-1 
job-7258,3,5,6,362310,362310,362364,0,54,362475,true,L-s-0 L-m-0 L-m-0 C-m-2 C-m-2 L-l-0 
job-7261,4,11,3,362466,362466,362511,0,45,362680,true,L-l-0 L-l-0 C-s-2 
job-7262,3,10,5,362517,362517,362535,0,18,362661,true,L-l-0 L-l-0 C-s-2 C-s-0 C-s-1 
job-7256,1,9,5,362217,362217,362541,0,324,362688,true,L-m-0 L-m-0 C-m-2 C-m-2 L-s-0 
job-7260,3,4,1,362414,362414,362563,0,149,362759,true,L-s-0 
job-7263,6,10,6,362565,362565,362635,0,70,362902,true,L-l-0 C-m-0 C-m-1 C-l-1 C-l-1 C-l-2 
job-7259,4,12,3,362365,362365,362687,0,322,362793,true,L-m-0 C-m-2 L-l-0 
job-7264,2,12,1,362606,362606,362747,0,141,362790,true,L-m-0 
job-7266,2,6,3,362710,362710,362778,0,68,362802,true,L-m-0 L-m-0 L-m-0 
job-7265,6,6,5,362657,362657,362812,0,155,362950,true,L-l-0 C-m-0 C-m-1 C-l-1 C-l-1 
job-7268,4,4,8,362802,362802,362822,0,20,362836,true,L-m-0 L-s-0 C-s-2 C-s-0 C-s-1 C-m-2 C-m-2 C-l-2 
job-7269,3,4,7,362853,362853,362881,0,28,362928,true,L-m-0 L-m-0 L-l-0 L-l-0 L-l-0 L-s-0 C-s-2 
job-7271,4,11,7,362957,362957,363012,0,55,363050,true,L-l-0 C-l-2 L-s-0 C-s-2 C-s-0 C-s-1 C-l-0 
job-7270,5,4,8,362907,362907,363034,0,127,363209,true,L-m-0 L-l-0 C-m-0 C-m-1 C-m-2 C-l-1 C-l-1 C-l-2 
job-7267,1,10,4,362754,362754,363111,0,357,363115,true,L-m-0 L-l-0 L-l-0 L-l-0 
job-7275,3,6,7,363160,363160,363171,0,11,363402,true,C-m-1 C-m-2 C-s-2 C-s-0 C-s-1 C-l-0 C-l-0 
job-7272,1,6,7,363014,363014,363210,0,196,363358,true,L-m-0 L-m-0 L-l-0 L-l-0 C-m-0 C-m-0 C-m-0 
job-7273,4,8,3,363059,363059,363227,0,168,363389,true,L-m-0 C-m-0 L-s-0 
job-7274,5,4,8,363111,363111,363246,0,135,363337,true,L-l-0 L-l-0 C-m-1 C-m-2 C-l-1 C-l-1 C-l-2 C-l-2 
job-7276,1,11,8,363210,363210,363295,0,85,363486,true,L-m-0 L-m-0 L-l-0 L-l-0 C-m-0 C-m-0 C-m-1 C-m-1 
job-7277,1,7,4,363248,363248,363349,0,101,363463,true,L-m-0 L-l-0 L-l-0 L-l-0 
job-7278,4,12,3,363296,363296,363357,0,61,363498,true,L-m-0 L-l-0 L-l-0 
job-7280,6,6,6,363394,363394,363426,0,32,363545,true,L-m-0 L-l-0 L-l-0 C-m-0 C-m-1 C-m-2 
job-7281,1,10,4,363447,363447,363508,0,61,363674,true,L-m-0 L-m-0 L-s-0 L-l-0 
job-7283,5,6,4,363536,363536,363589,0,53,363800,true,L-m-0 L-l-0 C-m-1 C-m-2 
job-7284,1,6,8,363604,363604,363679,0,75,363872,true,L-m-0 L-m-0 L-m-0 L-l-0 L-l-0 L-l-0 L-l-0 L-l-0 
job-7285,4,9,2,363654,363654,363729,0,75,364021,true,L-s-0 C-s-2 
job-7287,3,6,6,363765,363765,363782,0,17,363933,true,L-m-0 L-s-0 C-s-2 C-s-1 C-m-1 C-m-1 
job-7282,6,6,2,363496,363496,363858,0,362,363986,true,L-l-0 C-m-0 
job-7279,1,11,1,363349,363349,363870,0,521,364045,true,L-m-0 
job-7289,3,8,5,363867,363867,363879,0,12,363965,true,L-l-0 L-l-0 C-m-0 C-m-1 C-m-1 
job-7286,4,9,3,363712,363712,363923,0,211,364134,true,L-m-0 L-l-0 C-s-0 
job-7288,1,11,8,363808,363808,364008,0,200,364231,true,L-m-0 L-l-0 L-l-0 C-m-0 C-m-0 L-s-0 C-s-2 C-s-1 
job-7291,6,7,7,363949,364008,364030,59,22,364195,true,L-l-0 C-l-1 L-m-0 C-l-2 C-l-2 C-l-0 C-l-0 
job-7293,6,10,3,364057,364057,364087,0,30,364218,true,L-l-0 C-l-1 L-m-0 
job-7292,4,8,1,364003,364008,364098,5,90,364306,true,L-s-0 
job-7290,5,6,5,363910,363910,364099,0,189,364307,true,L-l-0 C-m-0 C-m-1 C-m-2 C-l-1 
job-7294,3,8,7,364125,364125,364177,0,52,364366,true,L-s-0 L-m-0 L-m-0 L-l-0 L-l-0 L-l-0 L-l-0 
job-7295,1,11,3,364185,364185,364200,0,15,364274,true,L-s-0 L-m-0 L-m-0 
job-7297,1,6,4,364267,364267,364286,0,19,364575,true,L-l-0 L-l-0 L-l-0 L-l-0 
job-7296,1,8,7,364227,364227,364315,0,88,364592,true,L-s-0 L-s-0 L-m-0 L-m-0 L-m-0 L-m-0 L-l-0 
job-7298,4,11,7,364309,364309,364384,0,75,364422,true,L-l-0 L-l-0 C-s-2 C-s-1 C-s-0 C-m-0 C-m-0 
job-7299,6,4,4,364345,364345,364409,0,64,364615,true,L-m-0 C-m-1 C-m-2 C-l-1 
job-7300,6,12,3,364408,364408,364445,0,37,364526,true,C-l-1 L-l-0 L-l-0 
job-7301,2,11,3,364474,364474,364504,0,30,364540,true,L-s-0 L-m-0 L-m-0 
job-7302,2,7,6,364527,364527,364659,0,132,364831,true,L-s-0 L-s-0 L-m-0 L-m-0 L-m-0 L-m-0 
job-7304,1,10,8,364644,364644,364770,0,126,364950,true,C-s-2 C-s-1 C-s-0 C-m-1 C-m-1 C-m-1 C-m-2 C-m-2 
job-7305,6,10,4,364710,364710,364770,0,60,364955,true,C-m-2 L-m-0 C-m-0 C-l-1 
job-7306,2,7,4,364762,364762,364861,0,99,364963,true,L-m-0 C-m-0 C-l-1 C-l-1 
job-7303,3,10,4,364601,364601,364888,0,287,364931,true,L-l-0 L-l-0 L-l-0 L-l-0 
job-7309,5,10,5,364925,364925,365039,0,114,365286,true,L-l-0 L-l-0 C-m-2 C-m-1 C-l-2 
job-7307,3,11,8,364823,364823,365091,0,268,365316,true,L-m-0 L-m-0 C-m-0 C-m-0 C-l-1 C-l-1 L-s-0 C-s-2 
job-7308,2,8,6,364870,364870,365102,0,232,365226,true,L-m-0 C-m-0 C-l-1 C-l-1 C-l-1 C-s-1 
job-7312,1,7,2,365065,365091,365141,26,50,365387,true,L-l-0 L-l-0 
job-7311,6,10,3,365008,365091,365161,83,70,365222,true,L-m-0 C-m-0 C-l-1 
job-7313,4,6,3,365119,365119,365181,0,62,365386,true,C-l-1 C-l-0 L-s-0 
job-7310,5,4,7,364961,365039,365181,78,142,365350,true,L-l-0 L-l-0 C-m-2 C-m-1 C-l-2 C-l-2 C-l-0 
job-7316,2,11,8,365276,365276,365342,0,66,365525,true,L-l-0 L-l-0 L-l-0 L-l-0 C-s-1 C-s-2 C-s-0 C-m-2 
job-7317,6,12,4,365320,365320,365365,0,45,365477,true,C-m-2 C-m-1 C-m-0 C-l-2 
job-7315,2,6,4,365216,365216,365384,0,168,365568,true,C-l-1 C-l-1 L-s-0 L-s-0 
job-7318,5,7,5,365369,365369,365456,0,87,365671,true,L-l-0 L-l-0 C-m-2 C-m-1 C-m-0 
job-7314,4,5,4,365167,365167,365508,0,341,365717,true,C-l-1 C-l-1 L-m-0 L-m-0 
job-7319,2,7,3,365413,365413,365520,0,107,365552,true,L-l-0 C-m-2 C-m-1 
job-7320,3,5,6,365462,365462,365551,0,89,365725,true,L-l-0 L-l-0 L-l-0 C-m-2 C-m-2 C-m-1 
job-7321,6,9,1,365506,365506,365563,0,57,365571,true,C-m-0 
job-7323,6,8,7,365608,365608,365655,0,47,365920,true,C-m-0 C-m-2 C-m-1 C-l-1 C-l-1 C-l-2 C-l-2 
job-7322,4,8,6,365561,365561,365678,0,117,365893,true,L-s-0 L-m-0 L-m-0 L-l-0 L-l-0 L-l-0 
job-7325,5,7,2,365727,365727,365791,0,64,366026,true,L-m-0 L-l-0 
job-7326,2,9,3,365787,365787,365925,0,138,366108,true,L-m-0 L-l-0 L-l-0 
job-7327,5,12,7,365853,365853,365925,0,72,365971,true,L-m-0 L-l-0 C-m-0 C-m-2 C-m-1 C-l-1 C-l-1 
job-7328,2,8,2,365916,365916,365944,0,28,366141,true,L-l-0 C-m-0 
job-7324,2,10,3,365665,365665,365951,0,286,366108,true,C-s-1 C-s-2 C-s-0 
job-7330,6,11,2,366007,366007,366025,0,18,366295,true,L-l-0 L-l-0 
job-7329,5,7,1,365955,365955,366167,0,212,366270,true,L-m-0 
job-7331,5,8,8,366057,366057,366242,0,185,366300,true,L-l-0 L-l-0 C-m-0 C-m-2 C-m-1 C-l-1 C-l-1 C-l-2 
job-7332,5,9,8,366114,366242,366277,128,35,366319,true,L-m-0 L-l-0 L-l-0 C-m-0 C-m-2 C-m-1 C-l-1 C-l-1 
job-7335,1,8,4,366259,366259,366278,0,19,366462,true,L-m-0 C-m-0 C-m-2 C-m-1 
job-7334,2,9,5,366214,366242,366294,28,52,366393,true,L-s-0 C-s-1 C-s-2 C-s-0 C-l-2 
job-7333,2,4,6,366158,366242,366308,84,66,366296,false,L-m-0 L-l-0 C-m-0 C-m-2 C-m-1 C-l-1 
job-7336,3,12,5,366313,366313,366383,0,70,366425,true,L-s-0 L-m-0 L-m-0 L-l-0 L-l-0 
job-7338,6,7,6,366431,366431,366517,0,86,366698,true,L-l-0 L-m-0 C-m-1 C-l-1 C-l-1 C-l-2 
job-7339,4,7,1,366485,366485,366540,0,55,366817,true,C-l-2 
job-7337,5,7,3,366370,366370,366655,0,285,366694,true,L-l-0 C-m-0 C-m-2 
job-7340,6,8,3,366530,366530,366682,0,152,366817,true,L-l-0 C-l-2 L-m-0 
job-7341,5,9,2,366579,366579,366726,0,147,366813,true,C-l-2 C-m-1 
job-7342,2,5,6,366634,366634,366755,0,121,367003,true,L-m-0 C-m-1 C-m-0 C-m-2 L-s-0 L-s-0 
job-7343,5,12,4,366671,366671,366780,0,109,366916,true,L-l-0 C-m-0 C-m-2 C-l-1 
job-7344,2,8,8,366725,366725,366839,0,114,366863,true,L-m-0 L-m-0 L-m-0 L-l-0 L-l-0 L-l-0 C-l-1 C-l-1 
job-7346,1,9,6,366829,366829,366839,0,10,367012,true,L-l-0 L-l-0 C-m-0 C-m-0 C-m-2 C-m-2 
job-7347,1,8,2,366869,366869,366968,0,99,367256,true,C-m-0 C-m-0 
job-7348,1,5,7,366922,366922,367017,0,95,367028,true,C-m-2 C-m-2 C-m-2 C-m-2 C-l-1 C-l-1 C-l-1 
job-7350,2,6,4,367009,367009,367024,0,15,367134,true,L-s-0 L-m-0 L-m-0 L-m-0 
job-7351,3,12,3,367050,367050,367068,0,18,367247,true,C-m-2 C-l-1 L-m-0 
job-7349,2,4,7,366977,366977,367126,0,149,367341,true,C-m-0 C-m-0 C-m-0 C-l-1 C-l-1 C-l-1 L-s-0 
job-7352,5,8,6,367117,367117,367175,0,58,367455,true,C-m-2 L-m-0 L-l-0 L-l-0 C-m-1 C-l-2 
job-7353,1,11,3,367168,367168,367180,0,12,367209,true,L-m-0 L-m-0 L-l-0 
job-7345,2,12,3,366772,366772,367209,0,437,367427,true,C-m-0 C-m-2 C-l-1 
job-7354,2,11,2,367223,367223,367270,0,47,367438,true,L-s-0 L-m-0 
job-7357,5,12,2,367387,367387,367411,0,24,367641,true,C-m-0 C-l-2 
job-7355,5,5,5,367289,367289,367465,0,176,367529,true,L-m-0 L-l-0 L-l-0 C-m-2 C-m-1 
job-7361,5,9,4,367585,367585,367607,0,22,367855,true,L-l-0 L-l-0 C-m-2 C-m-1 
job-7356,4,10,2,367341,367341,367616,0,275,367659,true,L-s-0 C-s-1 
job-7359,1,6,3,367493,367493,367620,0,127,367773,true,C-m-0 C-m-0 C-m-0 
job-7358,5,12,5,367450,367450,367643,0,193,367690,true,C-m-0 C-l-2 C-l-2 C-l-1 C-l-1 
job-7363,5,4,1,367681,367681,367694,0,13,367827,true,C-m-0 
job-7360,5,4,1,367538,367538,367741,0,203,367882,true,L-m-0 
job-7364,2,11,4,367725,367725,367794,0,69,367996,true,C-m-0 C-l-2 C-l-2 C-l-1 
job-7365,5,12,5,367768,367768,367819,0,51,368089,true,L-m-0 C-l-1 L-l-0 L-l-0 C-m-2 
job-7362,1,10,7,367639,367639,367858,0,219,368135,true,L-m-0 L-m-0 C-m-0 C-m-0 C-l-2 C-l-2 C-l-1 
job-7366,2,9,1,367824,367824,367909,0,85,368070,true,L-m-0 
job-7367,5,12,6,367860,367860,367943,0,83,368161,true,L-m-0 L-l-0 L-l-0 C-m-0 C-m-2 C-m-1 
job-7369,6,8,8,367964,367964,368006,0,42,368261,true,C-l-1 L-m-0 L-l-0 L-l-0 C-m-0 C-m-2 C-m-1 C-l-0 
job-7370,4,11,5,368020,368020,368033,0,13,368070,true,C-l-1 C-l-1 L-m-0 L-m-0 L-l-0 
job-7368,4,7,8,367919,367919,368165,0,246,368268,true,L-s-0 C-s-1 C-s-2 C-s-0 C-l-2 C-l-2 C-l-2 C-l-1 
job-7372,2,8,5,368101,368101,368223,0,122,368248,true,L-m-0 C-l-1 L-l-0 L-l-0 L-l-0 
job-7374,5,12,5,368194,368194,368227,0,33,368435,true,C-l-1 C-m-1 C-l-2 C-l-2 C-l-0 
job-7373,4,8,4,368148,368148,368233,0,85,368313,true,L-l-0 C-m-0 C-m-0 C-m-2 
job-7371,5,8,2,368063,368063,368236,0,173,368363,true,C-l-1 L-m-0 
job-7375,6,11,8,368248,368248,368259,0,11,368325,true,L-m-0 L-l-0 L-l-0 C-m-0 C-m-2 C-m-1 C-l-1 C-l-1 
job-7376,6,5,7,368300,368300,368346,0,46,368361,true,L-m-0 L-l-0 L-l-0 C-m-0 C-m-2 C-m-1 C-l-1 
job-7377,6,6,7,368357,368357,368369,0,12,368403,true,L-m-0 L-l-0 L-l-0 C-m-0 C-m-2 C-m-1 C-l-1 
job-7378,6,4,4,368401,368401,368502,0,101,368689,true,L-m-0 L-l-0 L-l-0 C-m-0 
job-7379,1,7,3,368451,368451,368517,0,66,368691,true,L-m-0 L-m-0 C-m-0 
job-7381,3,12,6,368540,368540,368557,0,17,368746,true,C-l-2 C-l-2 L-s-0 L-m-0 L-m-0 L-l-0 
job-7380,6,10,5,368497,368497,368597,0,100,368812,true,C-m-2 C-m-1 C-l-1 C-l-1 C-l-2 
job-7382,2,9,6,368588,368588,368661,0,73,368708,true,C-m-2 C-m-1 C-l-2 C-l-2 C-l-2 L-s-0 
job-7383,3,7,3,368651,368651,368664,0,13,368717,true,C-m-2 C-m-2 C-m-1 
job-7384,2,9,7,368694,368694,368727,0,33,368779,true,L-s-0 L-m-0 L-m-0 L-m-0 L-l-0 L-l-0 L-l-0 
job-7385,2,6,2,368730,368730,368749,0,19,368773,true,L-s-0 L-s-0 
job-7386,2,8,3,368786,368786,368810,0,24,368826,true,L-s-0 L-s-0 L-m-0 
job-7388,2,7,3,368882,368882,368896,0,14,369124,true,C-s-2 C-s-2 C-s-0 
job-7389,5,11,2,368927,368927,368950,0,23,369173,true,C-m-2 C-m-1 
job-7387,4,4,7,368830,368830,368976,0,146,369234,true,L-s-0 L-m-0 L-m-0 L-l-0 L-l-0 L-l-0 C-s-1 
job-7390,3,4,2,368971,368971,368990,0,19,369160,true,C-s-2 C-s-0 
job-7392,3,9,3,369078,369078,369131,0,53,369237,true,C-s-2 C-s-0 C-m-2 
job-7393,1,8,4,369132,369132,369192,0,60,369447,true,L-s-0 L-m-0 L-m-0 C-s-1 
job-7394,4,6,2,369185,369185,369243,0,58,369402,true,C-s-2 C-s-0 
job-7395,5,12,1,369232,369232,369324,0,92,369594,true,C-m-2 
job-7391,3,5,8,369023,369023,369356,0,333,369491,true,L-s-0 L-m-0 L-m-0 L-l-0 L-l-0 L-l-0 L-l-0 C-s-1 
job-7396,3,4,6,369276,369276,369398,0,122,369503,true,C-m-2 C-s-2 C-s-0 C-m-1 C-m-1 C-m-0 
job-7398,5,8,1,369378,369378,369427,0,49,369629,true,C-m-2 
job-7397,4,5,4,369323,369323,369456,0,133,369607,true,C-m-0 C-l-2 C-l-2 C-l-2 
job-7399,4,9,2,369425,369425,369493,0,68,369720,true,C-m-0 L-s-0 
job-7401,6,7,7,369526,369526,369615,0,89,369860,true,C-m-2 C-m-1 C-l-2 C-l-2 C-l-1 C-l-1 C-l-0 
job-7400,3,7,8,369476,369476,369618,0,142,369792,true,C-m-0 L-m-0 L-m-0 L-l-0 L-l-0 L-l-0 L-l-0 C-s-2 
job-7402,2,10,2,369572,369572,369648,0,76,369672,true,L-m-0 C-m-2 
job-7403,2,4,2,369622,369622,369731,0,109,369735,true,L-m-0 L-m-0 
job-7405,5,12,1,369704,369704,369789,0,85,369842,true,L-l-0 
job-7404,3,6,2,369666,369666,369791,0,125,370028,true,L-m-0 L-s-0 
job-7406,1,4,2,369759,369759,369843,0,84,370021,true,L-s-0 L-m-0 
job-7407,4,12,8,369800,369800,369850,0,50,369877,true,L-m-0 L-l-0 L-l-0 L-l-0 C-s-2 C-s-0 C-s-1 C-m-2 
job-7408,2,6,1,369843,369843,369913,0,70,370072,true,L-m-0 
job-7409,5,12,1,369895,369895,369980,0,85,370104,true,L-m-0 
job-7411,6,10,8,369997,369997,370021,0,24,370088,true,L-m-0 C-m-2 C-m-1 C-m-0 C-l-2 C-l-2 C-l-1 C-l-1 
job-7410,4,7,3,369946,369946,370051,0,105,370307,true,L-s-0 L-l-0 L-l-0 
job-7412,4,11,7,370039,370039,370080,0,41,370168,true,L-l-0 L-m-0 L-m-0 C-s-2 C-s-0 C-s-1 C-m-2 
job-7413,4,4,6,370093,370093,370128,0,35,370217,true,L-s-0 L-m-0 L-m-0 L-l-0 L-l-0 L-l-0 
job-7414,1,7,2,370132,370132,370268,0,136,370394,true,L-s-0 L-s-0 
job-7416,5,11,3,370222,370222,370291,0,69,370501,true,C-m-2 C-m-1 C-m-0 
job-7417,6,11,3,370281,370281,370325,0,44,370595,true,C-l-2 C-l-2 C-l-1 
job-7415,4,8,5,370173,370173,370396,0,223,370429,true,L-m-0 L-m-0 L-l-0 L-l-0 L-l-0 
job-7420,5,5,1,370440,370440,370468,0,28,370551,true,C-l-2 
job-7419,6,10,4,370388,370388,370492,0,104,370518,true,C-m-2 C-m-1 C-m-0 C-l-2 
job-7421,5,8,8,370492,370492,370507,0,15,370630,true,L-m-0 L-l-0 L-l-0 C-m-2 C-m-1 C-m-0 C-l-2 C-l-2 
job-7422,3,12,7,370535,370535,370572,0,37,370623,true,L-m-0 L-m-0 L-l-0 L-l-0 L-l-0 L-l-0 C-s-0 
job-7424,4,7,3,370637,370637,370656,0,19,370786,true,L-m-0 C-m-2 C-m-2 
job-7418,1,9,2,370342,370342,370757,0,415,370787,true,L-s-0 C-s-2 
job-7425,6,8,7,370683,370683,370760,0,77,371028,true,L-m-0 C-m-2 C-m-1 C-m-0 C-l-2 C-l-2 C-l-1 
job-7426,6,12,5,370721,370760,370776,39,16,370924,true,C-m-2 C-m-1 C-m-0 C-l-2 C-l-2 
job-7427,4,10,5,370765,370765,370846,0,81,370972,true,L-s-0 C-s-2 C-l-1 C-l-1 C-l-1 
job-7423,1,12,8,370587,370587,370867,0,280,371074,true,L-m-0 L-m-0 L-l-0 L-l-0 L-l-0 L-l-0 C-s-0 C-s-1 
job-7431,6,7,3,370956,370956,370985,0,29,371256,true,C-l-1 C-l-2 C-l-2 
job-7430,5,12,6,370903,370903,371005,0,102,371218,true,L-m-0 L-l-0 L-l-0 C-m-1 C-m-0 C-l-1 
job-7428,3,9,2,370807,370807,371007,0,200,371129,true,C-m-2 C-m-2 
job-7432,3,9,7,371006,371006,371111,0,105,371399,true,L-s-0 L-m-0 L-m-0 L-l-0 L-l-0 L-l-0 L-l-0 
job-7434,1,7,5,371115,371115,371125,0,10,371327,true,C-m-1 C-m-1 C-m-0 C-m-0 C-l-0 
job-7433,6,8,8,371058,371058,371159,0,101,371250,true,C-m-2 C-m-1 C-m-0 C-l-1 C-l-1 C-l-2 C-l-2 C-l-0 
job-7435,6,11,2,371166,371166,371226,0,60,371262,true,C-m-2 L-m-0 
job-7436,6,8,7,371217,371217,371253,0,36,371552,true,L-l-0 L-l-0 C-m-1 C-m-0 C-l-1 C-l-1 C-l-2 
job-7429,2,9,1,370848,370848,371272,0,424,371386,true,C-m-2 
job-7438,2,7,8,371319,371319,371330,0,11,371432,true,L-m-0 L-l-0 L-l-0 L-l-0 C-m-2 C-m-2 C-s-0 C-s-0 
job-7437,3,12,6,371271,371271,371350,0,79,371506,true,C-m-2 L-s-0 L-m-0 L-m-0 L-l-0 L-l-0 
job-7439,3,9,1,371374,371374,371500,0,126,371682,true,L-s-0 
job-7440,1,9,4,371424,371424,371501,0,77,371720,true,L-m-0 L-m-0 L-m-0 L-l-0 
job-7441,5,10,5,371474,371474,371509,0,35,371654,true,L-l-0 L-l-0 C-m-2 C-m-1 C-m-0 
job-7442,4,11,2,371519,371519,371563,0,44,371751,true,L-s-0 L-m-0 
job-7446,3,4,5,371709,371709,371732,0,23,371848,true,L-m-0 C-s-0 C-s-1 C-s-2 C-m-0 
job-7443,1,6,6,371572,371572,371785,0,213,371791,true,L-s-0 L-s-0 L-m-0 L-m-0 L-m-0 L-m-0 
job-7445,6,4,2,371667,371667,371791,0,124,372062,true,C-m-2 C-m-1 
job-7447,6,8,4,371768,371768,371801,0,33,371929,true,C-m-0 C-l-1 C-l-1 C-l-2 
job-7449,1,11,7,371861,371861,371886,0,25,372180,true,L-m-0 L-m-0 C-s-0 C-s-1 C-s-2 C-m-2 C-m-2 
job-7444,6,6,2,371621,371621,371910,0,289,372163,true,L-l-0 L-l-0 
job-7450,2,7,8,371905,371905,371934,0,29,371965,true,L-m-0 L-m-0 C-s-0 C-s-0 C-s-1 C-s-1 C-s-2 C-s-2 
job-7448,3,10,2,371815,371815,371959,0,144,372054,true,L-s-0 L-m-0 
job-7452,1,6,7,372010,372010,372041,0,31,372054,true,L-l-0 L-l-0 L-l-0 L-l-0 C-s-0 C-s-0 C-s-1 
job-7451,4,12,5,371962,371962,372112,0,150,372297,true,L-s-0 L-m-0 L-m-0 L-l-0 L-l-0 
job-7454,4,10,4,372104,372104,372143,0,39,372422,true,C-s-0 C-s-1 C-s-2 C-m-2 
job-7455,6,6,1,372157,372157,372172,0,15,372281,true,L-l-0 
job-7456,3,11,6,372195,372195,372238,0,43,372243,true,L-l-0 L-l-0 L-s-0 L-m-0 L-m-0 C-s-0 
job-7457,2,10,4,372230,372230,372267,0,37,372359,true,L-m-0 L-l-0 C-s-1 C-s-2 
job-7459,5,6,8,372345,372345,372359,0,14,372432,true,L-m-0 C-m-2 C-m-1 C-m-0 C-l-1 C-l-1 C-l-2 C-l-2 
job-7458,2,9,4,372286,372286,372369,0,83,372595,true,L-l-0 L-l-0 L-l-0 L-l-0 
job-7453,4,12,1,372060,372060,372389,0,329,372418,true,L-l-0 
job-7460,2,5,5,372397,372397,372416,0,19,372649,true,L-s-0 L-s-0 L-m-0 L-m-0 L-m-0 
job-7461,4,8,2,372453,372453,372592,0,139,372884,true,L-s-0 L-m-0 
job-7462,5,10,6,372495,372495,372639,0,144,372853,true,L-l-0 L-l-0 C-m-2 C-m-1 C-m-0 C-l-1 
job-7464,5,10,2,372591,372591,372689,0,98,372793,true,C-l-0 C-l-0 
job-7463,6,4,3,372537,372537,372693,0,156,372914,true,C-l-1 C-l-2 C-l-2 
job-7465,4,9,1,372633,372633,372738,0,105,372832,true,L-s-0 
job-7466,3,10,5,372681,372681,372753,0,72,373019,true,C-l-1 C-l-1 L-m-0 L-m-0 L-l-0 
job-7469,1,12,3,372834,372834,372867,0,33,373020,true,L-m-0 L-m-0 L-l-0 
job-7467,3,7,7,372732,372732,372947,0,215,373225,true,L-l-0 L-l-0 L-l-0 C-l-1 C-l-1 C-s-0 C-s-1 
job-7470,1,4,3,372884,372884,372957,0,73,372962,true,L-m-0 L-m-0 L-l-0 
job-7468,6,6,7,372784,372784,373076,0,292,373253,true,C-l-1 L-m-0 C-m-2 C-m-1 C-m-0 C-l-0 C-l-0 
job-7473,2,12,6,373026,373076,373143,50,67,373125,false,L-m-0 C-m-2 C-m-1 C-m-0 C-s-0 C-s-1 
job-7471,4,12,2,372916,372916,373207,0,291,373323,true,L-s-0 C-s-2 
job-7472,6,5,8,372975,373076,373218,101,142,373182,false,L-m-0 L-l-0 L-l-0 C-m-2 C-m-1 C-m-0 C-l-0 C-l-0 
job-7474,6,8,5,373056,373218,373255,162,37,373306,true,L-m-0 L-l-0 L-l-0 C-m-2 C-m-1 
job-7475,5,9,8,373104,373255,373269,151,14,373409,true,L-m-0 L-l-0 L-l-0 C-m-2 C-m-1 C-m-0 C-l-0 C-l-0 
job-7478,5,5,8,373269,373269,373288,0,19,373569,true,L-m-0 L-l-0 L-l-0 C-m-2 C-m-1 C-m-0 C-l-0 C-l-0 
job-7479,2,12,7,373313,373313,373353,0,40,373355,true,L-m-0 L-l-0 L-l-0 C-m-2 C-m-1 C-m-0 C-l-0 
job-7477,3,12,2,373211,373255,373360,44,105,373572,true,L-s-0 C-s-2 
job-7476,1,12,8,373151,373255,373392,104,137,373571,true,L-m-0 L-l-0 L-l-0 C-m-2 C-m-1 C-m-0 C-l-0 C-l-0 
job-7482,6,9,8,373459,373459,373480,0,21,373735,true,C-m-2 C-m-1 C-m-0 C-l-0 C-l-0 C-l-1 C-l-1 C-l-2 
job-7481,4,8,5,373417,373417,373485,0,68,373746,true,L-l-0 L-s-0 C-s-2 C-s-0 C-s-1 
job-7480,6,7,2,373369,373369,373541,0,172,373640,true,L-m-0 L-l-0 
job-7483,1,10,2,373523,373523,373588,0,65,373722,true,L-m-0 L-m-0 
job-7484,1,11,1,373576,373576,373628,0,52,373706,true,L-m-0 
job-7485,2,4,7,373635,373635,373658,0,23,373943,true,L-s-0 L-s-0 L-m-0 L-m-0 L-m-0 L-m-0 L-l-0 
job-7486,3,7,2,373683,373683,373697,0,14,373898,true,L-s-0 L-m-0 
job-7488,4,6,1,373786,373786,373853,0,67,373895,true,L-l-0 
job-7490,5,10,6,373880,373880,373928,0,48,373967,true,L-l-0 C-m-2 C-m-1 C-m-0 C-l-0 C-l-0 
job-7489,4,8,1,373835,373835,373947,0,112,374130,true,L-l-0 
job-7487,3,4,3,373732,373732,373998,0,266,374189,true,L-s-0 L-m-0 L-m-0 
job-7493,6,6,3,374033,374033,374107,0,74,374251,true,L-m-0 C-m-0 C-l-0 
job-7495,6,11,3,374139,374139,374149,0,10,374315,true,L-m-0 C-m-0 C-l-0 
job-7492,5,8,4,373983,373983,374150,0,167,374181,true,L-l-0 L-l-0 C-m-2 C-m-1 
job-7494,3,6,2,374084,374084,374227,0,143,374321,true,C-m-2 C-m-1 
job-7491,5,10,4,373922,373922,374251,0,329,374433,true,C-l-1 C-l-1 C-l-2 C-l-2 
job-7497,6,8,2,374252,374252,374273,0,21,374497,true,L-l-0 L-l-0 
job-7498,6,5,8,374300,374300,374369,0,69,374630,true,L-l-0 L-l-0 C-m-2 C-m-1 C-m-0 C-l-1 C-l-1 C-l-2 
job-7496,6,10,1,374199,374199,374434,0,235,374577,true,L-m-0 
job-7499,2,6,5,374350,374350,374459,0,109,374481,true,L-m-0 C-m-2 C-m-1 C-m-0 C-l-2 
job-7502,4,7,6,374491,374491,374511,0,20,374810,true,C-l-2 C-l-0 L-s-0 C-s-2 C-s-0 C-s-1 
job-7503,1,8,5,374533,374533,374545,0,12,374565,true,L-m-0 L-m-0 C-m-2 C-m-2 C-m-1 
job-7501,6,11,4,374439,374439,374573,0,134,374750,true,L-m-0 C-l-1 C-l-1 C-l-0 
job-7504,6,6,5,374578,374578,374670,0,92,374683,true,C-l-2 L-m-0 C-l-1 C-l-1 C-l-0 
job-7505,3,12,3,374624,374624,374689,0,65,374887,true,C-l-0 C-l-0 L-s-0 
job-7500,6,11,6,374403,374403,374777,0,374,374829,true,C-m-2 C-m-1 C-m-0 C-l-2 L-l-0 L-l-0 
job-7506,5,10,8,374682,374777,374857,95,80,374820,false,L-m-0 L-l-0 L-l-0 C-m-2 C-m-1 C-m-0 C-l-2 C-l-2 
job-7507,5,4,3,374721,374777,374869,56,92,374837,false,C-l-0 C-l-0 C-l-1 
job-7510,4,10,3,374859,374859,374907,0,48,374991,true,L-l-0 L-l-0 C-s-2 
job-7508,6,4,2,374769,374857,374936,88,79,374965,true,C-l-1 L-m-0 
job-7509,1,6,8,374810,374857,374965,47,108,374978,true,L-m-0 L-m-0 C-l-1 C-l-0 C-l-0 L-s-0 L-s-0 L-l-0 
job-7511,5,6,8,374913,374913,375071,0,158,375309,true,L-l-0 L-l-0 C-l-1 C-l-0 C-l-0 C-m-2 C-m-1 C-m-0 
job-7514,6,9,3,375065,375065,375075,0,10,375300,true,C-l-1 C-l-2 C-l-2 
job-7512,3,8,2,374960,374960,375095,0,135,375320,true,L-m-0 L-m-0 
job-7513,1,6,8,375017,375017,375125,0,108,375300,true,L-m-0 L-m-0 L-l-0 L-l-0 C-m-2 C-m-2 C-m-2 C-m-1 
job-7515,2,4,8,375119,375119,375148,0,29,375250,true,L-m-0 L-m-0 L-m-0 L-l-0 L-l-0 L-l-0 L-l-0 L-l-0 
job-7516,5,7,2,375170,375170,375299,0,129,375559,true,L-m-0 L-l-0 
job-7520,2,10,3,375362,375362,375374,0,12,375528,true,L-s-0 C-s-2 C-s-0 
job-7517,2,10,1,375214,375214,375400,0,186,375421,true,L-m-0 
job-7519,5,7,3,375321,375321,375419,0,98,375429,true,L-m-0 L-l-0 L-l-0 
job-7521,5,7,8,375414,375414,375471,0,57,375515,true,C-m-2 C-m-1 C-m-0 C-l-0 C-l-0 C-l-1 C-l-1 C-l-2 
job-7522,3,11,4,375471,375471,375481,0,10,375663,true,L-m-0 L-m-0 L-l-0 L-l-0 
job-7518,1,7,2,375266,375266,375494,0,228,375684,true,L-m-0 L-l-0 
job-7524,1,5,1,375571,375571,375616,0,45,375804,true,L-m-0 
job-7525,2,4,3,375631,375631,375646,0,15,375853,true,L-m-0 L-m-0 L-l-0 
job-7523,1,5,7,375521,375521,375680,0,159,375865,true,L-s-0 L-s-0 L-s-0 L-m-0 L-m-0 L-m-0 L-m-0 
job-7526,2,11,7,375672,375672,375697,0,25,375741,true,L-m-0 L-l-0 L-l-0 L-l-0 L-l-0 C-s-2 C-s-0 
job-7527,3,9,8,375728,375728,375795,0,67,376048,true,L-s-0 L-m-0 L-m-0 L-l-0 L-l-0 L-l-0 L-l-0 C-s-2 
job-7529,5,10,5,375836,375836,375891,0,55,376096,true,C-m-1 L-m-0 L-l-0 L-l-0 C-m-0 
job-7530,5,9,4,375880,375880,375950,0,70,376156,true,C-l-0 C-l-0 C-l-1 C-l-1 
job-7528,3,7,5,375789,375789,375970,0,181,376118,true,C-s-0 C-s-1 C-m-2 C-m-2 C-m-1 
job-7532,5,6,4,375967,375967,376005,0,38,376043,true,C-m-0 C-l-0 C-l-0 C-l-1 
job-7535,1,9,5,376121,376121,376153,0,32,376196,true,C-m-2 C-m-2 C-s-0 C-s-1 C-s-2 
job-7531,3,10,8,375928,375928,376161,0,233,376294,true,C-m-1 L-s-0 L-m-0 L-m-0 L-l-0 L-l-0 L-l-0 L-l-0 
job-7534,1,6,2,376066,376066,376168,0,102,376327,true,L-s-0 L-m-0 
job-7533,5,9,2,376022,376022,376202,0,180,376422,true,C-m-1 C-m-2 
job-7536,4,4,8,376165,376165,376225,0,60,376405,true,L-m-0 L-l-0 L-l-0 L-l-0 C-s-0 C-s-1 C-s-2 C-m-0 
job-7538,3,6,6,376253,376253,376279,0,26,376292,true,L-m-0 C-m-0 C-m-1 L-l-0 L-l-0 L-l-0 
job-7540,2,6,8,376343,376343,376361,0,18,376545,true,L-m-0 L-m-0 L-l-0 C-m-2 C-m-0 C-m-0 C-m-1 C-m-1 
job-7539,5,12,4,376301,376301,376474,0,173,376732,true,L-l-0 L-l-0 C-m-2 C-l-0 
job-7541,3,8,6,376392,376392,376509,0,117,376703,true,L-m-0 C-m-2 C-m-0 C-m-1 C-l-0 C-l-0 
job-7543,4,10,4,376513,376513,376541,0,28,376809,true,L-m-0 C-m-0 C-m-1 L-l-0 
job-7537,4,6,4,376217,376217,376553,0,336,376675,true,L-m-0 C-m-0 L-s-0 C-m-1 
job-7542,3,8,6,376451,376451,376586,0,135,376712,true,C-s-0 C-s-1 C-s-2 C-l-1 C-l-1 C-l-1 
job-7544,4,5,8,376552,376552,376717,0,165,376878,true,L-m-0 C-m-0 C-m-1 L-l-0 L-l-0 L-l-0 C-m-2 C-m-2 
job-7547,4,4,2,376704,376704,376761,0,57,376953,true,C-l-0 C-l-0 
job-7546,3,9,7,376656,376656,376761,0,105,376982,true,C-s-1 C-s-2 C-l-1 C-l-1 C-l-1 C-l-1 C-l-0 
job-7545,1,11,8,376602,376602,376766,0,164,377037,true,L-m-0 L-m-0 C-m-0 C-m-0 C-m-1 C-m-1 L-s-0 C-s-0 
job-7549,4,5,4,376789,376789,376868,0,79,377118,true,L-m-0 C-m-0 C-m-1 L-s-0 
job-7551,5,12,3,376879,376879,376912,0,33,377092,true,C-l-1 C-l-0 C-l-0 
job-7548,4,8,8,376741,376741,376914,0,173,377052,true,L-m-0 C-m-0 C-m-1 L-l-0 L-l-0 L-l-0 C-m-2 C-m-2 
job-7550,3,10,4,376838,376838,377044,0,206,377257,true,C-s-1 C-s-2 C-s-0 C-l-1 
job-7552,5,12,6,376938,376938,377076,0,138,377196,true,C-l-1 L-m-0 L-l-0 L-l-0 C-m-2 C-m-0 
job-7555,4,10,7,377071,377076,377201,5,125,377207,true,L-m-0 L-l-0 L-l-0 C-m-2 C-m-0 C-l-1 C-l-1 
job-7557,5,4,4,377170,377201,377220,31,19,377469,true,C-m-2 C-m-0 C-l-1 C-l-2 
job-7554,2,10,8,377031,377031,377232,0,201,377236,true,L-s-0 C-m-1 C-m-1 C-m-1 C-l-0 C-l-0 C-l-0 C-l-0 
job-7553,2,8,6,376985,376985,377264,0,279,377435,true,L-m-0 L-l-0 C-m-2 C-m-0 C-l-1 C-l-1 
job-7558,5,5,6,377222,377232,377391,10,159,377598,true,C-m-2 C-m-0 C-l-1 C-m-1 C-l-0 C-l-0 
job-7556,5,5,3,377123,377201,377401,78,200,377594,true,L-m-0 L-l-0 L-l-0 
job-7560,3,7,1,377318,377318,377410,0,92,377522,true,C-m-2 
job-7559,2,4,1,377267,377267,377423,0,156,377502,true,L-m-0 
job-7561,2,6,3,377379,377379,377456,0,77,377572,true,L-l-0 C-m-0 C-m-1 
job-7563,1,11,7,377492,377492,377522,0,30,377725,true,L-m-0 L-l-0 L-l-0 L-l-0 C-m-0 C-m-1 C-m-2 
job-7562,6,11,8,377428,377428,377575,0,147,377837,true,L-l-0 C-m-0 C-m-1 L-m-0 C-m-2 C-l-0 C-l-0 C-l-1 
job-7564,6,9,6,377540,377575,377607,35,32,377779,true,L-m-0 L-l-0 L-l-0 C-m-0 C-m-1 C-m-2 
job-7566,3,5,3,377640,377640,377692,0,52,377885,true,L-m-0 L-m-0 C-m-0 
job-7568,5,12,6,377744,377744,377763,0,19,377769,true,C-m-1 C-m-2 L-l-0 L-l-0 C-l-0 C-l-0 
job-7565,1,8,8,377590,377590,377785,0,195,377957,true,L-m-0 L-m-0 C-m-0 C-m-0 C-m-1 C-m-1 C-m-2 C-m-2 
job-7569,1,9,1,377794,377794,377807,0,13,378012,true,L-m-0 
job-7567,2,11,2,377693,377693,377888,0,195,377929,true,L-m-0 C-m-0 
job-7571,6,8,2,377892,377892,377975,0,83,378070,true,L-m-0 L-l-0 
job-7570,1,8,2,377844,377844,377986,0,142,377992,true,L-m-0 L-m-0 
job-7573,3,8,6,377984,377984,378059,0,75,378069,true,L-m-0 L-m-0 L-l-0 L-l-0 C-m-0 C-m-1 
job-7572,5,5,4,377943,377943,378110,0,167,378241,true,L-l-0 C-m-0 C-m-1 C-m-2 
job-7575,6,10,4,378073,378110,378123,37,13,378219,true,L-l-0 C-m-0 C-m-1 C-m-2 
job-7574,5,9,8,378037,378059,378208,22,149,378392,true,L-l-0 L-m-0 C-l-0 C-l-0 C-l-1 C-l-1 C-l-2 C-l-2 
job-7577,5,5,2,378180,378208,378230,28,22,378215,false,C-m-2 C-l-0 
job-7576,6,10,5,378131,378208,378299,77,91,378330,true,L-m-0 L-l-0 L-l-0 C-m-0 C-m-1 
job-7580,4,9,4,378353,378353,378365,0,12,378371,true,L-s-0 L-m-0 L-m-0 L-l-0 
job-7578,6,9,4,378239,378239,378420,0,181,378624,true,C-m-2 C-l-0 C-l-0 C-l-1 
job-7579,6,8,1,378297,378297,378456,0,159,378685,true,C-l-1 
job-7582,6,9,2,378446,378446,378503,0,57,378566,true,L-l-0 C-l-1 
job-7581,5,5,2,378397,378397,378531,0,134,378589,true,L-m-0 L-l-0 
job-7583,4,5,4,378501,378501,378574,0,73,378695,true,C-l-1 L-s-0 C-s-1 C-s-2 
job-7585,3,12,8,378581,378581,378695,0,114,378948,true,C-l-1 L-s-0 C-s-1 C-s-2 C-m-2 C-m-2 C-m-0 C-m-0 
job-7584,4,7,8,378538,378538,378712,0,174,378765,true,C-l-1 C-l-1 L-m-0 L-m-0 L-l-0 L-l-0 L-l-0 C-s-0 
job-7586,1,7,8,378641,378641,378813,0,172,379086,true,C-m-2 C-m-0 C-l-1 C-m-1 C-m-1 C-m-1 C-m-1 C-l-0 
job-7588,4,8,1,378733,378733,378816,0,83,379040,true,C-m-2 
job-7587,2,5,6,378690,378690,378823,0,133,379102,true,C-l-0 C-l-0 C-l-0 C-l-0 C-l-0 C-l-2 
job-7589,1,10,7,378789,378789,378859,0,70,378939,true,C-m-2 C-m-0 C-m-0 C-l-0 C-l-2 C-l-2 C-l-2 
job-7590,5,10,7,378839,378839,378965,0,126,379213,true,C-m-0 C-m-2 C-l-2 C-l-0 C-l-0 L-m-0 L-l-0 
job-7592,5,10,2,378955,378955,378981,0,26,379223,true,C-m-1 C-l-1 
job-7593,4,4,2,379012,379012,379029,0,17,379123,true,L-l-0 L-l-0 
job-7591,4,6,5,378891,378891,379060,0,169,379103,true,L-l-0 C-l-2 L-s-0 C-s-1 C-s-2 
job-7594,3,9,1,379069,379069,379191,0,122,379443,true,L-s-0 
job-7595,4,4,5,379119,379119,379196,0,77,379431,true,L-m-0 L-m-0 L-l-0 L-l-0 L-l-0 
job-7597,5,8,5,379215,379215,379254,0,39,379486,true,L-m-0 L-l-0 L-l-0 C-m-0 C-m-2 
job-7599,5,12,1,379305,379305,379357,0,52,379417,true,C-m-0 
job-7598,4,8,7,379260,379260,379367,0,107,379429,true,L-s-0 L-m-0 L-m-0 L-l-0 L-l-0 L-l-0 C-s-0 
job-7596,4,4,2,379166,379166,379417,0,251,379623,true,C-s-1 C-s-2 
job-7600,4,5,2,379359,379359,379455,0,96,379736,true,C-m-0 C-m-0 
job-7602,6,12,7,379470,379470,379528,0,58,379698,true,L-m-0 L-l-0 L-l-0 C-m-0 C-m-2 C-m-1 C-l-2 
job-7601,3,5,1,379420,379420,379571,0,151,379681,true,L-s-0 
job-7603,6,8,1,379520,379520,379597,0,77,379772,true,C-l-2 
job-7604,5,9,8,379574,379574,379643,0,69,379766,true,C-l-2 L-m-0 L-l-0 L-l-0 C-m-0 C-m-2 C-m-1 C-l-0 
job-7606,3,8,7,379683,379683,379752,0,69,379997,true,L-m-0 C-m-0 L-s-0 L-l-0 L-l-0 L-l-0 L-l-0 
job-7607,4,12,3,379734,379734,379777,0,43,379842,true,C-s-0 C-s-1 C-s-2 
job-7605,3,8,2,379629,379629,379793,0,164,379843,true,L-m-0 C-m-0 
job-7609,4,9,4,379820,379820,379868,0,48,380154,true,L-m-0 L-l-0 L-l-0 C-m-0 
job-7608,4,6,4,379773,379773,379998,0,225,380132,true,L-m-0 C-m-0 L-s-0 L-l-0 
job-7611,1,10,2,379920,379920,380020,0,100,380168,true,L-m-0 L-m-0 
job-7612,2,6,1,379973,379973,380066,0,93,380106,true,L-m-0 
job-7610,4,12,6,379867,379867,380069,0,202,380099,true,C-s-0 C-s-1 C-s-2 C-m-2 C-m-2 C-m-1 
job-7613,3,4,5,380028,380028,380151,0,123,380360,true,L-m-0 L-m-0 C-m-1 L-s-0 L-l-0 
job-7615,3,5,5,380125,380125,380213,0,88,380401,true,L-l-0 L-l-0 L-l-0 C-m-1 C-s-0 
job-7614,1,8,1,380070,380070,380213,0,143,380476,true,L-s-0 
job-7617,3,11,5,380216,380216,380242,0,26,380300,true,L-s-0 L-l-0 L-l-0 L-l-0 L-l-0 
job-7616,6,6,1,380164,380164,380294,0,130,380318,true,L-m-0 
job-7618,6,7,8,380266,380266,380296,0,30,380348,true,L-l-0 L-l-0 C-m-1 C-m-2 C-m-0 C-l-2 C-l-2 C-l-0 
job-7619,4,9,1,380306,380306,380376,0,70,380474,true,L-s-0 
job-7620,3,6,8,380354,380354,380414,0,60,380542,true,L-m-0 L-m-0 L-l-0 L-l-0 L-l-0 L-l-0 C-s-0 C-s-1 
job-7621,6,7,4,380394,380394,380430,0,36,380609,true,C-m-1 C-m-2 C-m-0 C-l-2 
job-7623,1,7,3,380497,380497,380629,0,132,380767,true,L-m-0 L-m-0 C-m-1 
job-7622,6,8,8,380441,380441,380669,0,228,380755,true,L-m-0 L-l-0 L-l-0 C-m-1 C-m-2 C-m-0 C-l-2 C-l-2 
job-7625,5,6,6,380603,380669,380747,66,78,380843,true,L-m-0 L-l-0 L-l-0 C-m-1 C-m-2 C-m-0 
job-7624,3,6,4,380543,380543,380756,0,213,380787,true,L-s-0 C-s-0 C-s-1 C-s-2 
job-7629,2,8,3,380786,380786,380873,0,87,381107,true,L-m-0 L-m-0 L-l-0 
job-7630,4,5,6,380838,380838,380893,0,55,380943,true,L-l-0 L-l-0 C-m-1 C-m-2 C-m-0 L-s-0 
job-7627,1,11,6,380681,380681,380897,0,216,380994,true,L-l-0 L-l-0 C-m-1 C-m-1 C-m-2 C-m-2 
job-7628,2,8,6,380731,380731,380915,0,184,380939,true,C-m-0 C-l-2 C-l-2 C-l-2 C-l-2 C-l-2 
job-7626,3,12,1,380641,380669,380940,28,271,381197,true,L-m-0 
job-7632,6,8,3,380929,380929,380956,0,27,381220,true,C-l-1 L-l-0 L-l-0 
job-7631,6,10,3,380884,380884,381000,0,116,381199,true,C-l-0 C-l-0 C-l-1 
job-7633,3,5,6,380972,380972,381095,0,123,381244,true,C-l-1 C-l-1 L-s-0 L-m-0 L-m-0 L-l-0 
job-7635,4,12,6,381090,381090,381128,0,38,381301,true,L-l-0 C-l-1 C-s-0 C-s-1 C-s-2 C-m-1 
job-7637,4,9,4,381173,381173,381185,0,12,381412,true,L-l-0 L-l-0 C-s-0 C-s-1 
job-7636,1,7,1,381124,381124,381194,0,70,381428,true,L-m-0 
job-7634,1,10,6,381030,381030,381259,0,229,381519,true,L-s-0 L-m-0 L-m-0 L-l-0 L-l-0 L-l-0 
job-7638,1,4,1,381227,381227,381328,0,101,381382,true,L-s-0 
job-7639,4,7,5,381272,381272,381355,0,83,381646,true,L-m-0 L-m-0 L-l-0 L-l-0 L-l-0 
job-7641,6,9,1,381381,381381,381403,0,22,381548,true,L-m-0 
job-7640,3,4,8,381326,381326,381410,0,84,381524,true,L-s-0 C-s-0 C-s-1 C-s-2 C-m-1 C-m-1 C-m-2 C-m-2 
job-7642,6,8,6,381439,381439,381556,0,117,381678,true,L-m-0 L-l-0 L-l-0 C-m-1 C-m-2 C-m-0 
job-7644,2,7,2,381523,381523,381575,0,52,381852,true,L-m-0 C-m-1 
job-7643,4,7,6,381476,381476,381640,0,164,381938,true,L-s-0 C-s-0 C-s-1 C-s-2 C-l-1 C-l-1 
job-7646,5,6,4,381616,381616,381694,0,78,381696,true,L-m-0 L-l-0 L-l-0 C-m-1 
job-7648,2,5,1,381724,381724,381766,0,42,381943,true,L-m-0 
job-7647,3,7,5,381672,381672,381818,0,146,381951,true,C-m-1 L-s-0 C-s-0 C-s-1 C-s-2 
job-7650,1,10,7,381840,381840,381850,0,10,381964,true,L-m-0 C-m-1 C-m-1 C-m-2 C-m-2 L-s-0 C-s-0 
job-7645,1,10,1,381571,381571,381937,0,366,381967,true,L-m-0 
job-7651,2,10,6,381878,381878,381938,0,60,381950,true,L-m-0 C-m-1 C-m-1 C-m-2 C-m-2 L-s-0 
job-7653,3,6,2,381980,381980,382005,0,25,382260,true,L-m-0 C-m-1 
job-7652,4,10,6,381935,381935,382015,0,80,382090,true,C-s-0 C-s-1 C-s-2 C-m-0 C-m-0 C-l-1 
job-7654,4,11,8,382043,382043,382076,0,33,382271,true,L-m-0 C-m-1 C-m-2 L-s-0 C-s-0 C-s-1 C-s-2 C-m-0 
job-7656,5,5,5,382132,382132,382148,0,16,382378,true,C-m-0 C-l-1 C-l-1 C-l-0 C-l-0 
job-7649,4,6,6,381786,381786,382166,0,380,382407,true,L-m-0 C-m-1 L-l-0 L-l-0 L-l-0 C-m-2 
job-7655,1,7,1,382086,382086,382199,0,113,382394,true,L-m-0 
job-7658,4,5,4,382220,382220,382262,0,42,382434,true,L-l-0 L-s-0 C-s-0 C-s-1 
job-7657,5,4,2,382177,382177,382329,0,152,382417,true,L-m-0 L-l-0 
job-7659,6,8,7,382274,382274,382360,0,86,382626,true,L-l-0 C-m-1 C-m-2 C-m-0 C-l-1 C-l-1 C-l-0 
job-7660,1,9,7,382320,382320,382382,0,62,382454,true,L-m-0 L-m-0 L-m-0 L-l-0 C-m-1 C-m-1 C-m-2 
job-7663,6,10,1,382482,382482,382502,0,20,382738,true,L-m-0 
job-7662,2,6,5,382426,382426,382515,0,89,382803,true,L-l-0 C-m-1 C-m-1 L-s-0 L-s-0 
job-7661,3,6,4,382375,382375,382578,0,203,382688,true,L-l-0 L-l-0 L-l-0 C-m-1 
job-7664,4,6,7,382532,382532,382661,0,129,382806,true,C-m-1 L-s-0 L-m-0 L-m-0 C-s-0 C-s-1 C-s-2 
job-7665,2,8,7,382579,382579,382736,0,157,382884,true,C-m-1 C-m-1 L-l-0 L-l-0 L-l-0 L-l-0 L-l-0 
job-7667,3,7,4,382675,382675,382758,0,83,383008,true,C-m-1 L-s-0 L-m-0 L-m-0 
job-7669,1,9,3,382765,382765,382775,0,10,382870,true,L-m-0 L-m-0 L-s-0 
job-7668,1,12,7,382729,382729,382840,0,111,382896,true,L-m-0 C-m-2 C-m-2 C-m-0 C-m-0 C-s-0 C-s-1 
job-7666,6,8,6,382622,382622,382984,0,362,383117,true,C-m-2 C-m-0 C-l-1 C-l-1 C-l-0 C-l-0 
job-7672,3,8,4,382918,382984,383023,66,39,383038,true,C-m-0 C-m-1 C-l-1 C-l-1 
job-7671,2,11,3,382874,382984,383042,110,58,382951,false,L-m-0 L-l-0 C-m-2 
job-7670,5,6,7,382823,382984,383073,161,89,383013,false,L-m-0 L-l-0 L-l-0 C-m-2 C-m-0 C-m-1 C-l-1 
job-7674,3,6,6,383027,383027,383086,0,59,383234,true,C-m-0 C-m-1 C-l-0 C-l-0 C-l-1 C-l-1 
job-7675,4,6,3,383071,383071,383101,0,30,383131,true,C-l-2 C-l-2 C-l-2 
job-7676,5,12,6,383124,383124,383173,0,49,383349,true,C-l-0 L-m-0 L-l-0 L-l-0 C-m-0 C-m-1 
job-7673,4,12,5,382971,382984,383178,13,194,383272,true,L-s-0 C-s-0 C-s-1 C-s-2 C-l-0 
job-7677,1,12,7,383172,383172,383227,0,55,383289,true,L-m-0 L-l-0 L-l-0 C-m-0 C-m-1 C-l-0 C-l-0 
job-7678,1,9,5,383222,383222,383245,0,23,383384,true,L-m-0 L-m-0 L-l-0 L-l-0 C-m-0 
job-7679,5,6,7,383277,383277,383302,0,25,383596,true,L-m-0 L-l-0 L-l-0 C-m-0 C-m-1 C-m-2 C-l-0 
job-7681,3,7,5,383371,383371,383463,0,92,383685,true,L-l-0 L-l-0 L-l-0 L-l-0 C-s-0 
job-7683,5,4,3,383481,383481,383500,0,19,383544,true,L-l-0 L-l-0 C-m-0 
job-7684,6,7,3,383537,383537,383557,0,20,383693,true,L-l-0 L-l-0 C-m-0 
job-7682,1,9,1,383429,383429,383571,0,142,383581,true,C-s-0 
job-7680,2,5,6,383323,383323,383651,0,328,383813,true,L-s-0 L-s-0 L-m-0 L-m-0 L-m-0 L-m-0 
job-7686,6,5,3,383643,383643,383670,0,27,383716,true,L-l-0 C-m-0 C-m-1 
job-7685,1,10,1,383598,383598,383760,0,162,383995,true,L-l-0 
job-7689,1,7,5,383802,383802,383817,0,15,383894,true,L-l-0 L-l-0 C-m-0 C-m-0 C-m-0 
job-7688,4,8,8,383760,383760,383881,0,121,383949,true,L-l-0 L-s-0 L-m-0 L-m-0 C-s-0 C-s-1 C-s-2 C-m-0 
job-7690,3,12,8,383852,383852,383909,0,57,384207,true,C-m-0 C-m-1 C-m-1 C-m-2 C-m-2 C-l-0 C-l-0 C-l-0 
job-7687,1,4,6,383713,383713,383976,0,263,384059,true,L-l-0 L-l-0 L-l-0 L-l-0 L-l-0 L-l-0 
job-7692,2,9,7,383962,383962,384033,0,71,384171,true,L-s-0 L-m-0 L-m-0 L-m-0 C-s-0 C-s-1 C-s-2 
job-7691,6,9,1,383898,383898,384062,0,164,384284,true,L-l-0 
job-7695,5,9,3,384111,384111,384220,0,109,384507,true,L-m-0 L-l-0 C-m-0 
job-7693,3,6,5,383998,383998,384231,0,233,384356,true,L-l-0 L-l-0 C-m-1 C-m-1 C-m-2 
job-7698,4,12,5,384263,384263,384308,0,45,384464,true,L-m-0 C-m-2 C-m-0 C-m-1 L-l-0 
job-7697,5,11,2,384219,384219,384365,0,146,384433,true,C-l-0 C-l-0 
job-7696,3,10,1,384169,384169,384384,0,215,384660,true,C-m-0 
job-7699,2,12,3,384310,384310,384387,0,77,384576,true,L-m-0 L-m-0 C-m-2 
job-7694,2,4,6,384052,384052,384387,0,335,384551,true,C-m-1 C-m-2 C-m-2 L-s-0 L-s-0 L-m-0 
job-7701,5,7,3,384414,384414,384467,0,53,384485,true,L-m-0 L-l-0 L-l-0 
job-7702,6,7,4,384474,384474,384499,0,25,384542,true,L-m-0 L-l-0 L-l-0 C-m-2 
job-7700,5,10,1,384357,384357,384505,0,148,384777,true,C-m-0 
job-7703,3,12,5,384533,384533,384585,0,52,384683,true,L-s-0 L-m-0 L-m-0 L-l-0 L-l-0 
job-7704,5,4,7,384582,384582,384620,0,38,384730,true,L-l-0 C-m-0 C-m-2 C-m-1 C-l-0 C-l-0 C-l-1 
job-7706,6,4,1,384672,384672,384692,0,20,384921,true,L-m-0 
job-7705,2,12,1,384628,384628,384767,0,139,384866,true,L-s-0 
job-7709,6,6,8,384825,384825,384839,0,14,385095,true,C-m-0 C-m-2 C-m-1 C-l-0 C-l-0 C-l-1 C-l-1 C-l-2 
job-7707,2,4,3,384730,384730,384875,0,145,385028,true,L-s-0 L-m-0 L-m-0 
job-7708,1,12,7,384777,384777,384891,0,114,385085,true,L-s-0 L-m-0 L-m-0 L-l-0 L-l-0 L-l-0 L-l-0 
job-7711,2,12,3,384937,384937,384977,0,40,385117,true,L-s-0 L-m-0 L-m-0 
job-7710,2,12,7,384882,384882,385007,0,125,385246,true,C-s-0 C-s-1 C-s-2 C-m-0 C-m-0 C-m-2 C-m-2 
job-7712,5,7,4,384998,384998,385101,0,103,385137,true,L-m-0 L-l-0 L-l-0 C-m-1 
job-7713,6,6,7,385054,385054,385176,0,122,385474,true,C-m-0 C-m-2 C-l-0 C-l-0 C-l-1 C-l-1 C-l-2 
job-7718,6,6,6,385290,385290,385330,0,40,385349,true,C-l-0 C-l-0 C-l-1 C-l-1 C-l-2 C-l-2 
job-7716,5,6,4,385186,385186,385335,0,149,385522,true,L-l-0 C-m-0 C-m-2 C-m-1 
job-7717,1,11,2,385242,385242,385340,0,98,385480,true,L-l-0 C-m-0 
job-7715,4,4,2,385140,385140,385357,0,217,385447,true,L-m-0 L-l-0 
job-7714,1,8,6,385100,385100,385373,0,273,385421,true,L-m-0 L-m-0 L-m-0 L-l-0 L-l-0 C-m-0 
job-7720,4,10,5,385388,385388,385453,0,65,385473,true,L-m-0 C-m-0 C-m-2 L-s-0 L-l-0 
job-7721,4,8,1,385446,385446,385529,0,83,385594,true,L-l-0 
job-7722,6,4,1,385501,385501,385573,0,72,385763,true,L-m-0 
job-7723,3,8,1,385557,385557,385624,0,67,385664,true,C-m-0 
job-7725,3,6,7,385651,385651,385683,0,32,385958,true,C-m-0 C-m-0 L-s-0 C-s-0 C-s-1 C-s-2 C-m-1 
job-7724,6,4,4,385608,385608,385721,0,113,385896,true,L-m-0 C-m-2 L-l-0 L-l-0 
job-7719,1,4,3,385331,385331,385770,0,439,385971,true,L-m-0 C-m-0 C-m-2 
job-7727,4,5,2,385752,385752,385821,0,69,385870,true,L-m-0 C-m-2 
job-7728,4,7,7,385807,385807,385859,0,52,386097,true,L-m-0 C-m-2 C-l-2 L-s-0 L-l-0 L-l-0 L-l-0 
job-7726,5,11,7,385701,385701,385909,0,208,386064,true,C-m-0 C-m-1 C-l-0 C-l-0 C-l-1 C-l-1 C-l-2 
job-7729,5,4,5,385857,385859,385951,2,92,386173,true,C-l-2 L-m-0 L-l-0 L-l-0 C-m-2 
job-7731,3,8,6,385954,385954,385979,0,25,386278,true,L-m-0 L-l-0 L-l-0 L-l-0 C-m-2 C-m-2 
job-7730,1,5,6,385909,385909,385985,0,76,386027,true,L-m-0 L-m-0 L-m-0 L-l-0 L-l-0 C-m-2 
job-7732,2,12,5,386002,386002,386065,0,63,386344,true,L-s-0 L-m-0 L-m-0 L-l-0 L-l-0 
job-7733,6,12,2,386057,386057,386135,0,78,386366,true,L-l-0 C-m-2 
job-7734,2,4,5,386105,386105,386148,0,43,386432,true,L-l-0 L-l-0 L-l-0 C-m-2 L-s-0 
job-7736,1,12,5,386210,386210,386241,0,31,386478,true,L-m-0 L-l-0 L-l-0 L-s-0 C-s-0 
job-7737,5,7,4,386251,386251,386285,0,34,386387,true,C-m-2 C-m-0 C-m-1 C-l-2 
job-7738,6,7,6,386285,386285,386317,0,32,386385,true,C-m-2 C-m-0 C-m-1 C-l-2 C-l-2 C-l-0 
job-7735,5,10,3,386159,386159,386370,0,211,386374,true,L-m-0 L-l-0 L-l-0 
job-7739,6,8,8,386342,386342,386404,0,62,386414,true,C-m-2 C-m-0 C-m-1 C-l-2 C-l-2 C-l-0 C-l-0 C-l-1 
job-7741,6,8,4,386440,386440,386472,0,32,386737,true,C-l-1 L-l-0 L-l-0 C-m-2 
job-7740,3,11,4,386396,386396,386529,0,133,386583,true,C-l-1 C-l-1 L-s-0 L-m-0 
job-7742,1,6,4,386482,386482,386539,0,57,386824,true,L-m-0 L-m-0 L-m-0 C-l-1 
job-7743,1,11,8,386545,386545,386784,0,239,387049,true,L-s-0 L-m-0 L-m-0 L-l-0 L-l-0 L-l-0 L-l-0 C-s-0 
job-7747,4,6,1,386752,386752,386826,0,74,386993,true,C-s-1 
job-7748,2,5,8,386797,386797,386828,0,31,386901,true,L-s-0 L-m-0 C-m-2 C-m-0 L-l-0 L-l-0 L-l-0 L-l-0 
job-7744,5,7,1,386598,386598,386869,0,271,387122,true,L-m-0 
job-7745,2,4,1,386652,386652,386884,0,232,387117,true,L-s-0 
job-7750,4,5,6,386896,386896,386936,0,40,387171,true,L-m-0 L-l-0 L-l-0 L-l-0 C-s-1 C-s-0 
job-7746,6,6,2,386699,386699,386951,0,252,387156,true,C-m-2 C-m-0 
job-7749,1,8,7,386851,386851,386962,0,111,387243,true,L-s-0 L-m-0 L-m-0 L-m-0 C-m-2 C-m-2 C-m-0 
job-7751,1,7,2,386930,386930,387002,0,72,387220,true,L-s-0 C-m-0 
job-7752,5,5,5,386987,386987,387036,0,49,387067,true,C-m-0 L-m-0 L-l-0 L-l-0 C-m-2 
job-7754,2,12,2,387099,387099,387164,0,65,387309,true,C-s-0 C-s-2 
job-7755,6,9,8,387144,387144,387299,0,155,387391,true,C-m-0 C-m-2 C-m-1 C-l-1 C-l-1 C-l-2 C-l-2 C-l-0 
job-7756,2,7,1,387214,387214,387338,0,124,387449,true,L-m-0 
job-7758,3,6,7,387322,387322,387342,0,20,387439,true,C-l-2 C-l-2 C-s-0 C-s-2 C-l-0 C-l-0 C-l-0 
job-7753,1,12,8,387041,387041,387351,0,310,387566,true,L-s-0 L-m-0 L-m-0 L-l-0 L-l-0 L-l-0 L-l-0 C-s-1 
job-7759,5,11,5,387379,387379,387409,0,30,387498,true,C-l-2 L-m-0 L-l-0 L-l-0 C-l-0 
job-7757,6,10,6,387267,387299,387419,32,120,387518,true,C-m-0 C-m-2 C-m-1 C-l-1 C-l-1 C-l-2 
job-7760,4,6,2,387435,387435,387451,0,16,387705,true,L-s-0 L-m-0 
job-7762,2,4,7,387544,387544,387580,0,36,387582,true,L-m-0 L-m-0 L-l-0 L-l-0 L-l-0 L-l-0 L-l-0 
job-7761,3,9,2,387487,387487,387605,0,118,387666,true,L-s-0 L-m-0 
job-7763,5,6,7,387593,387593,387623,0,30,387678,true,L-m-0 L-l-0 L-l-0 C-m-0 C-m-2 C-m-1 C-l-1 
job-7765,6,7,8,387692,387692,387727,0,35,387813,true,L-m-0 C-m-0 C-m-2 C-m-1 C-l-1 C-l-1 C-l-2 C-l-2 
job-7764,1,11,7,387638,387638,387768,0,130,387772,true,L-s-0 L-m-0 L-m-0 L-l-0 L-l-0 L-l-0 L-l-0 
job-7767,4,5,8,387812,387812,387834,0,22,388062,true,L-s-0 L-l-0 L-l-0 L-l-0 C-s-1 C-s-0 C-s-2 C-l-1 
job-7768,6,12,2,387850,387850,387864,0,14,388083,true,L-l-0 L-l-0 
job-7770,4,6,4,387966,387966,387985,0,19,388003,true,L-l-0 L-s-0 C-s-1 C-s-0 
job-7769,6,4,1,387911,387911,388007,0,96,388155,true,L-l-0 
job-7771,6,7,4,388023,388023,388065,0,42,388363,true,L-l-0 L-l-0 C-l-1 C-l-1 
job-7766,5,8,4,387756,387756,388122,0,366,388225,true,L-m-0 C-m-0 C-m-2 C-m-1 
job-7774,5,9,1,388178,388178,388191,0,13,388241,true,C-l-1 
job-7772,1,9,3,388070,388070,388259,0,189,388476,true,L-m-0 L-m-0 C-m-0 
job-7773,6,6,7,388123,388123,388281,0,158,388569,true,L-m-0 C-m-0 L-l-0 L-l-0 C-m-2 C-m-1 C-l-1 
job-7775,5,5,6,388219,388281,388305,62,24,388328,true,L-m-0 L-l-0 L-l-0 C-m-0 C-m-2 C-m-1 
job-7780,6,6,7,388454,388454,388468,0,14,388653,true,L-l-0 C-l-1 C-l-1 C-l-2 C-l-2 C-l-0 C-l-0 
job-7777,3,9,1,388317,388317,388479,0,162,388573,true,L-m-0 
job-7776,3,6,4,388268,388281,388513,13,232,388769,true,L-m-0 C-m-0 C-m-2 C-m-1 
job-7779,6,10,1,388415,388415,388520,0,105,388526,true,L-l-0 
job-7783,4,8,4,388607,388607,388644,0,37,388873,true,L-m-0 C-s-1 C-s-0 C-s-2 
job-7781,1,8,8,388507,388507,388648,0,141,388904,true,L-m-0 L-m-0 L-m-0 L-l-0 L-l-0 L-l-0 L-l-0 C-m-2 
job-7782,3,9,5,388555,388555,388740,0,185,389013,true,L-l-0 C-m-0 C-m-2 C-m-2 L-s-0 
job-7784,4,11,4,388655,388655,388744,0,89,388929,true,L-l-0 L-l-0 L-m-0 L-m-0 
job-7785,1,9,7,388711,388711,388827,0,116,388887,true,L-l-0 C-m-2 C-s-1 C-s-0 C-s-2 C-m-1 C-m-1 
job-7778,5,7,1,388364,388364,388858,0,494,389107,true,C-m-0 
job-7787,1,12,6,388817,388817,388878,0,61,389117,true,L-l-0 L-l-0 C-m-0 C-m-0 C-m-1 C-m-2 
job-7788,5,10,5,388875,388875,388888,0,13,389057,true,L-l-0 C-m-1 C-m-2 L-m-0 C-l-1 
job-7789,5,10,3,388924,388924,389038,0,114,389327,true,L-l-0 L-m-0 C-m-0 
job-7790,3,4,3,388984,388984,389065,0,81,389354,true,L-m-0 L-l-0 C-m-0 
job-7791,2,12,3,389034,389034,389115,0,81,389163,true,L-s-0 C-s-1 C-s-0 
job-7792,6,8,3,389084,389084,389124,0,40,389397,true,L-l-0 L-m-0 C-m-0 
job-7786,3,8,1,388759,388759,389212,0,453,389350,true,L-l-0 
job-7794,6,8,8,389191,389191,389219,0,28,389296,true,L-m-0 C-m-0 C-m-1 C-m-2 C-l-1 C-l-1 C-l-2 C-l-2 
job-7796,1,10,3,389273,389273,389302,0,29,389478,true,L-s-0 L-m-0 L-m-0 
job-7793,2,12,3,389136,389136,389433,0,297,389595,true,L-l-0 L-l-0 L-l-0 
job-7797,4,11,3,389327,389327,389461,0,134,389497,true,L-s-0 L-m-0 L-m-0 
job-7795,2,4,1,389228,389228,389494,0,266,389787,true,L-l-0 
job-7798,4,11,2,389386,389386,389528,0,142,389697,true,C-s-1 C-s-0 
job-7801,6,4,4,389517,389517,389544,0,27,389604,true,L-l-0 L-m-0 C-l-0 C-l-0 
job-7802,2,9,2,389571,389571,389582,0,11,389833,true,L-l-0 L-l-0 
job-7799,5,4,6,389431,389431,389650,0,219,389788,true,C-m-0 C-m-1 C-m-2 C-l-1 C-l-1 C-l-2 
job-7804,6,12,6,389676,389676,389762,0,86,389861,true,C-l-2 L-m-0 C-m-0 C-m-1 C-m-2 C-l-1 
job-7803,5,8,1,389629,389629,389815,0,186,389907,true,L-l-0 
job-7805,6,5,4,389721,389762,389945,41,183,390130,true,C-l-2 L-m-0 C-m-0 C-m-1 
job-7808,1,4,2,389877,389877,389965,0,88,390236,true,L-s-0 L-m-0 
job-7809,4,10,5,389935,389945,389973,10,28,390124,true,L-m-0 C-l-2 C-s-0 C-s-2 C-m-0 
job-7800,6,4,2,389471,389471,389987,0,516,390255,true,L-l-0 C-l-2 
job-7807,3,8,3,389829,389829,389996,0,167,390235,true,C-m-2 L-s-0 C-s-1 
job-7810,1,11,5,390000,390000,390037,0,37,390200,true,L-l-0 L-l-0 L-l-0 L-l-0 C-m-2 
job-7806,5,4,6,389786,389815,390108,29,293,390092,false,L-l-0 C-m-2 C-l-1 C-l-1 C-l-0 C-l-0 
job-7811,5,5,4,390056,390056,390195,0,139,390399,true,L-l-0 L-m-0 C-m-0 C-m-1 
job-7813,2,9,8,390168,390168,390217,0,49,390258,true,L-m-0 C-m-2 C-m-0 C-m-1 C-l-1 C-l-1 C-l-1 L-s-0 
job-7812,6,5,3,390117,390117,390301,0,184,390521,true,L-l-0 C-m-2 C-l-1 
job-7816,2,4,2,390311,390311,390346,0,35,390614,true,L-m-0 L-l-0 
job-7815,5,8,3,390272,390272,390383,0,111,390530,true,L-m-0 C-m-0 C-m-1 
job-7817,3,5,8,390365,390365,390393,0,28,390496,true,L-m-0 L-l-0 L-l-0 C-m-0 C-m-1 C-l-1 C-l-1 C-s-1 
job-7814,4,11,3,390224,390224,390408,0,184,390646,true,L-l-0 C-l-1 L-s-0 
job-7818,4,7,6,390418,390418,390445,0,27,390550,true,L-s-0 L-m-0 L-m-0 L-l-0 L-l-0 L-l-0 
job-7820,4,5,3,390508,390508,390520,0,12,390758,true,L-m-0 L-l-0 L-l-0 
job-7819,3,7,2,390466,390466,390576,0,110,390653,true,L-s-0 L-m-0 
job-7821,3,9,6,390556,390556,390625,0,69,390831,true,L-m-0 L-l-0 L-l-0 L-l-0 L-l-0 C-s-1 
job-7822,5,12,8,390607,390607,390640,0,33,390927,true,L-m-0 C-m-0 C-m-1 C-m-2 C-l-1 C-l-1 C-l-0 C-l-0 
job-7824,1,10,1,390714,390714,390757,0,43,390784,true,L-m-0 
job-7825,3,7,7,390790,390790,390800,0,10,390936,true,L-s-0 L-l-0 L-l-0 L-l-0 L-l-0 C-s-1 C-s-0 
job-7823,6,5,1,390664,390664,390802,0,138,391031,true,L-m-0 
job-7827,1,9,5,390896,390896,390970,0,74,391233,true,L-m-0 L-m-0 L-m-0 L-l-0 L-l-0 
job-7826,4,10,1,390842,390842,391082,0,240,391092,true,L-s-0 
job-7831,1,7,4,391110,391110,391197,0,87,391460,true,L-m-0 L-s-0 L-s-0 C-s-2 
job-7829,2,6,7,391002,391002,391226,0,224,391319,true,L-l-0 L-l-0 L-l-0 L-l-0 L-l-0 L-m-0 L-m-0 
job-7828,2,7,1,390940,390940,391227,0,287,391273,true,L-l-0 
job-7833,1,8,7,391232,391232,391367,0,135,391369,true,L-m-0 L-m-0 C-m-0 C-m-0 C-m-0 C-m-1 C-m-1 
job-7832,5,5,8,391175,391175,391390,0,215,391549,true,C-m-0 C-m-1 C-m-2 C-l-1 C-l-1 C-l-0 C-l-0 C-l-2 
job-7835,4,9,7,391344,391390,391431,46,41,391638,true,C-l-2 L-s-0 C-s-2 C-m-0 C-m-0 C-m-1 C-m-1 
job-7836,6,11,1,391392,391392,391438,0,46,391732,true,C-m-2 
job-7834,6,5,4,391281,391367,391440,86,73,391584,true,L-m-0 C-l-2 L-l-0 L-l-0 
job-7830,2,12,3,391064,391064,391444,0,380,391509,true,L-m-0 C-s-1 C-s-0 
job-7837,5,4,3,391439,391439,391480,0,41,391694,true,C-l-2 C-m-0 C-m-1 
job-7839,2,8,1,391524,391524,391603,0,79,391822,true,L-l-0 
job-7838,2,9,6,391483,391483,391650,0,167,391689,true,L-s-0 L-m-0 L-m-0 L-m-0 L-l-0 L-l-0 
job-7840,6,9,8,391579,391579,391689,0,110,391937,true,L-l-0 C-m-0 C-m-1 C-m-2 C-l-2 C-l-2 C-l-1 C-l-1 
job-7843,6,10,7,391732,391732,391805,0,73,391810,true,L-l-0 C-m-0 C-m-1 L-m-0 C-m-2 C-l-2 C-l-2 
job-7842,1,8,8,391682,391682,391838,0,156,391901,true,L-l-0 L-l-0 L-l-0 L-l-0 C-m-0 C-m-0 C-m-1 C-m-1 
job-7844,4,12,8,391775,391805,391840,30,35,392024,true,L-l-0 C-m-0 C-m-1 L-s-0 L-m-0 L-m-0 C-m-2 C-m-2 
job-7841,4,6,3,391626,391626,391870,0,244,391885,true,C-s-1 C-s-0 C-s-2 
job-7846,6,6,1,391879,391879,391951,0,72,392232,true,C-l-0 
job-7845,6,9,5,391822,391822,391967,0,145,392204,true,C-l-2 C-l-2 C-l-1 C-l-1 C-l-0 
job-7849,6,4,4,392019,392019,392102,0,83,392358,true,C-l-2 C-l-1 C-l-1 C-l-0 
job-7848,6,8,7,391980,391980,392157,0,177,392212,true,L-m-0 L-l-0 L-l-0 C-m-2 C-m-0 C-m-1 C-l-2 
job-7847,1,12,1,391930,391930,392238,0,308,392329,true,L-s-0 
job-7850,5,6,2,392062,392102,392243,40,141,392311,true,C-l-2 C-l-1 
job-7853,5,6,6,392230,392230,392275,0,45,392532,true,C-l-0 L-m-0 L-l-0 L-l-0 C-m-2 C-m-0 
job-7852,4,5,1,392168,392168,392337,0,169,392486,true,C-l-2 
job-7851,5,6,2,392115,392115,392345,0,230,392522,true,C-l-1 C-l-0 
job-7854,6,6,7,392285,392285,392436,0,151,392692,true,C-l-1 C-l-0 C-l-2 L-m-0 L-l-0 L-l-0 C-m-2 
job-7855,5,5,2,392348,392348,392508,0,160,392805,true,C-l-1 C-l-0 
job-7857,5,4,7,392466,392466,392512,0,46,392630,true,C-l-1 C-l-0 C-l-2 L-m-0 L-l-0 L-l-0 C-m-2 
job-7858,2,8,6,392519,392519,392542,0,23,392700,true,C-l-2 C-l-2 C-l-2 C-l-2 L-s-0 L-s-0 
job-7859,3,12,3,392568,392568,392578,0,10,392588,true,C-l-2 C-l-2 C-l-2 
job-7856,3,11,1,392403,392403,392621,0,218,392728,true,C-l-2 
job-7860,4,5,8,392613,392613,392695,0,82,392702,true,C-l-2 C-l-2 L-s-0 L-m-0 L-m-0 L-l-0 L-l-0 L-l-0 
job-7862,4,4,2,392698,392698,392732,0,34,392988,true,L-s-0 L-m-0 
job-7861,6,4,2,392656,392656,392740,0,84,392752,true,C-m-2 C-m-0 
job-7863,1,7,6,392739,392739,392838,0,99,393028,true,C-m-2 C-m-2 C-m-0 C-m-0 L-s-0 L-s-0 
job-7864,6,10,1,392795,392795,392899,0,104,392959,true,C-m-2 
job-7865,6,9,8,392846,392846,392925,0,79,393104,true,L-m-0 L-l-0 L-l-0 C-m-0 C-m-1 C-l-2 C-l-2 C-l-1 
job-7867,4,9,6,392950,392950,392981,0,31,393249,true,L-s-0 C-s-1 C-s-0 C-s-2 C-l-1 C-l-1 
job-7868,2,11,6,392999,392999,393067,0,68,393216,true,L-m-0 L-l-0 C-m-0 C-m-1 C-m-2 C-l-2 
job-7866,5,4,8,392894,392925,393072,31,147,393220,true,L-m-0 L-l-0 L-l-0 C-m-0 C-m-1 C-m-2 C-l-2 C-l-2 
job-7869,1,11,2,393048,393048,393249,0,201,393469,true,L-m-0 C-m-0 
job-7872,4,4,7,393191,393191,393260,0,69,393411,true,L-l-0 C-m-1 C-m-2 C-m-2 C-l-2 C-l-2 C-l-2 
job-7870,1,10,8,393096,393096,393284,0,188,393527,true,L-m-0 L-m-0 C-m-0 C-m-0 L-s-0 L-l-0 L-l-0 L-l-0 
job-7873,6,4,6,393241,393249,393316,8,67,393436,true,L-m-0 C-m-0 C-l-1 C-l-1 C-l-0 C-l-0 
job-7871,3,11,5,393150,393150,393379,0,229,393614,true,L-l-0 C-s-1 C-s-0 C-s-2 C-m-1 
job-7874,2,6,8,393284,393284,393397,0,113,393564,true,L-m-0 L-l-0 L-l-0 L-l-0 L-l-0 C-m-0 C-m-1 C-m-1 
job-7875,6,5,7,393335,393335,393562,0,227,393821,true,L-m-0 C-m-0 C-m-2 C-l-1 C-l-1 C-l-0 C-l-0 
job-7876,5,7,6,393387,393562,393607,175,45,393434,false,L-m-0 L-l-0 L-l-0 C-m-0 C-m-2 C-m-1 
job-7879,4,10,5,393529,393562,393637,33,75,393694,true,C-s-2 C-l-1 C-l-1 C-l-1 C-l-0 
job-7878,1,9,2,393478,393562,393638,84,76,393629,false,L-s-0 L-l-0 
job-7877,3,6,7,393429,393562,393696,133,134,393634,false,L-m-0 C-m-0 C-m-2 C-m-1 L-s-0 C-s-1 C-s-0 
job-7882,1,5,4,393695,393695,393747,0,52,394043,true,L-s-0 L-l-0 L-l-0 C-s-1 
job-7881,5,12,3,393637,393637,393833,0,196,394130,true,C-m-2 C-m-1 C-l-1 
job-7880,5,11,4,393575,393607,393872,32,265,393903,true,L-m-0 L-l-0 L-l-0 C-m-0 
job-7884,6,6,1,393804,393804,393883,0,79,394169,true,C-l-0 
job-7883,4,12,3,393747,393747,393897,0,150,393988,true,C-l-1 L-s-0 C-s-1 
job-7885,4,8,1,393854,393854,393940,0,86,394011,true,C-l-0 
job-7886,6,10,1,393894,393894,393979,0,85,394079,true,C-l-1 
job-7887,5,8,5,393949,393949,394096,0,147,394167,true,C-l-1 L-m-0 L-l-0 L-l-0 C-m-0 
job-7888,2,11,2,394005,394005,394117,0,112,394354,true,L-m-0 L-l-0 
job-7889,3,8,4,394067,394067,394127,0,60,394140,true,C-m-0 C-l-1 C-l-1 L-s-0 
job-7890,5,10,8,394134,394134,394306,0,172,394523,true,L-m-0 L-l-0 L-l-0 C-m-0 C-m-2 C-m-1 C-l-1 C-l-1 
job-7891,5,6,4,394192,394192,394377,0,185,394565,true,C-l-0 C-l-0 C-l-2 C-l-2 
job-7895,6,5,2,394394,394394,394424,0,30,394636,true,C-l-0 C-l-2 
job-7892,6,10,3,394242,394306,394436,64,130,394442,true,L-m-0 L-l-0 L-l-0 
job-7894,1,4,7,394345,394345,394447,0,102,394608,true,L-s-0 L-s-0 L-s-0 L-s-0 C-s-1 C-s-1 C-s-1 
job-7893,1,8,6,394296,394306,394470,10,164,394706,true,L-m-0 L-m-0 C-l-0 C-l-0 C-l-2 C-l-2 
job-7896,1,12,8,394450,394450,394516,0,66,394716,true,L-m-0 C-l-0 C-l-0 C-l-2 C-l-2 L-s-0 L-l-0 L-l-0 
job-7897,3,7,2,394518,394518,394538,0,20,394656,true,L-s-0 L-m-0 
job-7899,6,11,4,394618,394618,394690,0,72,394888,true,C-l-0 C-l-2 C-l-2 C-l-1 
job-7898,6,11,7,394568,394568,394701,0,133,394852,true,L-m-0 L-l-0 L-l-0 C-m-0 C-m-2 C-m-1 C-l-0 
job-7900,2,9,4,394677,394677,394703,0,26,394773,true,L-m-0 C-m-0 C-m-2 C-m-1 
job-7901,1,4,7,394725,394725,394799,0,74,394897,true,L-s-0 L-s-0 L-s-0 L-s-0 L-m-0 L-m-0 L-m-0 
job-7904,4,8,7,394879,394879,394907,0,28,395032,true,L-s-0 C-s-1 C-s-0 C-s-2 C-m-0 C-m-0 C-m-2 
job-7902,3,10,4,394774,394774,394935,0,161,395141,true,L-m-0 L-l-0 L-l-0 L-l-0 
job-7906,2,12,7,394974,394974,394990,0,16,395054,true,L-m-0 L-l-0 L-l-0 L-l-0 C-m-2 C-m-2 C-m-1 
job-7903,1,6,4,394821,394821,395002,0,181,395142,true,L-m-0 L-m-0 L-m-0 L-l-0 
job-7905,4,7,6,394926,394926,395089,0,163,395360,true,L-s-0 C-s-1 C-s-0 C-s-2 C-m-0 C-m-0 
job-7907,5,4,2,395025,395025,395109,0,84,395174,true,L-m-0 L-l-0 
job-7908,3,5,6,395077,395077,395141,0,64,395333,true,L-m-0 L-l-0 L-l-0 C-m-2 C-m-2 C-m-1 
job-7910,2,10,7,395166,395166,395190,0,24,395470,true,L-m-0 L-m-0 L-s-0 L-l-0 L-l-0 L-l-0 L-l-0 
job-7909,4,8,1,395120,395120,395232,0,112,395516,true,L-m-0 
job-7912,6,8,4,395260,395260,395278,0,18,395309,true,L-l-0 C-m-2 C-m-1 C-m-0 
job-7911,1,7,6,395221,395221,395322,0,101,395545,true,L-m-0 L-m-0 L-m-0 L-s-0 L-s-0 L-l-0 
job-7913,5,10,6,395315,395315,395374,0,59,395473,true,L-m-0 L-l-0 L-l-0 C-m-2 C-m-1 C-m-0 
job-7914,1,5,6,395361,395361,395420,0,59,395468,true,L-m-0 L-m-0 L-m-0 L-l-0 L-l-0 C-m-2 
job-7915,2,7,2,395418,395418,395457,0,39,395493,true,L-m-0 L-m-0 
job-7916,3,7,4,395470,395470,395523,0,53,395589,true,L-s-0 L-m-0 L-m-0 L-l-0 
job-7919,3,6,3,395623,395623,395653,0,30,395677,true,L-m-0 L-s-0 C-s-0 
job-7917,1,12,5,395517,395517,395704,0,187,395888,true,L-m-0 L-l-0 L-l-0 L-l-0 C-s-1 
job-7922,3,5,4,395769,395769,395780,0,11,395921,true,L-s-0 L-m-0 C-s-0 C-s-2 
job-7918,4,9,2,395575,395575,395800,0,225,395974,true,L-m-0 L-l-0 
job-7921,4,8,3,395729,395729,395822,0,93,396010,true,L-l-0 L-l-0 C-s-1 
job-7924,6,11,4,395881,395881,395916,0,35,396092,true,L-l-0 C-m-2 C-m-1 C-m-0 
job-7920,1,11,4,395678,395678,395986,0,308,396024,true,L-m-0 L-s-0 C-s-0 C-s-2 
job-7925,6,11,3,395932,395932,395990,0,58,396276,true,L-l-0 C-m-2 C-m-1 
job-7923,1,11,2,395826,395826,396027,0,201,396112,true,L-m-0 L-l-0 
job-7927,5,4,5,396041,396041,396054,0,13,396075,true,L-l-0 C-m-2 C-m-1 C-m-0 C-l-0 
job-7928,4,5,5,396094,396094,396216,0,122,396347,true,L-m-0 L-l-0 L-l-0 C-s-0 C-s-2 
job-7929,5,5,7,396148,396148,396231,0,83,396311,true,C-m-2 C-m-1 C-m-0 C-l-0 C-l-0 C-l-2 C-l-2 
job-7930,2,12,3,396208,396208,396240,0,32,396494,true,C-m-2 C-m-1 C-m-0 
job-7931,3,12,5,396254,396254,396307,0,53,396525,true,L-m-0 L-l-0 L-l-0 C-s-0 C-s-2 
job-7933,5,12,2,396357,396357,396371,0,14,396644,true,C-m-2 C-m-1 
job-7932,1,6,7,396309,396309,396402,0,93,396411,true,L-m-0 L-m-0 L-m-0 L-l-0 L-l-0 L-l-0 L-l-0 
job-7934,1,4,2,396406,396406,396513,0,107,396768,true,L-m-0 L-m-0 
job-7926,4,9,3,395987,395987,396517,0,530,396793,true,L-m-0 L-l-0 L-s-0 
job-7938,3,6,6,396599,396599,396616,0,17,396860,true,L-m-0 L-l-0 C-m-1 C-m-0 L-s-0 C-s-2 
job-7936,3,5,3,396494,396494,396629,0,135,396906,true,L-l-0 C-m-2 C-s-0 
job-7937,5,6,3,396548,396548,396638,0,90,396638,false,L-m-0 C-m-1 C-m-0 
job-7935,5,10,2,396447,396447,396713,0,266,396909,true,L-l-0 C-m-2 
job-7939,3,4,3,396656,396656,396751,0,95,396760,true,L-l-0 L-l-0 C-m-2 
job-7940,5,8,7,396705,396705,396777,0,72,396966,true,L-m-0 C-m-1 C-m-0 C-l-0 C-l-0 C-l-2 C-l-2 
job-7941,6,8,7,396752,396777,396851,25,74,396901,true,L-m-0 L-l-0 L-l-0 C-m-1 C-m-0 C-m-2 C-l-0 
job-7944,6,7,5,396891,396891,396915,0,24,396951,true,L-m-0 C-m-1 C-l-0 C-l-2 L-l-0 
job-7942,3,12,7,396799,396799,396980,0,181,397195,true,C-l-0 C-l-0 L-s-0 C-s-0 C-s-2 C-s-1 C-l-2 
job-7943,2,6,2,396848,396848,396989,0,141,397207,true,L-m-0 C-m-1 
job-7946,4,8,2,396969,396969,396995,0,26,397208,true,C-l-2 C-l-2 
job-7945,1,10,6,396923,396923,396997,0,74,397185,true,L-m-0 L-m-0 C-m-1 C-m-1 C-l-0 C-l-0 
job-7948,6,8,3,397066,397066,397123,0,57,397128,true,C-m-2 C-l-0 C-l-0 
job-7947,6,8,5,397017,397017,397171,0,154,397371,true,L-m-0 L-l-0 L-l-0 C-m-1 C-m-0 
job-7949,5,11,6,397123,397123,397210,0,87,397333,true,C-m-2 C-l-0 C-l-0 C-l-2 C-l-2 C-l-1 
job-7951,1,10,3,397226,397226,397251,0,25,397423,true,C-m-2 C-m-2 C-l-0 
job-7950,2,9,4,397176,397176,397295,0,119,397413,true,C-m-2 C-l-0 C-l-2 C-l-1 
job-7952,3,8,6,397279,397279,397310,0,31,397463,true,C-m-2 C-m-2 C-l-0 C-l-0 C-l-0 C-l-2 
job-7954,5,10,4,397381,397381,397396,0,15,397513,true,L-l-0 L-l-0 C-m-2 C-m-1 
job-7953,6,11,1,397334,397334,397443,0,109,397715,true,L-m-0 
job-7955,1,12,3,397431,397431,397483,0,52,397767,true,L-m-0 L-s-0 L-l-0 
job-7956,4,12,5,397487,397487,397500,0,13,397516,true,L-s-0 L-m-0 L-m-0 L-l-0 L-l-0 
job-7959,3,6,5,397634,397634,397663,0,29,397819,true,C-l-0 C-l-0 C-l-0 C-l-0 C-l-2 
job-7957,4,11,8,397542,397542,397709,0,167,397913,true,L-s-0 L-m-0 L-m-0 L-l-0 L-l-0 L-l-0 C-s-0 C-s-2 
job-7960,4,10,2,397691,397691,397802,0,111,397814,true,C-l-0 C-l-0 
job-7961,4,7,2,397729,397729,397803,0,74,397895,true,C-l-0 L-s-0 
job-7958,3,10,7,397584,397584,397864,0,280,398051,true,C-s-1 C-m-2 C-m-2 C-m-1 C-m-1 C-m-0 C-m-0 
job-7963,2,6,4,397830,397830,397892,0,62,397965,true,C-m-2 C-m-1 C-m-0 C-l-2 
job-7965,2,11,1,397930,397930,398034,0,104,398326,true,C-m-2 
job-7966,6,7,6,397980,397980,398037,0,57,398116,true,C-l-2 C-m-0 C-l-0 C-l-0 C-l-1 C-l-1 
job-7967,2,8,1,398031,398031,398042,0,11,398145,true,C-m-0 
job-7964,3,9,3,397875,397875,398106,0,231,398281,true,C-m-2 C-m-2 C-m-1 
job-7968,4,9,3,398087,398087,398106,0,19,398194,true,C-m-1 C-l-2 C-l-2 
job-7970,2,4,3,398185,398185,398214,0,29,398421,true,L-s-0 C-s-1 C-s-1 
job-7969,1,8,6,398137,398137,398263,0,126,398263,false,C-l-2 C-l-2 C-l-2 C-l-2 C-l-2 L-s-0 
job-7972,6,11,7,398272,398272,398311,0,39,398520,true,C-l-2 C-m-2 C-m-1 C-m-0 C-l-0 C-l-0 C-l-1 
job-7962,4,7,8,397784,397784,398325,0,541,398487,true,L-m-0 L-m-0 L-l-0 L-l-0 L-l-0 C-s-0 C-s-2 C-l-2 
job-7971,1,4,6,398236,398236,398326,0,90,398541,true,L-s-0 L-s-0 C-s-1 C-s-1 C-s-1 C-s-1 
job-7973,2,9,8,398317,398317,398373,0,56,398530,true,C-l-2 C-l-2 C-l-2 C-l-2 C-m-2 C-m-2 C-m-2 C-m-1 
job-7974,1,12,4,398368,398368,398417,0,49,398593,true,C-m-1 C-l-2 L-s-0 L-m-0 
job-7975,6,12,2,398424,398424,398555,0,131,398804,true,L-m-0 L-l-0 
job-7976,6,8,6,398472,398472,398616,0,144,398685,true,L-l-0 C-m-2 C-m-1 C-m-0 C-l-2 C-l-2 
job-7979,2,11,5,398630,398630,398743,0,113,398769,true,L-l-0 L-l-0 L-l-0 C-m-2 C-m-2 
job-7978,2,5,6,398568,398568,398752,0,184,398865,true,L-m-0 C-m-2 C-m-1 C-m-0 C-l-1 C-l-1 
job-7980,6,7,1,398681,398681,398817,0,136,398899,true,C-m-1 
job-7981,3,7,4,398717,398717,398826,0,109,398942,true,C-m-0 C-m-0 L-s-0 C-s-1 
job-7977,6,9,5,398521,398555,398843,34,288,398941,true,L-l-0 L-m-0 C-l-0 C-l-0 C-l-1 
job-7982,1,10,6,398762,398762,398867,0,105,399076,true,L-m-0 L-m-0 L-l-0 L-l-0 L-l-0 C-m-0 
job-7984,1,11,7,398854,398854,398900,0,46,399111,true,L-m-0 L-l-0 C-m-1 C-m-0 C-m-0 C-l-1 L-s-0 
job-7985,3,7,2,398900,398900,398920,0,20,399120,true,C-m-1 C-m-1 
job-7986,6,4,5,398946,398946,398997,0,51,399023,true,C-m-1 C-l-1 L-m-0 L-l-0 L-l-0 
job-7983,2,12,5,398809,398809,399004,0,195,399273,true,C-m-1 C-l-1 C-l-1 C-l-1 C-s-0 
job-7987,6,12,6,399001,399001,399018,0,17,399272,true,C-m-1 C-l-1 L-m-0 L-l-0 L-l-0 C-m-0 
job-7988,1,10,1,399060,399060,399070,0,10,399233,true,L-s-0 
job-7989,5,6,8,399118,399118,399297,0,179,399558,true,L-m-0 L-l-0 L-l-0 C-m-1 C-m-0 C-m-2 C-l-1 C-l-1 
job-7990,5,8,5,399165,399297,399365,132,68,399276,false,L-m-0 L-l-0 L-l-0 C-m-1 C-m-0 
job-7991,3,7,3,399212,399297,399370,85,73,399478,true,L-m-0 C-m-1 C-m-0 
job-7994,1,11,5,399359,399365,399455,6,90,399647,true,L-l-0 L-l-0 L-l-0 L-l-0 C-m-2 
job-7993,5,4,4,399309,399365,399458,56,93,399601,true,L-m-0 C-m-1 C-m-0 L-l-0 
job-7995,4,9,6,399419,399419,399459,0,40,399617,true,L-s-0 C-s-0 C-s-1 C-s-2 C-l-2 C-l-2 
job-7992,5,12,5,399257,399297,399463,40,166,399690,true,C-m-2 C-l-1 C-l-1 C-l-0 C-l-0 
job-7997,4,4,1,399504,399504,399515,0,11,399683,true,C-l-2 
job-7996,6,4,6,399461,399461,399599,0,138,399802,true,L-m-0 L-l-0 L-l-0 C-m-1 C-m-0 C-l-2 
job-7998,5,8,5,399544,399544,399627,0,83,399872,true,C-l-2 C-m-2 C-l-1 C-l-1 C-l-0 
job-7999,3,11,5,399597,399597,399676,0,79,399876,true,C-m-2 C-l-0 C-l-0 L-s-0 C-s-0 
job-8001,3,8,7,399709,399709,399748,0,39,399887,true,L-l-0 L-l-0 C-m-2 C-l-0 C-l-0 L-s-0 C-s-0 
job-8000,3,5,7,399651,399651,399802,0,151,400095,true,C-m-2 C-l-0 C-l-0 L-m-0 L-m-0 L-l-0 L-l-0 
job-8004,1,6,6,399877,399877,399903,0,26,400106,true,C-m-2 C-m-2 C-l-0 C-l-0 C-l-0 C-l-0 
job-8002,3,6,4,399769,399769,399960,0,191,400244,true,L-l-0 L-l-0 C-m-2 C-l-0 
job-8006,3,9,3,399966,399966,400030,0,64,400194,true,L-l-0 L-l-0 C-m-2 
job-8007,2,5,8,400017,400017,400046,0,29,400167,true,L-m-0 C-m-2 C-l-0 C-l-0 C-l-0 L-s-0 L-s-0 C-s-0 
job-8005,6,5,2,399917,399917,400080,0,163,400369,true,C-l-0 L-m-0 
job-8008,6,4,7,400070,400070,400152,0,82,400300,true,L-l-0 C-l-0 C-m-1 C-m-0 C-l-2 C-l-2 C-l-1 
job-8011,3,4,4,400231,400231,400307,0,76,400373,true,C-l-0 C-l-0 C-l-1 C-l-1 
job-8003,3,10,3,399822,399822,400311,0,489,400603,true,L-l-0 L-l-0 C-m-2 
job-8009,5,6,4,400130,400130,400367,0,237,400657,true,C-m-2 C-l-0 C-l-1 L-m-0 
job-8010,2,6,4,400176,400176,400368,0,192,400404,true,L-m-0 L-l-0 L-l-0 L-l-0 
job-8012,4,4,1,400275,400275,400461,0,186,400483,true,L-s-0 
job-8013,2,9,8,400320,400320,400501,0,181,400773,true,L-l-0 L-l-0 L-l-0 C-m-2 C-l-0 C-l-0 C-l-0 C-l-1 
job-8014,3,9,2,400378,400378,400506,0,128,400709,true,L-l-0 L-l-0 
job-8016,5,10,7,400496,400506,400550,10,44,400648,true,C-l-0 L-l-0 L-l-0 C-m-1 C-m-0 C-l-2 C-l-2 
job-8017,4,10,4,400557,400557,400571,0,14,400576,true,L-m-0 C-m-2 C-l-1 C-l-0 
job-8015,4,9,5,400435,400435,400669,0,234,400939,true,C-m-2 C-l-0 C-l-1 C-l-1 L-m-0 
job-8018,1,11,6,400609,400609,400681,0,72,400952,true,L-m-0 L-m-0 C-m-2 C-m-2 C-l-1 C-l-1 
job-8022,2,5,1,400807,400807,400822,0,15,401056,true,C-l-2 
job-8021,3,9,3,400761,400761,400831,0,70,400864,true,C-l-0 C-l-0 C-l-2 
job-8020,2,8,2,400711,400711,400835,0,124,400863,true,C-m-1 C-m-0 
job-8023,3,11,3,400854,400854,400930,0,76,401175,true,C-l-0 C-l-0 C-l-2 
job-8019,6,7,6,400661,400661,401029,0,368,401267,true,C-l-0 L-l-0 L-l-0 C-m-1 C-m-0 C-l-2 
job-8026,1,7,4,400994,401029,401075,35,46,401132,true,L-m-0 L-l-0 L-l-0 C-m-1 
job-8024,5,12,7,400907,401029,401080,122,51,400971,false,L-m-0 L-l-0 L-l-0 C-m-1 C-m-0 C-m-2 C-l-0 
job-8027,3,11,1,401061,401061,401189,0,128,401471,true,C-m-0 
job-8028,1,5,2,401108,401108,401242,0,134,401424,true,L-m-0 L-m-0 
job-8030,1,9,1,401205,401205,401280,0,75,401454,true,L-m-0 
job-8029,6,10,7,401155,401155,401505,0,350,401532,true,L-l-0 L-l-0 C-m-1 C-m-2 C-l-0 C-l-0 C-l-2 
job-8031,5,6,6,401253,401505,401602,252,97,401461,false,L-m-0 L-l-0 L-l-0 C-m-1 C-m-2 C-m-0 
job-8033,4,9,8,401361,401505,401609,144,104,401521,false,L-s-0 C-s-0 C-s-1 C-s-2 C-l-0 C-l-0 C-l-0 C-l-2 
job-8036,1,4,6,401524,401524,401614,0,90,401689,true,C-m-1 C-m-2 C-m-2 C-l-2 C-l-1 C-l-1 
job-8037,6,10,5,401574,401614,401626,40,12,401766,true,L-l-0 C-m-1 C-m-2 C-l-1 C-l-0 
job-8035,3,10,3,401475,401505,401638,30,133,401683,true,C-m-0 C-l-2 C-l-1 
job-8038,6,5,6,401619,401626,401658,7,32,401945,true,L-l-0 C-m-1 C-m-2 C-l-1 C-l-0 C-l-0 
job-8032,1,10,6,401309,401505,401681,196,176,401533,false,L-m-0 L-l-0 L-l-0 C-m-1 C-m-1 C-m-2 
job-8039,5,9,8,401665,401665,401705,0,40,401886,true,L-m-0 L-l-0 L-l-0 C-m-1 C-m-2 C-l-2 C-m-0 C-l-1 
job-8034,4,5,1,401422,401505,401711,83,206,401643,false,C-l-2 
job-8025,2,7,1,400959,401029,401755,70,726,401846,true,L-m-0 
job-8040,6,10,8,401715,401715,401781,0,66,402074,true,L-m-0 L-l-0 L-l-0 C-m-1 C-m-2 C-m-0 C-l-2 C-l-2 
job-8041,6,4,2,401764,401764,401809,0,45,401864,true,C-l-1 C-l-1 
job-8042,2,9,7,401814,401814,401865,0,51,401986,true,L-s-0 L-m-0 L-m-0 L-m-0 L-l-0 L-l-0 L-l-0 
job-8043,5,10,2,401860,401860,401881,0,21,401959,true,L-l-0 C-m-1 
job-8045,1,4,6,401964,401964,402033,0,69,402075,true,L-s-0 L-m-0 L-m-0 L-m-0 L-m-0 L-m-0 
job-8044,1,4,3,401918,401918,402052,0,134,402108,true,L-s-0 L-s-0 L-s-0 
job-8046,1,10,5,402021,402021,402062,0,41,402241,true,L-m-0 L-l-0 L-l-0 L-l-0 L-l-0 
job-8047,6,7,8,402067,402067,402102,0,35,402347,true,L-m-0 L-l-0 L-l-0 C-m-1 C-m-2 C-m-0 C-l-2 C-l-2 
job-8048,5,5,3,402128,402128,402190,0,62,402205,true,L-m-0 L-l-0 L-l-0 
job-8049,5,4,6,402164,402164,402195,0,31,402365,true,C-m-1 C-m-2 C-m-0 C-l-2 C-l-2 C-l-1 
job-8051,1,8,1,402265,402265,402281,0,16,402442,true,L-m-0 
job-8050,2,6,3,402219,402219,402326,0,107,402572,true,L-s-0 L-s-0 L-m-0 
job-8053,1,4,7,402382,402382,402421,0,39,402592,true,C-s-0 C-s-0 C-s-0 C-s-0 C-s-1 C-s-1 C-s-1 
job-8055,6,10,4,402466,402466,402495,0,29,402503,true,C-m-1 C-m-2 C-m-0 C-l-2 
job-8054,3,4,3,402424,402424,402522,0,98,402622,true,C-s-0 C-s-1 C-s-2 
job-8052,4,9,6,402332,402332,402529,0,197,402617,true,L-s-0 L-m-0 L-m-0 L-l-0 L-l-0 L-l-0 
job-8056,3,4,5,402509,402509,402578,0,69,402760,true,C-m-1 C-m-1 C-m-2 C-m-2 C-m-0 
job-8057,6,10,7,402557,402557,402616,0,59,402904,true,L-m-0 L-l-0 L-l-0 C-l-2 C-l-2 C-l-1 C-l-1 
job-8060,2,7,8,402719,402719,402760,0,41,403027,true,C-m-2 C-m-0 L-s-0 L-s-0 C-s-0 C-s-0 C-s-1 C-s-1 
job-8061,4,4,5,402779,402779,402887,0,108,402936,true,L-s-0 C-s-0 C-s-1 C-s-2 C-l-2 
job-8059,1,8,4,402663,402663,402897,0,234,403189,true,L-m-0 L-m-0 C-m-1 C-m-1 
job-8058,6,9,6,402613,402616,402919,3,303,403124,true,L-m-0 L-l-0 L-l-0 C-m-1 C-m-2 C-m-0 
job-8064,2,11,3,402915,402915,402929,0,14,403180,true,L-m-0 C-m-1 C-m-0 
job-8062,1,12,1,402821,402821,402940,0,119,403053,true,C-m-2 
job-8065,5,12,1,402961,402961,402976,0,15,403235,true,C-l-2 
job-8066,2,5,6,403008,403008,403044,0,36,403261,true,C-l-2 C-l-2 C-l-2 C-l-1 C-l-1 C-l-1 
job-8067,4,5,1,403057,403057,403088,0,31,403109,true,C-l-2 
job-8063,5,11,2,402864,402864,403121,0,257,403315,true,C-l-2 C-l-1 
job-8068,5,10,4,403106,403106,403192,0,86,403298,true,C-l-2 C-l-1 L-m-0 L-l-0 
job-8069,1,4,8,403168,403168,403220,0,52,403357,true,L-m-0 L-m-0 L-m-0 L-l-0 L-l-0 L-l-0 L-l-0 L-l-0 
job-8070,5,9,1,403217,403217,403287,0,70,403362,true,L-m-0 
job-8071,3,5,3,403272,403272,403317,0,45,403359,true,L-m-0 L-s-0 L-l-0 
job-8073,5,5,8,403378,403378,403393,0,15,403591,true,L-l-0 L-l-0 C-m-2 C-m-1 C-m-0 C-l-2 C-l-2 C-l-1 
job-8072,1,10,4,403323,403323,403410,0,87,403655,true,L-s-0 L-m-0 L-m-0 L-m-0 
job-8075,5,5,4,403483,403483,403557,0,74,403764,true,L-m-0 L-l-0 L-l-0 C-m-2 
job-8077,5,4,5,403601,403601,403652,0,51,403755,true,L-m-0 L-l-0 L-l-0 C-m-2 C-l-2 
job-8074,3,4,2,403425,403425,403707,0,282,403932,true,L-s-0 L-m-0 
job-8080,2,12,7,403743,403743,403763,0,20,403771,true,L-m-0 L-m-0 L-l-0 C-m-1 C-m-0 C-m-2 C-m-2 
job-8076,6,12,2,403542,403542,403780,0,238,403824,true,C-m-1 C-m-0 
job-8079,4,5,7,403685,403685,403791,0,106,403993,true,L-m-0 L-l-0 L-l-0 C-s-0 C-s-1 C-s-2 C-m-2 
job-8081,4,11,1,403802,403802,403892,0,90,403904,true,L-l-0 
job-8082,2,9,1,403852,403852,403918,0,66,404173,true,L-l-0 
job-8083,4,9,1,403915,403915,403942,0,27,404208,true,L-l-0 
job-8078,1,9,2,403643,403643,403960,0,317,404245,true,L-s-0 L-l-0 
job-8084,4,12,1,403972,403972,404030,0,58,404288,true,L-s-0 
job-8086,1,7,6,404087,404087,404098,0,11,404254,true,L-s-0 L-m-0 L-m-0 L-l-0 L-l-0 L-l-0 
job-8085,3,6,3,404030,404030,404116,0,86,404407,true,L-s-0 L-m-0 L-m-0 
job-8087,2,10,4,404134,404134,404180,0,46,404233,true,L-s-0 L-m-0 L-m-0 L-m-0 
job-8088,1,11,1,404179,404179,404192,0,13,404421,true,L-l-0 
job-8089,2,12,7,404236,404236,404336,0,100,404387,true,L-s-0 L-m-0 L-m-0 L-l-0 L-l-0 L-l-0 L-l-0 
job-8090,3,4,8,404279,404279,404374,0,95,404385,true,L-m-0 C-s-0 C-s-1 C-s-2 C-m-1 C-m-1 C-m-0 C-m-0 
job-8093,1,12,2,404411,404411,404429,0,18,404546,true,L-m-0 C-m-2 
job-8091,5,5,2,404321,404321,404494,0,173,404583,true,C-m-2 C-l-2 
job-8094,6,4,6,404466,404466,404524,0,58,404771,true,C-l-2 L-l-0 L-l-0 C-m-1 C-m-0 C-l-1 
job-8092,5,9,1,404369,404369,404599,0,230,404754,true,L-m-0 
job-8095,4,9,6,404525,404525,404682,0,157,404808,true,L-s-0 L-l-0 L-l-0 L-l-0 C-s-0 C-s-1 
job-8096,3,7,7,404572,404572,404687,0,115,404694,true,L-m-0 C-s-2 C-m-2 C-m-2 C-m-1 C-m-1 C-m-0 
job-8097,2,12,2,404627,404627,404692,0,65,404913,true,L-m-0 L-m-0 
job-8099,1,7,2,404744,404744,404767,0,23,404825,true,L-m-0 L-m-0 
job-8100,3,4,7,404800,404800,404818,0,18,404942,true,L-m-0 L-l-0 L-l-0 C-s-0 C-s-1 C-s-2 C-m-2 
job-8101,3,4,3,404854,404854,404881,0,27,405078,true,L-m-0 L-l-0 L-l-0 
job-8098,2,4,7,404691,404691,404925,0,234,405175,true,L-m-0 L-m-0 L-s-0 L-s-0 L-l-0 L-l-0 L-l-0 
job-8102,3,8,1,404896,404896,404974,0,78,405097,true,L-m-0 
job-8103,5,7,1,404944,404944,405036,0,92,405091,true,L-m-0 
job-8104,3,6,2,405005,405005,405092,0,87,405279,true,L-m-0 L-s-0 
job-8105,1,10,2,405067,405067,405168,0,101,405287,true,L-s-0 L-m-0 
job-8106,3,8,1,405120,405120,405226,0,106,405321,true,L-m-0 
job-8107,1,7,1,405176,405176,405245,0,69,405496,true,L-m-0 
job-8109,1,5,5,405258,405258,405287,0,29,405490,true,L-s-0 L-m-0 L-m-0 L-m-0 L-m-0 
job-8108,2,10,4,405216,405216,405294,0,78,405442,true,L-m-0 L-s-0 L-l-0 L-l-0 
job-8110,6,12,3,405307,405307,405403,0,96,405497,true,L-m-0 L-l-0 L-l-0 
job-8112,1,6,5,405423,405423,405538,0,115,405770,true,L-s-0 C-s-0 C-s-1 C-s-2 C-m-2 
job-8113,6,8,3,405482,405482,405567,0,85,405661,true,L-m-0 L-l-0 L-l-0 
job-8111,3,6,7,405363,405363,405588,0,225,405858,true,L-s-0 C-s-0 C-s-1 C-s-2 C-m-2 C-m-2 C-m-1 
job-8115,4,11,8,405577,405577,405616,0,39,405625,true,L-m-0 L-l-0 L-l-0 L-l-0 C-m-0 C-m-0 C-l-2 C-l-2 
job-8116,3,6,5,405630,405630,405640,0,10,405895,true,L-m-0 L-m-0 C-m-1 C-m-2 C-m-2 
job-8118,1,10,3,405732,405732,405770,0,38,405837,true,C-m-2 C-m-2 L-s-0 
job-8119,2,4,6,405788,405788,405810,0,22,405930,true,L-m-0 C-m-2 C-m-2 C-m-2 L-s-0 L-s-0 
job-8120,5,4,7,405844,405844,405881,0,37,406148,true,C-m-2 L-l-0 L-l-0 C-m-0 C-l-2 C-l-2 C-l-1 
job-8117,1,7,4,405686,405686,405981,0,295,406103,true,L-m-0 L-m-0 C-m-1 C-m-1 
job-8122,5,5,8,405956,405956,405989,0,33,406134,true,L-l-0 C-m-0 C-l-2 C-l-2 C-l-1 C-l-1 C-l-0 C-l-0 
job-8121,3,8,5,405905,405905,405990,0,85,406254,true,C-m-2 C-m-2 L-s-0 L-l-0 L-l-0 
job-8114,1,6,6,405533,405533,406026,0,493,406305,true,L-m-0 L-m-0 C-m-2 C-m-1 C-m-1 C-m-1 
job-8123,2,5,4,406019,406019,406115,0,96,406275,true,L-m-0 L-m-0 L-m-0 C-m-1 
job-8124,1,4,4,406072,406072,406230,0,158,406284,true,L-m-0 L-m-0 C-m-1 C-m-1 
job-8125,3,5,5,406117,406117,406241,0,124,406505,true,L-m-0 L-m-0 C-m-1 C-m-1 L-s-0 
job-8126,1,7,6,406164,406164,406258,0,94,406385,true,L-s-0 L-l-0 L-l-0 L-l-0 L-l-0 L-l-0 
job-8127,2,9,2,406218,406218,406335,0,117,406592,true,L-l-0 C-s-0 
job-8129,2,9,2,406318,406318,406341,0,23,406363,true,L-m-0 L-l-0 
job-8130,5,11,8,406370,406370,406405,0,35,406490,true,L-l-0 C-m-2 C-m-0 C-l-2 C-l-2 C-l-1 C-l-1 C-l-0 
job-8132,4,10,6,406459,406459,406490,0,31,406706,true,L-l-0 L-s-0 C-s-0 C-s-1 C-s-2 C-m-2 
job-8133,4,7,4,406511,406511,406523,0,12,406658,true,L-l-0 L-s-0 C-s-0 C-s-1 
job-8128,6,4,3,406268,406268,406629,0,361,406835,true,L-l-0 L-m-0 C-m-1 
job-8136,6,9,2,406678,406678,406720,0,42,406732,true,L-m-0 L-l-0 
job-8137,6,12,3,406728,406728,406752,0,24,407040,true,L-m-0 L-l-0 C-m-1 
job-8135,1,5,1,406626,406626,406754,0,128,407035,true,L-m-0 
job-8134,4,11,3,406559,406559,406765,0,206,407053,true,L-l-0 L-s-0 C-s-0 
job-8131,1,5,1,406420,406420,406818,0,398,406991,true,L-m-0 
job-8138,1,12,8,406770,406770,406910,0,140,407190,true,L-m-0 L-m-0 L-s-0 L-l-0 L-l-0 L-l-0 L-l-0 C-s-0 
job-8140,6,8,5,406891,406891,406939,0,48,407040,true,L-m-0 C-l-2 C-l-1 C-l-1 C-l-0 
job-8141,4,5,6,406939,406939,407006,0,67,407223,true,C-l-2 L-s-0 L-m-0 L-m-0 L-l-0 L-l-0 
job-8143,3,11,7,407002,407006,407030,4,24,407318,true,L-l-0 L-l-0 C-l-2 C-l-2 L-s-0 L-m-0 L-m-0 
job-8142,4,6,7,406967,406967,407093,0,126,407319,true,L-l-0 C-s-0 C-s-1 C-s-2 C-l-1 C-l-1 C-l-1 
job-8144,5,12,7,407071,407093,407122,22,29,407274,true,C-l-2 L-m-0 L-l-0 L-l-0 C-l-1 C-l-1 C-l-0 
job-8139,6,12,4,406834,406834,407228,0,394,407314,true,C-m-1 C-m-2 C-m-0 C-l-2 
job-8146,6,10,3,407187,407228,407291,41,63,407307,true,C-l-2 C-l-0 C-m-1 
job-8147,6,8,4,407238,407291,407309,53,18,407467,true,C-l-2 C-l-0 C-m-1 C-m-2 
job-8149,2,12,1,407357,407357,407368,0,11,407512,true,L-m-0 
job-8148,3,7,6,407305,407305,407402,0,97,407576,true,L-s-0 C-s-0 C-s-1 C-s-2 C-m-0 C-m-0 
job-8145,6,5,7,407114,407122,407502,8,380,407699,true,C-l-2 L-m-0 L-l-0 L-l-0 C-l-1 C-l-1 C-l-0 
job-8152,6,4,3,407501,407502,407563,1,61,407589,true,C-l-2 C-l-2 C-l-0 
job-8151,3,9,3,407445,407502,407697,57,195,407710,true,L-s-0 C-s-0 C-s-1 
job-8150,6,5,8,407401,407502,407825,101,323,407732,false,L-m-0 L-l-0 L-l-0 C-m-0 C-m-1 C-m-2 C-l-1 C-l-1 
job-8154,1,7,1,407584,407825,407856,241,31,407904,true,L-m-0 
job-8157,3,6,1,407747,407825,407879,78,54,407962,true,C-s-0 
job-8156,2,11,8,407686,407825,407927,139,102,407838,false,L-m-0 L-l-0 C-m-0 C-m-1 C-m-2 C-l-1 C-l-2 L-s-0 
job-8155,5,11,4,407636,407825,407957,189,132,407994,true,C-l-1 C-l-1 C-l-2 C-l-2 
job-8160,4,10,1,407890,407957,407981,67,24,408006,true,C-l-2 
job-8153,5,6,6,407543,407825,408023,282,198,408028,true,L-m-0 L-l-0 L-l-0 C-m-0 C-m-1 C-m-2 
job-8161,1,8,5,407945,407957,408025,12,68,408310,true,L-m-0 L-m-0 L-m-0 L-l-0 L-l-0 
job-8159,5,5,4,407850,407957,408044,107,87,408092,true,C-l-0 C-l-1 C-l-1 C-l-2 
job-8158,5,12,1,407797,407825,408065,28,240,408323,true,C-l-0 
job-8163,1,9,5,408044,408044,408099,0,55,408317,true,C-m-0 C-m-0 C-m-1 C-m-1 C-m-2 
job-8162,2,6,8,407992,407992,408155,0,163,408442,true,C-m-0 C-m-1 C-m-2 C-l-0 C-l-1 C-l-2 C-l-2 C-l-2 
job-8165,3,5,1,408146,408146,408186,0,40,408242,true,C-m-2 
job-8164,2,9,8,408097,408097,408224,0,127,408334,true,C-m-2 C-l-2 C-l-2 C-l-2 C-l-0 C-l-0 C-l-0 C-l-0 
job-8166,3,9,6,408186,408186,408229,0,43,408302,true,C-m-2 C-m-2 C-l-0 C-l-2 C-l-2 L-s-0 
job-8167,4,7,1,408238,408238,408327,0,89,408477,true,L-s-0 
job-8168,1,10,5,408284,408284,408332,0,48,408531,true,L-m-0 L-m-0 L-m-0 L-l-0 L-l-0 
job-8169,6,9,5,408328,408328,408342,0,14,408428,true,L-l-0 C-m-2 C-m-0 C-m-1 C-l-0 
job-8170,5,10,3,408372,408372,408386,0,14,408549,true,L-m-0 L-l-0 L-l-0 
job-8172,3,5,3,408489,408489,408518,0,29,408695,true,L-l-0 L-l-0 C-s-0 
job-8173,5,6,4,408549,408549,408569,0,20,408798,true,L-l-0 C-m-2 C-m-0 C-m-1 
job-8171,4,10,4,408421,408421,408600,0,179,408827,true,L-s-0 L-m-0 L-m-0 L-l-0 
job-8174,4,8,6,408594,408594,408621,0,27,408889,true,L-l-0 L-l-0 C-s-0 C-s-1 C-s-2 C-m-2 
job-8176,5,6,6,408696,408696,408759,0,63,408894,true,C-m-0 C-m-1 C-l-0 C-l-0 C-l-2 C-l-2 
job-8177,1,6,1,408754,408754,408768,0,14,408780,true,L-m-0 
job-8175,5,10,4,408653,408653,408790,0,137,409023,true,L-m-0 L-l-0 L-l-0 C-m-2 
job-8179,4,11,2,408853,408853,408964,0,111,409216,true,L-m-0 L-m-0 
job-8178,4,7,1,408805,408805,408976,0,171,409066,true,L-s-0 
job-8181,3,11,3,408953,408953,409071,0,118,409367,true,C-m-2 C-m-2 C-m-0 
job-8180,4,5,6,408901,408901,409077,0,176,409329,true,L-l-0 L-l-0 L-l-0 C-s-0 C-s-1 C-s-2 
job-8183,6,12,4,409042,409042,409119,0,77,409145,true,C-m-1 C-l-0 C-l-0 C-l-2 
job-8182,3,10,3,409000,409000,409122,0,122,409417,true,C-m-0 L-s-0 L-m-0 
job-8184,4,11,7,409104,409104,409154,0,50,409339,true,L-m-0 C-m-0 C-l-2 L-l-0 L-l-0 L-l-0 C-s-0 
job-8185,3,12,8,409153,409153,409211,0,58,409376,true,L-m-0 C-m-0 C-l-2 C-l-2 L-s-0 C-s-1 C-s-2 C-m-1 
job-8186,6,10,8,409213,409213,409271,0,58,409414,true,L-m-0 L-l-0 L-l-0 C-m-0 C-m-1 C-m-2 C-l-2 C-l-2 
job-8187,3,7,6,409268,409268,409405,0,137,409596,true,L-s-0 C-s-0 C-s-1 C-s-2 C-l-0 C-l-0 
job-8188,5,4,2,409319,409319,409431,0,112,409565,true,C-l-0 L-m-0 
job-8191,2,9,8,409478,409478,409506,0,28,409653,true,L-m-0 L-m-0 L-l-0 L-s-0 C-s-0 C-s-1 C-s-2 C-m-0 
job-8190,2,8,1,409419,409419,409531,0,112,409542,true,L-l-0 
job-8192,5,8,8,409527,409527,409590,0,63,409614,true,L-m-0 C-m-0 C-m-1 C-m-2 C-l-0 C-l-0 C-l-2 C-l-2 
job-8189,3,12,3,409378,409378,409601,0,223,409622,true,L-m-0 L-l-0 L-l-0 
job-8193,2,5,4,409573,409573,409627,0,54,409661,true,L-l-0 L-l-0 L-l-0 C-m-0 
job-8194,2,7,5,409609,409609,409716,0,107,409791,true,L-l-0 L-l-0 L-l-0 C-m-0 C-m-0 
job-8196,6,7,1,409704,409704,409808,0,104,410099,true,L-m-0 
job-8198,4,4,6,409801,409801,409846,0,45,409990,true,C-s-2 C-m-1 C-m-1 C-m-2 C-m-2 C-l-0 
job-8195,4,5,2,409656,409656,409864,0,208,409958,true,L-l-0 C-m-0 
job-8199,1,8,8,409859,409859,409979,0,120,410181,true,L-l-0 L-l-0 C-m-0 L-m-0 L-m-0 L-m-0 L-m-0 C-s-2 
job-8197,3,9,6,409761,409761,410032,0,271,410319,true,L-l-0 L-l-0 C-m-0 L-s-0 C-s-0 C-s-1 
job-8203,4,7,1,410034,410034,410060,0,26,410274,true,C-m-0 
job-8200,5,5,7,409909,409909,410088,0,179,410361,true,C-m-1 C-m-2 C-l-0 C-l-0 C-l-2 C-l-2 C-l-1 
job-8204,4,9,6,410082,410088,410122,6,34,410276,true,C-m-0 C-l-1 C-l-1 L-s-0 C-s-0 C-s-1 
job-8205,1,12,7,410131,410131,410151,0,20,410187,true,C-m-0 C-m-0 C-l-1 C-l-1 C-l-1 L-s-0 C-s-0 
job-8202,4,10,2,409992,410032,410155,40,123,410240,true,L-l-0 L-l-0 
job-8201,4,6,6,409947,409979,410222,32,243,410301,true,L-l-0 C-m-0 C-l-1 L-m-0 L-m-0 C-s-2 
job-8206,6,8,2,410185,410185,410227,0,42,410327,true,L-l-0 C-l-1 
job-8207,5,12,3,410229,410229,410245,0,16,410501,true,L-m-0 L-l-0 L-l-0 
job-8208,6,10,7,410269,410269,410376,0,107,410475,true,L-m-0 L-l-0 L-l-0 C-m-0 C-m-1 C-m-2 C-l-1 
job-8212,1,6,2,410475,410475,410499,0,24,410795,true,L-m-0 L-m-0 
job-8210,4,11,2,410376,410376,410502,0,126,410683,true,L-m-0 L-s-0 
job-8211,3,7,4,410430,410430,410532,0,102,410587,true,L-l-0 L-l-0 L-l-0 L-l-0 
job-8213,3,8,7,410518,410518,410607,0,89,410862,true,L-m-0 L-m-0 L-s-0 C-s-2 C-s-0 C-s-1 C-m-0 
job-8215,6,4,5,410616,410616,410677,0,61,410742,true,L-m-0 C-m-1 C-m-2 C-l-1 C-l-1 
job-8214,2,8,7,410558,410558,410697,0,139,410995,true,C-m-0 C-m-0 L-l-0 L-l-0 L-l-0 L-l-0 L-l-0 
job-8216,2,6,6,410669,410669,410748,0,79,410978,true,L-l-0 C-m-0 C-m-0 C-m-1 C-m-2 L-s-0 
job-8217,3,10,2,410722,410722,410795,0,73,410924,true,L-m-0 L-m-0 
job-8219,1,8,5,410809,410809,410893,0,84,411022,true,L-m-0 L-m-0 L-m-0 L-l-0 L-l-0 
job-8209,2,4,1,410316,410316,410906,0,590,411010,true,L-m-0 
job-8221,2,10,1,410897,410897,410938,0,41,411025,true,L-m-0 
job-8218,5,10,3,410763,410763,410974,0,211,411062,true,L-l-0 L-l-0 C-m-0 
job-8222,4,5,3,410938,410938,411041,0,103,411056,true,L-s-0 L-m-0 L-m-0 
job-8220,6,4,2,410853,410853,411061,0,208,411325,true,C-m-1 C-m-2 
job-8224,2,5,8,411036,411036,411179,0,143,411242,true,C-m-0 C-m-1 C-m-2 C-s-2 C-s-2 C-s-0 C-s-0 C-s-1 
job-8225,3,5,3,411084,411084,411186,0,102,411296,true,C-m-1 C-m-1 C-m-2 
job-8226,4,11,3,411140,411140,411206,0,66,411395,true,L-s-0 L-m-0 L-m-0 
job-8223,6,8,3,410983,410983,411336,0,353,411549,true,L-l-0 L-l-0 C-m-0 
job-8227,2,8,4,411191,411191,411343,0,152,411547,true,C-m-0 C-s-2 C-s-2 C-s-0 
job-8229,5,8,6,411279,411279,411377,0,98,411402,true,C-m-1 C-m-2 C-l-1 C-l-1 C-l-0 C-l-0 
job-8228,1,6,8,411248,411248,411389,0,141,411504,true,C-s-0 L-s-0 L-s-0 L-m-0 L-m-0 L-m-0 L-m-0 L-m-0 
job-8231,5,12,1,411389,411389,411424,0,35,411700,true,C-l-2 
job-8232,1,10,5,411435,411435,411450,0,15,411587,true,C-l-2 C-l-2 C-l-2 C-l-2 L-s-0 
job-8230,6,6,1,411326,411326,411452,0,126,411669,true,C-l-2 
job-8234,3,4,8,411535,411535,411580,0,45,411797,true,L-m-0 C-m-0 C-m-1 C-m-2 L-s-0 C-s-2 C-s-0 C-s-1 
job-8233,5,5,6,411480,411480,411603,0,123,411818,true,L-m-0 L-l-0 L-l-0 C-m-0 C-m-1 C-m-2 
job-8235,2,5,5,411584,411584,411667,0,83,411779,true,L-m-0 L-l-0 C-m-0 C-m-1 C-m-2 
job-8236,4,7,3,411631,411631,411775,0,144,412040,true,L-m-0 L-l-0 L-l-0 
job-8237,3,5,3,411676,411676,411799,0,123,412092,true,L-m-0 L-l-0 L-s-0 
job-8239,6,11,5,411797,411797,411858,0,61,411996,true,L-l-0 C-m-1 C-m-2 C-l-2 C-l-2 
job-8240,5,11,7,411834,411834,411977,0,143,412226,true,L-l-0 C-m-0 L-m-0 C-l-1 C-l-1 C-l-0 C-l-0 
job-8238,3,10,4,411740,411740,411990,0,250,412153,true,C-s-2 C-s-0 C-s-1 C-m-0 
job-8241,2,8,4,411883,411883,412031,0,148,412223,true,L-m-0 L-l-0 L-l-0 L-l-0 
job-8242,2,5,8,411937,411937,412044,0,107,412079,true,C-l-1 C-l-0 L-s-0 L-s-0 C-m-1 C-m-1 C-m-1 C-m-1 
job-8243,5,7,7,411984,411984,412099,0,115,412200,true,L-m-0 L-l-0 C-m-0 C-l-1 C-l-1 C-l-0 C-l-0 
job-8244,2,9,2,412045,412045,412127,0,82,412226,true,L-m-0 L-l-0 
job-8246,1,11,6,412143,412143,412164,0,21,412430,true,L-m-0 L-m-0 L-s-0 L-l-0 L-l-0 L-l-0 
job-8245,2,5,2,412100,412100,412185,0,85,412385,true,L-m-0 L-m-0 
job-8247,4,7,7,412187,412187,412246,0,59,412317,true,L-s-0 L-m-0 L-m-0 L-l-0 L-l-0 L-l-0 C-s-2 
job-8249,4,8,5,412287,412287,412297,0,10,412389,true,L-s-0 L-m-0 L-m-0 L-l-0 L-l-0 
job-8250,5,6,5,412325,412325,412373,0,48,412532,true,L-m-0 L-l-0 L-l-0 C-l-1 C-l-1 
job-8248,4,6,8,412238,412238,412420,0,182,412598,true,C-s-0 C-s-1 C-m-0 C-m-0 C-m-1 C-m-1 C-m-2 C-m-2 
job-8252,6,4,3,412412,412412,412505,0,93,412597,true,L-m-0 L-l-0 L-l-0 
job-8251,4,10,8,412364,412364,412595,0,231,412690,true,L-s-0 C-s-2 C-l-0 C-l-0 C-l-0 C-l-2 C-l-2 C-l-2 
job-8255,4,4,5,412581,412581,412647,0,66,412842,true,L-l-0 C-s-1 C-m-0 C-m-0 C-m-1 
job-8256,3,10,4,412634,412634,412700,0,66,412976,true,C-m-1 L-s-0 C-s-2 C-m-2 
job-8253,4,9,1,412466,412466,412738,0,272,412970,true,C-s-0 
job-8254,4,5,4,412514,412514,412738,0,224,412791,true,L-m-0 L-m-0 L-l-0 L-l-0 
job-8258,1,12,2,412742,412742,412752,0,10,412778,true,C-m-1 C-m-2 
job-8259,5,5,1,412779,412779,412806,0,27,412855,true,L-m-0 
job-8257,5,9,3,412687,412687,412817,0,130,412818,true,C-m-1 C-m-2 C-m-0 
job-8260,4,7,6,412828,412828,412877,0,49,413066,true,L-s-0 L-m-0 L-m-0 L-l-0 L-l-0 L-l-0 
job-8262,6,9,4,412918,412918,412936,0,18,412953,true,L-m-0 L-l-0 L-l-0 C-m-0 
job-8261,3,6,6,412876,412876,413022,0,146,413056,true,C-s-0 C-s-2 C-s-1 C-m-1 C-m-1 C-m-2 
job-8263,4,5,6,412971,412971,413084,0,113,413157,true,C-m-2 L-s-0 L-m-0 L-m-0 L-l-0 L-l-0 
job-8265,4,10,7,413058,413058,413090,0,32,413143,true,C-m-2 C-s-0 C-s-2 C-s-1 C-m-1 C-m-1 C-m-0 
job-8266,5,9,3,413109,413109,413143,0,34,413419,true,L-l-0 L-m-0 C-m-2 
job-8264,4,11,1,413014,413014,413152,0,138,413288,true,L-l-0 
job-8269,4,11,1,413273,413273,413342,0,69,413395,true,L-s-0 
job-8270,3,5,2,413321,413321,413347,0,26,413416,true,L-m-0 C-m-2 
job-8268,6,5,4,413219,413219,413502,0,283,413711,true,C-l-0 C-l-0 C-l-2 C-l-2 
job-8267,5,11,6,413167,413167,413506,0,339,413611,true,L-m-0 L-l-0 L-l-0 C-m-2 C-m-1 C-m-0 
job-8273,2,8,5,413457,413502,413534,45,32,413682,true,L-l-0 C-l-1 C-l-1 C-l-1 C-l-1 
job-8272,3,10,8,413407,413502,413539,95,37,413637,true,L-m-0 C-m-2 C-m-1 C-m-0 L-s-0 C-s-0 C-s-2 C-s-1 
job-8275,1,4,8,413559,413559,413593,0,34,413598,true,L-m-0 L-m-0 L-m-0 L-m-0 L-m-0 L-l-0 L-l-0 L-l-0 
job-8274,3,5,7,413502,413506,413644,4,138,413735,true,L-m-0 L-l-0 L-l-0 L-l-0 C-m-2 C-m-1 C-m-0 
job-8277,2,9,5,413665,413665,413678,0,13,413817,true,L-m-0 L-m-0 L-l-0 L-l-0 L-l-0 
job-8276,3,6,8,413619,413619,413716,0,97,413928,true,L-m-0 L-l-0 C-m-2 C-m-1 C-m-0 L-s-0 C-s-0 C-s-2 
job-8278,3,11,2,413720,413720,413735,0,15,413880,true,L-s-0 L-m-0 
job-8271,6,5,4,413363,413502,413780,139,278,413887,true,C-l-0 C-l-0 C-l-2 C-l-2 
job-8279,3,5,2,413771,413771,413818,0,47,413841,true,L-s-0 L-m-0 
job-8280,5,12,6,413824,413824,413838,0,14,413894,true,L-m-0 L-l-0 L-l-0 C-m-2 C-m-1 C-m-0 
job-8281,5,6,7,413877,413877,414012,0,135,414245,true,L-m-0 L-l-0 L-l-0 C-m-2 C-m-1 C-m-0 C-l-0 
job-8283,3,5,2,413980,413980,414088,0,108,414138,true,C-m-0 C-l-0 
job-8285,6,10,4,414074,414088,414184,14,96,414425,true,C-l-0 C-l-2 C-l-1 C-l-1 
job-8282,1,12,7,413926,413926,414210,0,284,414227,true,L-m-0 L-m-0 L-l-0 L-l-0 C-m-2 C-m-2 C-m-1 
job-8286,5,11,4,414116,414184,414263,68,79,414393,true,C-l-0 C-l-2 C-l-1 C-l-1 
job-8284,5,7,8,414021,414021,414343,0,322,414526,true,L-m-0 L-l-0 L-l-0 C-m-2 C-m-0 C-m-1 C-l-0 C-l-2 
job-8289,2,8,7,414278,414343,414414,65,71,414559,true,L-m-0 C-m-2 C-m-1 C-m-0 C-m-0 C-l-2 C-l-2 
job-8287,3,10,5,414161,414184,414440,23,256,414535,true,C-m-0 L-s-0 C-s-0 C-s-2 C-s-1 
job-8290,5,5,3,414325,414414,414524,89,110,414677,true,C-m-0 C-l-2 C-l-1 
job-8291,2,6,2,414378,414414,414525,36,111,414502,false,L-m-0 C-m-2 
job-8293,1,5,5,414461,414461,414623,0,162,414907,true,L-s-0 C-m-1 C-m-1 C-l-1 C-l-2 
job-8294,5,11,2,414512,414524,414643,12,119,414682,true,C-m-0 C-l-1 
job-8292,3,9,4,414419,414440,414665,21,225,414781,true,C-m-0 C-l-1 C-l-1 L-s-0 
job-8288,6,12,8,414226,414343,414811,117,468,414710,false,L-m-0 L-l-0 L-l-0 C-m-2 C-m-1 C-l-0 C-l-0 C-l-2 
job-8296,5,6,1,414607,414811,414839,204,28,414912,true,C-l-0 
job-8295,5,10,7,414555,414811,414900,256,89,414920,true,L-m-0 L-l-0 L-l-0 C-m-1 C-m-2 C-m-0 C-l-0 
job-8297,6,10,2,414658,414811,414945,153,134,414818,false,C-l-2 C-l-2 
job-8298,6,7,8,414707,414900,415152,193,252,415212,true,L-m-0 L-l-0 L-l-0 C-m-1 C-m-2 C-m-0 C-l-0 C-l-0 
job-8301,1,12,2,414862,415152,415177,290,25,415055,false,L-l-0 L-l-0 
job-8299,5,4,8,414761,415152,415185,391,33,415082,false,L-m-0 L-l-0 L-l-0 C-m-1 C-m-2 C-m-0 C-l-0 C-l-0 
job-8304,5,9,1,415016,415185,415197,169,12,415212,true,L-l-0 
job-8305,5,5,3,415058,415197,415210,139,13,415261,true,L-l-0 C-l-0 C-l-0 
job-8300,3,5,8,414800,415152,415215,352,63,415094,false,L-m-0 C-m-1 C-m-2 C-m-0 L-s-0 C-s-0 C-s-2 C-s-1 
job-8306,3,9,5,415113,415210,415253,97,43,415210,false,L-l-0 L-l-0 C-l-0 C-l-0 C-l-0 
job-8307,4,7,2,415162,415215,415289,53,74,415412,true,L-m-0 C-m-1 
job-8302,3,7,6,414905,415152,415299,247,147,415289,false,C-l-2 C-l-2 C-l-2 C-l-2 C-l-1 C-l-1 
job-8308,3,5,2,415218,415218,415360,0,142,415568,true,C-m-2 C-m-0 
job-8303,4,7,6,414961,415185,415566,224,381,415343,false,L-m-0 C-m-1 C-m-2 C-m-0 C-l-1 L-l-0 
job-8309,6,5,7,415277,415566,415652,289,86,415532,false,L-m-0 L-l-0 L-l-0 C-m-2 C-m-0 C-m-1 C-l-1 
job-8313,1,8,1,415462,415652,415670,190,18,415541,false,C-m-2 
job-8312,2,6,1,415410,415652,415722,242,70,415640,false,L-m-0 
job-8314,6,7,2,415519,415652,415740,133,88,415825,true,C-l-0 C-l-0 
job-8311,4,8,7,415367,415652,415816,285,164,415776,false,L-s-0 C-s-0 C-s-2 C-s-1 C-l-2 C-l-2 C-l-2 
job-8315,3,5,8,415584,415816,415840,232,24,415885,true,L-s-0 C-s-0 C-s-2 C-s-1 C-l-2 C-l-2 C-l-2 C-l-2 
job-8318,2,12,8,415750,415840,415884,90,44,415947,true,L-m-0 C-m-2 C-m-0 C-m-1 C-l-2 C-l-2 C-l-2 L-s-0 
job-8317,6,10,2,415703,415840,415918,137,78,415849,false,C-l-0 C-l-2 
job-8320,4,10,3,415848,415918,415972,70,54,416188,true,C-l-2 L-s-0 C-s-0 
job-8316,6,8,1,415642,415816,415977,174,161,415931,false,C-l-0 
job-8310,6,5,8,415321,415652,416055,331,403,416019,false,L-m-0 L-l-0 L-l-0 C-m-2 C-m-0 C-m-1 C-l-1 C-l-1 
job-8322,6,8,1,415955,416055,416065,100,10,416049,false,C-m-2 
job-8319,6,5,2,415797,415918,416082,121,164,416121,true,C-l-0 C-l-2 
job-8323,5,8,7,415993,416082,416120,89,38,416049,false,C-l-0 C-l-2 C-m-2 C-m-0 C-m-1 C-l-1 C-l-1 
job-8324,4,11,8,416038,416120,416132,82,12,416066,false,C-l-0 C-l-2 L-s-0 C-s-0 C-s-2 C-s-1 C-m-2 C-m-2 
job-8325,6,4,5,416085,416132,416147,47,15,416306,true,C-l-0 C-l-2 C-m-2 C-m-0 C-m-1 
job-8328,3,9,1,416237,416237,416272,0,35,416473,true,L-s-0 
job-8327,6,8,2,416184,416184,416301,0,117,416323,true,C-l-0 C-l-2 
job-8329,2,10,5,416283,416283,416305,0,22,416330,true,L-l-0 L-s-0 C-s-0 C-s-2 C-s-1 
job-8321,5,8,5,415895,416055,416349,160,294,416266,false,C-l-0 C-l-2 L-m-0 L-l-0 L-l-0 
job-8331,6,11,8,416361,416361,416373,0,12,416442,true,L-l-0 C-l-0 C-m-2 C-m-0 C-m-1 C-l-2 C-l-2 C-l-1 
job-8326,1,4,3,416134,416134,416395,0,261,416475,true,L-m-0 L-m-0 L-m-0 
job-8330,1,5,3,416318,416318,416413,0,95,416690,true,L-l-0 L-l-0 C-l-0 
job-8333,1,7,5,416467,416467,416485,0,18,416566,true,L-l-0 L-l-0 L-l-0 L-l-0 L-l-0 
job-8332,2,6,8,416417,416417,416529,0,112,416744,true,L-s-0 L-s-0 L-m-0 L-m-0 L-m-0 L-m-0 L-l-0 L-l-0 
job-8334,3,7,2,416519,416519,416536,0,17,416691,true,L-l-0 L-l-0 
job-8335,3,8,5,416578,416578,416747,0,169,416906,true,L-s-0 L-m-0 L-m-0 L-l-0 L-l-0 
job-8337,4,11,8,416684,416684,416747,0,63,416959,true,C-s-0 C-s-2 C-s-1 C-m-1 C-m-1 C-l-0 C-l-0 C-l-0 
job-8336,6,7,3,416626,416626,416748,0,122,416933,true,L-l-0 C-m-2 C-m-0 
job-8338,5,5,5,416736,416747,416767,11,20,416787,true,L-l-0 L-m-0 C-l-2 C-l-2 C-l-1 
job-8339,5,7,8,416783,416783,416795,0,12,417044,true,L-m-0 L-l-0 L-l-0 C-m-1 C-m-2 C-m-0 C-l-0 C-l-0 
job-8342,4,9,3,416899,416899,417028,0,129,417143,true,L-l-0 C-s-0 C-s-2 
job-8343,3,11,4,416943,416943,417031,0,88,417133,true,C-s-1 C-m-1 C-m-1 C-m-2 
job-8344,6,12,7,416976,416976,417079,0,103,417110,true,C-m-0 C-l-0 C-l-0 C-l-2 C-l-2 C-l-1 C-l-1 
job-8340,1,8,8,416819,416819,417080,0,261,417290,true,L-s-0 L-s-0 L-m-0 L-m-0 L-m-0 L-m-0 L-l-0 L-l-0 
job-8341,6,10,1,416857,416857,417115,0,258,417329,true,L-l-0 
job-8346,5,11,7,417086,417086,417182,0,96,417315,true,L-l-0 L-m-0 C-m-0 C-m-2 C-l-0 C-l-0 C-l-2 
job-8345,6,9,1,417033,417033,417207,0,174,417303,true,C-m-1 
job-8348,3,5,6,417176,417176,417281,0,105,417413,true,C-m-0 C-m-2 C-l-2 C-l-2 L-s-0 C-s-0 
job-8347,1,11,6,417133,417133,417285,0,152,417338,true,L-m-0 L-l-0 L-l-0 L-l-0 C-m-1 C-m-1 
job-8350,6,9,5,417275,417275,417302,0,27,417333,true,L-m-0 L-l-0 C-m-1 C-l-2 C-l-0 
job-8349,1,6,1,417226,417226,417311,0,85,417320,true,L-s-0 
job-8352,5,12,3,417367,417367,417402,0,35,417421,true,L-l-0 C-m-1 C-m-0 
job-8351,3,10,4,417323,417323,417437,0,114,417522,true,L-s-0 L-m-0 L-m-0 L-l-0 
job-8354,1,4,5,417469,417469,417494,0,25,417699,true,L-l-0 L-l-0 L-l-0 C-s-0 C-s-2 
job-8353,3,12,8,417421,417421,417564,0,143,417731,true,L-l-0 L-l-0 L-l-0 C-s-0 C-s-2 C-s-1 C-m-1 C-m-1 
job-8355,4,12,7,417516,417516,417569,0,53,417844,true,L-s-0 L-m-0 L-m-0 C-m-0 C-m-0 C-m-2 C-m-2 
job-8356,2,12,5,417561,417561,417572,0,11,417669,true,L-l-0 C-l-2 C-l-2 C-l-2 C-l-2 
job-8359,6,7,5,417716,417716,417735,0,19,417961,true,L-l-0 L-l-0 C-m-0 C-m-2 C-m-1 
job-8358,3,5,1,417667,417667,417753,0,86,417789,true,L-m-0 
job-8357,4,5,2,417612,417612,417757,0,145,417782,true,L-s-0 L-m-0 
job-8360,5,8,3,417767,417767,417802,0,35,418005,true,L-m-0 L-l-0 L-l-0 
job-8361,1,10,1,417818,417818,417851,0,33,418133,true,L-s-0 
job-8362,6,8,1,417877,417877,417893,0,16,418120,true,L-m-0 
job-8363,1,7,8,417919,417919,417954,0,35,417963,true,L-s-0 L-s-0 L-m-0 L-m-0 L-m-0 L-m-0 L-l-0 L-l-0 
job-8365,1,10,2,418016,418016,418058,0,42,418078,true,L-m-0 L-m-0 
job-8364,6,9,3,417960,417960,418101,0,141,418307,true,L-m-0 L-l-0 L-l-0 
job-8366,2,10,4,418061,418061,418140,0,79,418340,true,L-m-0 L-s-0 C-s-0 C-s-2 
job-8367,2,7,2,418118,418118,418155,0,37,418265,true,L-m-0 L-m-0 
job-8368,5,7,7,418174,418174,418227,0,53,418276,true,L-m-0 L-l-0 L-l-0 C-m-0 C-m-2 C-m-1 C-l-2 
job-8369,6,7,3,418231,418231,418259,0,28,418556,true,L-m-0 L-l-0 L-l-0 
job-8370,2,4,4,418278,418278,418343,0,65,418626,true,L-s-0 L-s-0 L-m-0 L-m-0 
job-8372,6,11,8,418392,418392,418435,0,43,418450,true,C-m-0 C-m-2 C-m-1 C-l-2 C-l-2 C-l-0 C-l-0 C-l-1 
job-8373,4,9,5,418442,418442,418502,0,60,418619,true,L-m-0 L-s-0 C-m-0 C-m-0 C-m-2 
job-8371,4,12,7,418333,418333,418596,0,263,418792,true,L-m-0 L-l-0 L-l-0 L-l-0 C-s-0 C-s-2 C-s-1 
job-8376,1,11,5,418593,418596,418749,3,153,419019,true,L-m-0 L-m-0 C-m-1 C-m-1 L-s-0 
job-8374,6,6,7,418490,418490,418763,0,273,418981,true,C-m-1 C-l-2 C-l-2 C-l-0 C-l-0 C-l-1 C-l-1 
job-8377,3,6,3,418650,418650,418789,0,139,419002,true,C-s-0 C-s-2 C-s-1 
job-8378,5,11,5,418689,418763,418831,74,68,419023,true,C-m-1 C-m-0 C-m-2 C-l-2 C-l-2 
job-8375,6,5,3,418528,418596,418844,68,248,418914,true,L-m-0 L-l-0 L-l-0 
job-8381,3,12,2,418845,418845,418867,0,22,419078,true,L-s-0 L-l-0 
job-8380,1,12,7,418788,418831,418904,43,73,419071,true,L-m-0 L-m-0 C-m-1 C-m-1 C-m-0 C-m-0 C-m-2 
job-8379,6,4,7,418738,418831,418933,93,102,418913,false,C-m-1 C-m-0 C-m-2 C-l-2 C-l-2 C-l-0 C-l-0 
job-8382,6,4,7,418883,418933,418980,50,47,418949,false,L-m-0 L-l-0 L-l-0 C-m-1 C-m-0 C-m-2 C-l-2 
job-8385,5,6,2,419027,419027,419040,0,13,419156,true,C-m-1 C-m-0 
job-8383,4,7,7,418923,418933,419120,10,187,419346,true,C-l-2 L-s-0 C-s-0 C-s-2 C-s-1 C-l-0 C-l-0 
job-8384,3,10,8,418978,418980,419139,2,159,419275,true,C-l-0 C-l-2 C-l-2 L-m-0 L-m-0 L-l-0 L-l-0 L-l-0 
job-8387,6,5,7,419128,419139,419163,11,24,419410,true,L-m-0 L-l-0 L-l-0 C-l-2 C-l-2 C-l-0 C-l-0 
job-8389,3,6,1,419235,419235,419254,0,19,419426,true,L-m-0 
job-8386,4,12,6,419075,419075,419283,0,208,419575,true,C-m-1 C-m-1 C-m-0 C-m-0 C-m-2 C-m-2 
job-8388,1,8,2,419191,419191,419303,0,112,419476,true,L-s-0 L-s-0 
job-8391,6,7,3,419339,419339,419401,0,62,419490,true,C-l-2 C-l-2 C-l-0 
job-8392,2,12,2,419381,419381,419412,0,31,419664,true,L-m-0 L-l-0 
job-8390,5,8,6,419287,419287,419442,0,155,419535,true,L-m-0 L-l-0 L-l-0 C-m-1 C-m-0 C-m-2 
job-8393,6,4,2,419435,419435,419490,0,55,419556,true,C-l-2 C-l-2 
job-8394,6,4,7,419490,419490,419544,0,54,419547,true,L-m-0 L-l-0 L-l-0 C-m-1 C-m-0 C-m-2 C-l-2 
job-8395,2,9,4,419541,419541,419605,0,64,419625,true,L-m-0 C-m-1 C-m-0 C-m-2 
job-8396,4,9,7,419581,419581,419664,0,83,419844,true,L-m-0 C-m-1 C-m-0 C-m-2 L-s-0 L-l-0 L-l-0 
job-8398,6,4,4,419688,419688,419767,0,79,419779,true,L-m-0 L-l-0 C-m-1 C-m-0 
job-8399,3,12,8,419738,419738,419851,0,113,419980,true,L-s-0 C-s-0 C-s-2 C-s-1 C-m-2 C-m-2 C-l-2 C-l-2 
job-8397,2,12,3,419626,419626,419855,0,229,420005,true,L-m-0 L-l-0 L-l-0 
job-8401,6,9,5,419853,419853,419925,0,72,419942,true,C-m-2 C-m-1 C-m-0 C-l-2 C-l-2 
job-8400,1,6,6,419791,419791,419928,0,137,420104,true,L-m-0 L-m-0 L-m-0 L-l-0 L-l-0 L-l-0 
job-8403,4,5,6,419949,419949,419995,0,46,420102,true,L-m-0 C-m-2 C-m-2 C-m-1 C-m-1 C-m-0 
job-8402,3,8,8,419894,419894,420046,0,152,420132,true,L-m-0 L-l-0 L-l-0 L-l-0 L-s-0 C-s-0 C-s-2 C-s-1 
job-8405,1,11,3,420063,420063,420118,0,55,420412,true,C-m-2 C-m-2 C-m-1 
job-8404,6,8,6,420000,420000,420319,0,319,420617,true,C-m-2 C-m-1 C-m-0 C-l-2 C-l-2 C-l-0 
job-8407,2,7,8,420161,420319,420360,158,41,420282,false,L-m-0 L-l-0 C-m-2 C-m-1 C-m-0 C-l-2 L-s-0 L-s-0 
job-8408,4,7,7,420210,420319,420368,109,49,420484,true,C-s-0 C-s-2 C-s-1 C-l-0 C-l-0 C-l-0 C-l-1 
job-8411,1,12,3,420340,420360,420379,20,19,420373,false,L-m-0 C-m-2 C-m-1 
job-8406,5,7,8,420116,420319,420382,203,63,420318,false,L-m-0 L-l-0 L-l-0 C-m-2 C-m-1 C-m-0 C-l-2 C-l-2 
job-8410,3,7,1,420299,420360,420387,61,27,420460,true,C-l-1 
job-8412,6,11,8,420388,420388,420454,0,66,420585,true,L-m-0 L-l-0 C-m-2 C-m-1 C-m-0 C-l-2 C-l-0 C-l-0 
job-8409,2,8,6,420249,420360,420530,111,170,420519,false,L-m-0 L-l-0 C-m-2 C-m-1 C-m-0 C-l-2 
job-8413,1,8,3,420444,420444,420539,0,95,420811,true,L-l-0 L-l-0 L-l-0 
job-8415,2,12,1,420539,420539,420552,0,13,420589,true,L-l-0 
job-8417,1,6,5,420638,420638,420650,0,12,420677,true,L-l-0 L-l-0 L-s-0 L-s-0 C-s-0 
job-8414,1,11,6,420492,420492,420671,0,179,420721,true,L-m-0 L-m-0 L-l-0 C-m-2 C-m-2 C-m-1 
job-8416,3,8,7,420592,420592,420695,0,103,420726,true,L-m-0 L-l-0 L-l-0 L-l-0 C-m-2 C-m-1 C-m-1 
job-8418,1,5,4,420676,420676,420749,0,73,420870,true,L-m-0 L-m-0 L-m-0 L-m-0 
job-8419,2,10,6,420727,420727,420752,0,25,420923,true,L-m-0 L-s-0 L-l-0 L-l-0 L-l-0 L-l-0 
job-8421,6,6,6,420826,420826,420847,0,21,421104,true,L-l-0 C-m-1 C-m-2 C-m-0 C-l-2 C-l-2 
job-8420,3,9,5,420771,420771,420906,0,135,421146,true,L-s-0 L-m-0 L-m-0 L-l-0 L-l-0 
job-8422,6,5,5,420866,420866,420936,0,70,421082,true,L-l-0 C-m-1 C-m-2 C-m-0 C-l-2 
job-8424,3,9,6,420959,420959,421057,0,98,421220,true,L-l-0 L-l-0 L-s-0 L-m-0 L-m-0 C-s-0 
job-8426,3,4,4,421055,421055,421066,0,11,421265,true,C-s-2 C-s-1 C-l-0 C-l-0 
job-8425,6,9,5,421002,421002,421095,0,93,421360,true,C-m-1 C-m-2 C-m-0 C-l-2 C-l-2 
job-8423,3,6,2,420915,420915,421147,0,232,421385,true,L-l-0 L-l-0 
job-8428,1,11,8,421160,421160,421190,0,30,421358,true,L-l-0 L-l-0 L-s-0 L-m-0 L-m-0 C-s-0 C-s-2 C-s-1 
job-8427,1,8,3,421107,421107,421216,0,109,421273,true,L-l-0 L-l-0 L-l-0 
job-8429,1,8,8,421224,421224,421280,0,56,421291,true,L-s-0 L-s-0 L-m-0 L-m-0 L-m-0 L-m-0 L-l-0 L-l-0 
job-8430,4,11,2,421273,421273,421286,0,13,421444,true,L-l-0 L-l-0 
job-8431,5,8,7,421314,421314,421409,0,95,421419,true,L-m-0 L-l-0 L-l-0 C-m-1 C-m-2 C-m-0 C-l-2 
job-8432,5,7,6,421354,421409,421425,55,16,421467,true,L-m-0 L-l-0 L-l-0 C-m-1 C-m-2 C-m-0 
job-8434,6,4,4,421477,421477,421497,0,20,421691,true,L-m-0 L-l-0 L-l-0 C-m-1 
job-8435,5,10,5,421533,421533,421553,0,20,421696,true,L-m-0 L-l-0 L-l-0 C-m-1 C-m-2 
job-8436,3,4,5,421585,421585,421641,0,56,421641,false,L-m-0 L-m-0 L-s-0 L-l-0 L-l-0 
job-8433,1,12,1,421409,421409,421646,0,237,421689,true,L-m-0 
job-8438,6,6,5,421672,421672,421692,0,20,421902,true,L-l-0 L-m-0 C-m-1 C-m-2 C-m-0 
job-8439,3,7,8,421722,421722,421808,0,86,421888,true,L-l-0 L-l-0 L-s-0 L-m-0 L-m-0 C-m-1 C-m-1 C-m-2 
job-8441,6,7,8,421823,421823,421834,0,11,421980,true,L-m-0 L-l-0 C-m-1 C-m-2 C-m-0 C-l-2 C-l-2 C-l-0 
job-8437,4,4,4,421625,421625,421858,0,233,421884,true,L-l-0 C-s-0 C-s-2 C-s-1 
job-8440,1,12,4,421771,421771,421919,0,148,422198,true,L-m-0 L-l-0 L-l-0 C-m-1 
job-8443,3,7,3,421913,421913,421929,0,16,421988,true,L-m-0 C-m-1 C-s-2 
job-8444,1,12,2,421955,421955,421983,0,28,422254,true,L-m-0 L-m-0 
job-8442,4,7,6,421865,421865,422155,0,290,422228,true,L-m-0 L-l-0 L-l-0 C-m-1 L-s-0 C-s-0 
job-8445,5,8,8,421998,421998,422175,0,177,422467,true,C-m-2 C-m-0 C-l-2 C-l-2 C-l-0 C-l-0 C-l-1 C-l-1 
job-8448,1,11,3,422149,422155,422185,6,30,422451,true,C-m-2 C-m-0 C-l-1 
job-8450,5,8,4,422244,422244,422258,0,14,422303,true,C-l-2 C-l-0 C-l-0 L-l-0 
job-8449,4,10,3,422196,422196,422261,0,65,422277,true,C-m-2 C-m-0 C-l-2 
job-8451,1,6,2,422288,422288,422313,0,25,422596,true,C-m-2 C-m-2 
job-8447,2,6,5,422099,422155,422330,56,175,422460,true,L-m-0 C-m-2 C-m-0 C-l-2 C-l-0 
job-8452,1,10,3,422332,422332,422404,0,72,422413,true,L-m-0 L-m-0 L-s-0 
job-8453,4,5,1,422374,422374,422445,0,71,422733,true,L-l-0 
job-8446,6,12,1,422045,422155,422474,110,319,422587,true,L-m-0 
job-8455,5,6,1,422486,422486,422527,0,41,422649,true,L-m-0 
job-8456,4,10,4,422532,422532,422583,0,51,422648,true,L-m-0 L-l-0 L-l-0 L-s-0 
job-8457,2,11,3,422578,422578,422609,0,31,422707,true,L-l-0 C-s-0 C-s-2 
job-8454,1,7,4,422436,422436,422659,0,223,422676,true,L-m-0 L-m-0 L-l-0 L-l-0 
job-8458,6,7,6,422645,422645,422702,0,57,422770,true,L-m-0 L-l-0 C-m-2 C-m-0 C-m-1 C-l-2 
job-8459,5,12,3,422688,422688,422782,0,94,422850,true,L-l-0 C-l-2 C-l-0 
job-8460,6,11,2,422741,422741,422791,0,50,422966,true,L-l-0 C-l-2 
job-8462,4,4,6,422827,422827,422870,0,43,422884,true,L-s-0 C-s-0 C-s-2 C-s-1 C-m-2 C-m-2 
job-8463,4,5,4,422873,422873,423006,0,133,423083,true,L-s-0 C-s-0 C-s-2 C-s-1 
job-8461,5,6,3,422791,422791,423032,0,241,423193,true,L-m-0 L-l-0 L-l-0 
job-8466,2,12,8,423023,423023,423033,0,10,423055,true,L-m-0 L-l-0 C-m-2 C-m-0 C-m-1 C-l-2 C-l-0 C-l-1 
job-8465,5,12,8,422971,422971,423097,0,126,423369,true,C-m-0 C-m-1 C-l-2 C-l-2 C-l-0 C-l-0 C-l-1 C-l-1 
job-8464,6,10,1,422925,422925,423125,0,200,423357,true,C-m-2 
job-8467,4,4,1,423068,423068,423135,0,67,423213,true,L-s-0 
job-8469,6,6,7,423173,423173,423226,0,53,423227,true,L-l-0 L-l-0 C-m-2 C-m-0 C-m-1 C-l-2 C-l-2 
job-8468,2,4,4,423131,423131,423260,0,129,423296,true,L-m-0 L-m-0 L-m-0 L-m-0 
job-8470,4,4,8,423218,423218,423364,0,146,423457,true,L-s-0 C-s-0 C-s-2 C-s-1 C-l-0 C-l-0 C-l-0 C-l-1 
job-8472,1,6,1,423322,423322,423420,0,98,423428,true,L-m-0 
job-8471,1,9,5,423276,423276,423439,0,163,423646,true,C-l-1 C-l-1 C-l-1 C-l-1 L-m-0 
job-8474,5,6,7,423428,423428,423474,0,46,423492,true,L-m-0 C-l-1 L-l-0 L-l-0 C-m-2 C-m-0 C-m-1 
job-8476,6,10,7,423543,423543,423554,0,11,423594,true,L-l-0 L-l-0 C-m-2 C-m-0 C-m-1 C-l-1 C-l-1 
job-8475,3,9,2,423483,423483,423639,0,156,423808,true,L-m-0 L-m-0 
job-8473,1,5,2,423377,423377,423651,0,274,423681,true,L-m-0 L-m-0 
job-8477,2,11,5,423586,423586,423659,0,73,423817,true,L-s-0 L-l-0 L-l-0 L-l-0 L-l-0 
job-8479,3,10,3,423699,423699,423771,0,72,423967,true,L-s-0 L-l-0 L-l-0 
job-8480,6,10,8,423743,423743,423781,0,38,424067,true,L-l-0 C-m-2 C-m-0 C-m-1 C-l-1 C-l-1 C-l-0 C-l-0 
job-8478,2,9,6,423651,423651,423789,0,138,423964,true,L-m-0 L-m-0 L-m-0 C-s-0 C-s-2 C-s-1 
job-8481,4,8,8,423798,423798,423817,0,19,423873,true,L-s-0 L-m-0 L-m-0 L-l-0 L-l-0 L-l-0 C-s-0 C-s-2 
job-8483,2,4,6,423889,423889,423907,0,18,424180,true,L-m-0 C-s-0 C-s-0 C-s-2 C-s-2 C-s-1 
job-8482,3,5,7,423840,423840,423922,0,82,424074,true,L-s-0 L-m-0 L-m-0 L-l-0 L-l-0 L-l-0 L-l-0 
job-8484,6,8,1,423933,423933,423975,0,42,424207,true,L-m-0 
job-8485,6,4,7,423978,423978,424188,0,210,424286,true,L-m-0 L-l-0 L-l-0 C-m-2 C-m-0 C-m-1 C-l-1 
job-8486,5,4,6,424024,424188,424220,164,32,424138,false,L-m-0 L-l-0 L-l-0 C-m-2 C-m-0 C-m-1 
job-8489,5,5,4,424184,424188,424243,4,55,424241,false,C-l-1 C-l-1 C-l-0 C-l-0 
job-8487,1,7,1,424072,424188,424290,116,102,424230,false,L-m-0 
job-8488,3,8,2,424120,424188,424305,68,117,424406,true,C-m-2 C-m-0 
job-8490,5,9,8,424236,424236,424344,0,108,424388,true,L-m-0 C-m-2 C-m-0 L-l-0 L-l-0 C-m-1 C-l-2 C-l-2 
job-8492,2,11,3,424332,424332,424350,0,18,424350,false,L-m-0 L-l-0 C-m-2 
job-8491,4,11,8,424273,424273,424403,0,130,424489,true,L-s-0 C-s-0 C-s-2 C-s-1 C-l-1 C-l-1 C-l-1 C-l-0 
job-8493,5,5,4,424388,424388,424419,0,31,424710,true,C-l-0 L-m-0 L-l-0 L-l-0 
job-8494,6,9,3,424429,424429,424490,0,61,424559,true,L-m-0 L-l-0 L-l-0 
job-8495,5,9,3,424475,424475,424497,0,22,424612,true,C-m-2 C-m-0 C-m-1 
job-8496,6,5,1,424530,424530,424553,0,23,424675,true,L-m-0 
job-8497,6,8,1,424574,424574,424640,0,66,424827,true,L-m-0 
job-8498,3,4,6,424621,424621,424651,0,30,424903,true,L-s-0 L-l-0 L-l-0 L-l-0 L-l-0 C-s-0 
job-8499,2,6,5,424670,424670,424715,0,45,424815,true,L-s-0 L-s-0 L-m-0 L-m-0 L-m-0 
job-8502,4,12,6,424832,424832,424849,0,17,424922,true,L-m-0 L-l-0 L-l-0 L-l-0 C-s-0 C-s-2 
job-8500,3,8,1,424723,424723,424874,0,151,424997,true,L-s-0 
job-8503,5,11,1,424885,424885,424961,0,76,424962,true,L-m-0 
job-8504,3,11,3,424935,424935,424966,0,31,424990,true,L-s-0 L-l-0 L-l-0 
job-8505,4,12,2,424988,424988,425000,0,12,425277,true,L-m-0 L-s-0 
job-8501,3,8,1,424775,424775,425007,0,232,425117,true,L-m-0 
job-8508,4,10,8,425158,425158,425188,0,30,425197,true,C-m-2 C-m-0 C-m-0 C-m-1 C-m-1 C-l-1 C-l-1 C-l-1 
job-8506,4,5,8,425037,425037,425203,0,166,425224,true,L-s-0 L-m-0 L-m-0 L-l-0 L-l-0 L-l-0 C-s-0 C-s-2 
job-8509,2,6,2,425213,425213,425223,0,10,425278,true,C-m-2 C-m-2 
job-8511,4,4,2,425327,425327,425352,0,25,425505,true,L-l-0 L-l-0 
job-8510,4,4,5,425269,425269,425436,0,167,425733,true,C-m-2 L-s-0 L-m-0 L-m-0 L-l-0 
job-8513,4,5,2,425425,425425,425457,0,32,425732,true,C-m-0 C-m-0 
job-8512,4,9,4,425380,425380,425486,0,106,425717,true,L-l-0 L-l-0 C-s-0 C-s-2 
job-8507,2,7,3,425096,425096,425547,0,451,425694,true,C-s-1 C-s-1 C-m-2 
job-8514,6,12,7,425485,425485,425567,0,82,425760,true,C-m-2 L-m-0 C-m-0 C-m-1 C-l-1 C-l-1 C-l-0 
job-8516,5,12,5,425578,425578,425652,0,74,425922,true,C-l-0 L-m-0 C-m-2 C-m-0 C-m-1 
job-8515,6,6,5,425539,425539,425702,0,163,425784,true,C-l-0 L-l-0 L-l-0 C-l-2 C-l-2 
job-8519,3,7,6,425716,425716,425736,0,20,425957,true,L-l-0 L-l-0 C-s-1 C-s-0 C-s-2 C-l-2 
job-8518,3,12,7,425668,425702,425805,34,103,425965,true,C-l-0 C-l-0 C-l-1 C-l-1 L-s-0 L-l-0 L-l-0 
job-8517,6,7,6,425616,425652,426001,36,349,426115,true,C-l-0 L-m-0 C-m-2 C-m-0 C-m-1 C-l-1 
job-8520,5,4,7,425771,426001,426042,230,41,425912,false,L-m-0 L-l-0 L-l-0 C-m-2 C-m-0 C-m-1 C-l-0 
job-8521,4,10,1,425833,426001,426094,168,93,426198,true,C-l-0 
job-8524,6,12,2,425975,426042,426115,67,73,426155,true,C-l-0 C-l-2 
job-8526,1,5,4,426092,426092,426136,0,44,426147,true,C-l-2 L-s-0 L-s-0 L-s-0 
job-8523,5,4,2,425924,426001,426143,77,142,426241,true,C-l-1 C-l-2 
job-8528,1,5,3,426180,426180,426261,0,81,426351,true,L-m-0 L-m-0 C-m-2 
job-8522,5,9,1,425873,426001,426267,128,266,426354,true,C-l-1 
job-8525,2,11,2,426032,426042,426292,10,250,426321,true,C-l-0 C-l-1 
job-8530,4,5,4,426278,426292,426313,14,21,426511,true,L-s-0 C-s-1 C-s-0 C-s-2 
job-8529,5,4,6,426232,426292,426413,60,121,426650,true,C-l-0 C-l-2 C-m-0 C-m-1 C-l-1 C-l-1 
job-8531,6,4,5,426330,426413,426460,83,47,426473,true,C-l-0 C-l-2 C-m-0 C-m-1 C-l-1 
job-8527,6,7,6,426134,426134,426469,0,335,426592,true,C-l-2 C-l-0 L-m-0 L-l-0 L-l-0 C-m-2 
job-8532,6,4,5,426380,426460,426518,80,58,426734,true,C-l-0 C-l-2 C-m-0 C-m-1 C-l-1 
job-8533,1,8,7,426418,426460,426534,42,74,426594,true,L-m-0 L-m-0 C-m-2 C-m-2 C-m-0 C-m-0 C-m-1 
job-8534,2,6,3,426474,426474,426576,0,102,426788,true,L-m-0 L-m-0 C-m-2 
job-8535,2,4,6,426518,426518,426591,0,73,426799,true,L-m-0 C-m-2 C-m-2 C-m-0 C-m-0 C-m-0 
job-8537,3,8,6,426594,426594,426611,0,17,426713,true,L-m-0 L-m-0 C-s-0 C-s-2 C-m-2 C-m-2 
job-8538,3,7,3,426640,426640,426678,0,38,426701,true,L-m-0 L-m-0 C-s-0 
job-8539,1,11,5,426690,426690,426753,0,63,426772,true,L-m-0 L-m-0 C-s-0 C-s-2 C-m-2 
job-8540,3,11,6,426746,426746,426943,0,197,427155,true,C-m-2 C-m-0 C-m-0 C-m-1 C-m-1 C-l-0 
job-8536,4,4,5,426560,426560,426993,0,433,427099,true,L-s-0 L-l-0 L-l-0 L-l-0 C-s-1 
job-8543,4,4,5,426893,426893,427011,0,118,427304,true,L-m-0 C-s-0 C-s-2 C-l-2 C-l-2 
job-8541,2,9,5,426799,426799,427011,0,212,427213,true,C-m-0 C-m-1 C-m-2 C-m-2 C-l-0 
job-8544,6,9,3,426944,426944,427019,0,75,427274,true,C-m-0 C-m-1 C-l-1 
job-8542,3,7,3,426856,426856,427050,0,194,427060,true,C-l-0 C-l-0 L-m-0 
job-8545,1,12,2,426998,426998,427081,0,83,427176,true,L-m-0 C-m-2 
job-8548,6,4,7,427163,427163,427218,0,55,427233,true,L-m-0 L-l-0 C-m-2 C-m-0 C-m-1 C-l-0 C-l-0 
job-8546,1,10,8,427057,427057,427272,0,215,427516,true,L-m-0 L-m-0 C-m-2 C-m-2 L-s-0 L-l-0 L-l-0 L-l-0 
job-8549,2,4,4,427232,427232,427272,0,40,427353,true,L-m-0 L-m-0 L-m-0 L-l-0 
job-8551,4,12,2,427353,427353,427374,0,21,427382,true,L-l-0 L-l-0 
job-8547,2,6,1,427103,427103,427378,0,275,427576,true,L-s-0 
job-8550,2,6,4,427290,427290,427460,0,170,427512,true,L-s-0 L-m-0 L-m-0 L-m-0 
job-8552,6,4,8,427399,427399,427575,0,176,427872,true,L-l-0 L-l-0 C-m-2 C-m-0 C-m-1 C-l-0 C-l-0 C-l-2 
job-8555,6,8,5,427537,427575,427586,38,11,427822,true,C-l-0 C-l-2 C-l-2 C-l-1 C-l-1 
job-8553,5,5,7,427444,427575,427621,131,46,427511,false,L-m-0 L-l-0 L-l-0 C-m-2 C-m-0 C-m-1 C-l-0 
job-8554,3,7,1,427491,427575,427633,84,58,427789,true,L-m-0 
job-8558,5,11,6,427677,427677,427696,0,19,427983,true,L-m-0 C-l-2 L-l-0 L-l-0 C-m-2 C-m-0 
job-8557,3,5,2,427629,427629,427762,0,133,427775,true,L-m-0 C-l-0 
job-8556,5,7,2,427585,427586,427820,1,234,427860,true,C-l-0 C-l-2 
job-8560,6,10,7,427774,427774,427830,0,56,427947,true,L-l-0 L-l-0 C-m-2 C-m-0 C-m-1 C-l-1 C-l-1 
job-8559,2,9,8,427717,427717,427908,0,191,428162,true,L-m-0 L-m-0 C-l-0 C-l-0 C-l-2 C-l-2 C-l-2 L-s-0 
job-8562,2,10,4,427872,427872,427956,0,84,428107,true,C-m-2 C-m-2 C-l-2 C-l-2 
job-8561,2,11,2,427828,427828,428037,0,209,428266,true,L-m-0 C-m-2 
job-8564,6,8,8,427974,427974,428041,0,67,428320,true,C-m-2 L-l-0 L-l-0 C-m-0 C-m-1 C-l-0 C-l-0 C-l-1 
job-8565,1,8,3,428028,428028,428066,0,38,428326,true,L-s-0 C-m-0 C-m-0 
job-8563,2,7,8,427921,427921,428116,0,195,428175,true,L-m-0 L-m-0 L-m-0 C-l-2 C-l-2 C-l-2 C-l-2 L-s-0 
job-8566,5,10,6,428093,428093,428116,0,23,428154,true,L-l-0 L-l-0 C-m-2 C-m-0 C-m-1 C-l-0 
job-8567,5,10,2,428141,428141,428226,0,85,428405,true,L-m-0 L-l-0 
job-8568,4,7,3,428191,428191,428239,0,48,428258,true,L-l-0 L-s-0 C-s-0 
job-8569,1,9,5,428239,428239,428394,0,155,428640,true,L-s-0 L-m-0 L-m-0 L-m-0 L-l-0 
job-8572,6,11,7,428376,428376,428457,0,81,428642,true,C-m-2 C-m-0 C-m-1 C-l-2 C-l-2 C-l-0 C-l-0 
job-8570,5,5,2,428284,428284,428474,0,190,428645,true,L-m-0 L-l-0 
job-8573,2,10,2,428417,428417,428565,0,148,428717,true,L-s-0 L-m-0 
job-8574,6,6,5,428475,428475,428580,0,105,428813,true,L-m-0 L-l-0 C-m-2 C-m-0 C-m-1 
job-8571,1,4,3,428332,428332,428591,0,259,428828,true,L-s-0 L-l-0 L-l-0 
job-8575,4,8,6,428517,428517,428669,0,152,428680,true,L-l-0 C-s-0 C-s-2 C-s-1 C-l-2 C-l-2 
job-8578,3,6,1,428667,428667,428694,0,27,428781,true,C-m-2 
job-8576,2,7,6,428565,428565,428694,0,129,428767,true,L-s-0 L-m-0 C-m-2 C-m-0 C-m-1 C-l-2 
job-8577,2,9,6,428613,428613,428719,0,106,428758,true,L-s-0 L-m-0 L-m-0 L-l-0 L-l-0 L-l-0 
job-8580,4,10,1,428766,428766,428792,0,26,428794,true,C-s-0 
job-8579,3,7,7,428725,428725,428873,0,148,428885,true,L-s-0 L-m-0 L-m-0 L-l-0 L-l-0 L-l-0 L-l-0 
job-8582,4,5,8,428874,428874,428894,0,20,429163,true,L-m-0 L-s-0 L-l-0 L-l-0 L-l-0 C-m-2 C-m-2 C-m-0 
job-8581,1,10,4,428811,428811,428912,0,101,429006,true,L-m-0 C-s-0 C-s-2 C-s-1 
job-8583,5,8,1,428926,428926,429029,0,103,429035,true,L-m-0 
job-8584,4,12,7,428971,428971,429045,0,74,429150,true,L-s-0 L-l-0 L-l-0 L-l-0 C-s-0 C-s-2 C-s-1 
job-8585,4,9,6,429017,429017,429073,0,56,429237,true,C-m-2 C-m-2 C-m-0 C-m-0 C-m-1 C-m-1 
job-8586,2,9,1,429059,429059,429125,0,66,429397,true,L-s-0 
job-8587,2,12,5,429102,429102,429164,0,62,429311,true,L-m-0 L-m-0 L-l-0 L-l-0 L-l-0 
job-8588,6,6,7,429154,429154,429175,0,21,429433,true,L-l-0 C-m-2 C-m-0 C-m-1 C-l-2 C-l-2 C-l-0 
job-8589,3,4,1,429217,429217,429276,0,59,429346,true,L-s-0 
job-8590,2,12,7,429273,429273,429329,0,56,429354,true,L-m-0 L-m-0 L-l-0 L-l-0 L-l-0 L-l-0 C-s-0 
job-8592,2,5,2,429367,429367,429419,0,52,429526,true,L-m-0 L-m-0 
job-8593,5,5,2,429421,429421,429448,0,27,429576,true,L-m-0 L-l-0 
job-8591,1,7,6,429314,429314,429462,0,148,429529,true,L-m-0 L-s-0 L-s-0 C-s-2 C-s-2 C-s-1 
job-8594,4,6,7,429461,429461,429508,0,47,429604,true,L-m-0 L-l-0 L-l-0 L-l-0 C-s-0 C-m-2 C-m-2 
job-8596,6,7,3,429554,429554,429645,0,91,429803,true,L-m-0 L-l-0 L-l-0 
job-8597,3,5,1,429594,429594,429663,0,69,429931,true,C-s-2 
job-8595,1,5,3,429508,429508,429705,0,197,429777,true,L-s-0 L-s-0 L-s-0 
job-8598,3,8,8,429647,429647,429707,0,60,429745,true,L-m-0 L-m-0 L-l-0 L-l-0 L-l-0 L-l-0 C-s-1 C-s-0 
job-8600,2,10,1,429739,429739,429798,0,59,429836,true,L-m-0 
job-8599,1,5,7,429703,429703,429823,0,120,430095,true,L-m-0 L-m-0 C-s-1 C-s-0 C-s-2 C-s-2 C-s-2 
job-8601,1,11,1,429781,429781,429841,0,60,430074,true,L-m-0 
job-8603,3,5,2,429879,429879,429915,0,36,429989,true,L-m-0 C-m-2 
job-8604,5,9,1,429923,429923,429956,0,33,430037,true,C-m-1 
job-8602,5,4,5,429830,429830,430099,0,269,430237,true,L-m-0 L-l-0 L-l-0 C-m-2 C-m-0 
job-8607,5,4,5,430096,430096,430117,0,21,430368,true,C-l-2 C-l-2 C-l-0 C-l-0 C-l-1 
job-8605,3,5,7,429985,429985,430151,0,166,430231,true,L-m-0 C-m-2 C-m-0 L-s-0 C-s-2 C-s-1 C-s-0 
job-8608,2,9,3,430157,430157,430173,0,16,430259,true,L-l-0 L-l-0 L-l-0 
job-8611,1,4,2,430289,430289,430305,0,16,430409,true,L-s-0 L-m-0 
job-8609,1,11,1,430207,430207,430330,0,123,430539,true,L-l-0 
job-8606,2,9,4,430036,430036,430337,0,301,430588,true,L-l-0 C-m-1 C-m-1 C-m-1 
job-8613,1,11,8,430375,430375,430394,0,19,430600,true,L-l-0 L-l-0 C-s-2 C-s-1 C-s-0 C-m-1 C-m-1 C-m-2 
job-8612,1,7,2,430336,430336,430445,0,109,430688,true,L-m-0 L-m-0 
job-8614,4,7,2,430426,430426,430490,0,64,430531,true,L-l-0 C-s-2 
job-8610,3,10,4,430241,430241,430497,0,256,430764,true,L-l-0 L-l-0 L-s-0 L-m-0 
job-8615,1,12,1,430470,430470,430546,0,76,430704,true,L-m-0 
job-8617,6,10,7,430572,430572,430633,0,61,430846,true,L-l-0 C-m-1 C-m-2 C-m-0 C-l-2 C-l-2 C-l-0 
job-8618,2,10,8,430625,430625,430638,0,13,430764,true,L-m-0 L-m-0 L-l-0 C-m-1 C-m-2 C-m-0 C-l-0 C-l-0 
job-8616,4,4,3,430514,430514,430699,0,185,430931,true,L-m-0 L-s-0 L-l-0 
job-8621,5,11,7,430771,430771,430795,0,24,430917,true,L-m-0 C-l-2 C-l-2 C-l-0 C-l-0 C-l-1 C-l-1 
job-8619,5,9,4,430682,430682,430839,0,157,430862,true,L-l-0 C-m-1 C-m-2 C-m-0 
job-8620,2,9,5,430727,430727,430868,0,141,431149,true,L-l-0 L-l-0 L-l-0 C-m-1 C-m-2 
job-8623,4,8,5,430882,430882,430898,0,16,430917,true,C-m-0 L-m-0 L-m-0 L-l-0 L-l-0 
job-8622,3,9,2,430828,430828,430950,0,122,431212,true,C-m-0 L-s-0 
job-8625,3,8,7,430990,430990,431032,0,42,431033,true,L-s-0 C-s-2 C-s-1 C-s-0 C-m-0 C-m-0 C-l-0 
job-8624,6,7,7,430941,430941,431050,0,109,431165,true,L-m-0 L-l-0 L-l-0 C-m-1 C-m-2 C-l-2 C-l-2 
job-8626,2,4,2,431038,431038,431093,0,55,431229,true,L-m-0 C-m-1 
job-8627,5,7,4,431084,431084,431240,0,156,431304,true,L-m-0 C-m-1 L-l-0 L-l-0 
job-8629,1,6,7,431189,431189,431294,0,105,431433,true,L-m-0 L-m-0 L-m-0 L-l-0 L-l-0 C-m-1 C-m-1 
job-8630,5,7,7,431237,431240,431336,3,96,431398,true,L-m-0 L-l-0 L-l-0 C-m-1 C-l-2 C-l-2 C-l-0 
job-8628,5,5,2,431138,431138,431429,0,291,431627,true,C-m-2 C-m-0 
job-8633,4,8,6,431389,431389,431439,0,50,431492,true,L-s-0 L-l-0 L-l-0 L-l-0 C-s-2 C-s-1 
job-8632,2,5,1,431340,431340,431441,0,101,431500,true,L-m-0 
job-8634,2,5,3,431434,431434,431522,0,88,431522,false,L-m-0 C-s-0 C-s-0 
job-8631,3,7,1,431295,431295,431590,0,295,431677,true,L-m-0 
job-8636,3,8,7,431525,431525,431618,0,93,431901,true,L-m-0 C-s-0 C-s-2 C-s-1 C-m-2 C-m-2 C-m-0 
job-8635,2,4,8,431484,431484,431744,0,260,431857,true,L-m-0 L-s-0 L-s-0 L-l-0 L-l-0 L-l-0 L-l-0 L-l-0 
job-8637,5,6,8,431571,431571,431771,0,200,431958,true,C-m-0 C-m-1 C-l-2 C-l-2 C-l-0 C-l-0 C-l-1 C-l-1 
job-8640,1,9,2,431731,431771,431785,40,14,431798,true,L-m-0 L-m-0 
job-8639,6,12,7,431669,431771,431793,102,22,431898,true,C-m-0 C-m-1 C-m-2 C-l-2 C-l-2 C-l-0 C-l-0 
job-8638,6,6,3,431616,431744,431863,128,119,432022,true,L-m-0 L-l-0 L-l-0 
job-8642,6,12,6,431844,431844,431882,0,38,432008,true,C-l-2 C-l-2 C-l-0 C-l-0 C-l-1 C-l-1 
job-8641,5,7,3,431781,431793,431962,12,169,432099,true,C-m-0 C-m-1 C-m-2 
job-8646,2,9,3,432036,432036,432088,0,52,432110,true,L-m-0 L-l-0 C-m-0 
job-8645,6,6,1,431994,431994,432109,0,115,432301,true,C-m-0 
job-8643,5,7,5,431902,431902,432130,0,228,432325,true,L-m-0 L-l-0 L-l-0 C-l-2 C-l-2 
job-8644,4,4,6,431944,431944,432142,0,198,432233,true,L-s-0 C-s-0 C-s-2 C-s-1 C-l-0 C-l-0 
job-8647,6,12,5,432102,432109,432226,7,117,432416,true,C-m-0 C-m-1 C-m-2 C-l-1 C-l-1 
job-8648,1,4,2,432149,432149,432226,0,77,432294,true,C-m-0 C-m-0 
job-8649,5,8,7,432203,432203,432227,0,24,432408,true,L-m-0 L-l-0 L-l-0 C-l-2 C-l-2 C-l-0 C-l-0 
job-8650,4,9,8,432252,432252,432274,0,22,432373,true,L-s-0 L-m-0 L-m-0 L-l-0 L-l-0 L-l-0 C-s-0 C-s-2 
job-8651,4,9,3,432299,432299,432349,0,50,432395,true,L-s-0 L-m-0 L-m-0 
job-8653,4,9,2,432404,432404,432445,0,41,432465,true,L-l-0 L-s-0 
job-8652,6,8,2,432352,432352,432451,0,99,432738,true,L-m-0 L-l-0 
job-8655,1,6,6,432520,432520,432534,0,14,432743,true,L-m-0 L-m-0 C-m-0 C-m-0 C-m-1 C-m-1 
job-8654,6,11,6,432456,432456,432544,0,88,432698,true,L-m-0 L-l-0 L-l-0 C-m-0 C-m-1 C-m-2 
job-8656,6,10,6,432570,432570,432581,0,11,432638,true,L-m-0 L-l-0 L-l-0 C-m-0 C-m-1 C-m-2 
job-8658,5,9,4,432666,432666,432716,0,50,432946,true,C-l-1 C-l-2 C-l-2 C-l-0 
job-8659,3,9,6,432716,432716,432732,0,16,432878,true,L-m-0 C-m-0 C-m-1 C-m-2 C-l-1 C-l-1 
job-8657,5,8,7,432614,432614,432765,0,151,432826,true,L-m-0 L-l-0 L-l-0 C-m-0 C-m-1 C-m-2 C-l-1 
job-8660,4,7,1,432765,432765,432791,0,26,432857,true,L-s-0 
job-8662,4,12,3,432861,432861,432927,0,66,433141,true,L-s-0 C-s-0 C-s-2 
job-8663,3,4,5,432919,432919,432974,0,55,433239,true,C-s-1 C-m-2 C-m-2 C-l-1 C-l-1 
job-8664,1,11,4,432979,432979,433090,0,111,433269,true,L-m-0 L-m-0 C-m-0 C-m-0 
job-8661,6,9,5,432807,432807,433094,0,287,433215,true,L-m-0 L-l-0 L-l-0 C-m-0 C-m-1 
job-8665,2,7,3,433032,433032,433112,0,80,433385,true,C-m-1 L-s-0 L-s-0 
job-8667,1,7,7,433113,433113,433129,0,16,433136,true,C-m-2 C-l-1 C-l-1 C-l-1 C-l-1 C-l-1 L-s-0 
job-8666,3,11,6,433074,433074,433184,0,110,433232,true,C-s-0 C-s-2 C-s-1 C-m-2 C-m-2 C-l-1 
job-8668,2,9,7,433159,433159,433242,0,83,433326,true,C-m-2 C-l-1 C-l-1 C-l-1 C-l-1 L-s-0 L-m-0 
job-8669,1,4,5,433211,433211,433284,0,73,433328,true,L-s-0 L-m-0 L-m-0 L-m-0 L-m-0 
job-8671,2,6,4,433307,433307,433371,0,64,433427,true,L-s-0 L-m-0 L-m-0 L-l-0 
job-8672,3,5,2,433357,433357,433520,0,163,433731,true,L-l-0 C-s-0 
job-8673,6,8,4,433401,433401,433529,0,128,433561,true,C-m-2 C-m-0 C-m-1 C-l-1 
job-8675,3,11,8,433499,433529,433548,30,19,433758,true,L-m-0 L-l-0 L-l-0 C-l-1 C-l-1 C-s-0 C-s-2 C-s-1 
job-8670,2,7,6,433260,433260,433607,0,347,433881,true,L-s-0 L-m-0 L-m-0 L-l-0 L-l-0 L-l-0 
job-8676,4,9,3,433553,433553,433644,0,91,433650,true,L-m-0 L-l-0 C-l-1 
job-8678,3,6,7,433651,433651,433673,0,22,433716,true,L-l-0 L-l-0 C-m-2 C-m-0 C-m-1 C-l-1 C-l-1 
job-8674,6,4,5,433455,433455,433690,0,235,433854,true,C-l-1 C-l-2 C-l-2 C-l-0 C-l-0 
job-8677,5,8,4,433599,433607,433753,8,146,434026,true,L-l-0 C-m-2 C-m-0 C-m-1 
job-8680,4,11,2,433761,433761,433778,0,17,433798,true,L-l-0 L-l-0 
job-8681,3,9,4,433813,433813,433835,0,22,433855,true,L-l-0 L-l-0 C-s-1 C-m-2 
job-8679,4,8,6,433709,433709,433866,0,157,434016,true,L-l-0 L-s-0 L-m-0 L-m-0 C-s-0 C-s-2 
job-8682,4,6,1,433859,433859,433929,0,70,434223,true,L-l-0 
job-8684,3,11,7,433956,433956,434016,0,60,434279,true,L-m-0 L-l-0 L-l-0 C-m-2 C-m-0 C-m-1 C-l-2 
job-8683,5,10,6,433912,433912,434044,0,132,434059,true,L-l-0 L-m-0 C-m-2 C-m-0 C-m-1 C-l-2 
job-8686,2,10,6,434050,434050,434106,0,56,434206,true,L-m-0 L-l-0 C-m-2 C-m-0 C-m-1 C-l-2 
job-8685,5,10,7,434009,434044,434225,35,181,434346,true,L-m-0 L-l-0 L-l-0 C-m-2 C-m-0 C-m-1 C-l-2 
job-8688,4,12,8,434145,434225,434257,80,32,434219,false,L-s-0 C-s-0 C-s-2 C-s-1 C-l-0 C-l-0 C-l-0 C-l-1 
job-8687,5,4,8,434097,434225,434271,128,46,434265,false,L-m-0 L-l-0 L-l-0 C-m-2 C-m-0 C-m-1 C-l-2 C-l-2 
job-8689,4,10,4,434200,434257,434271,57,14,434285,true,L-s-0 C-s-0 C-s-2 C-s-1 
job-8690,3,4,5,434244,434257,434292,13,35,434314,true,L-m-0 C-m-2 C-m-0 C-m-1 C-l-0 
job-8691,2,9,6,434277,434277,434371,0,94,434385,true,L-m-0 L-m-0 C-m-2 C-m-2 C-m-0 C-m-0 
job-8692,4,6,2,434325,434325,434413,0,88,434660,true,L-m-0 C-m-2 
job-8693,3,6,6,434382,434382,434540,0,158,434729,true,L-m-0 C-m-2 L-s-0 L-l-0 L-l-0 L-l-0 
job-8696,4,6,1,434524,434524,434559,0,35,434621,true,C-m-1 
job-8695,3,11,6,434468,434468,434688,0,220,434930,true,L-l-0 C-m-0 C-s-0 C-s-2 C-s-1 C-m-1 
job-8698,3,10,2,434614,434614,434688,0,74,434898,true,C-m-2 C-m-1 
job-8694,5,6,3,434435,434435,434717,0,282,434962,true,L-m-0 C-m-2 C-m-0 
job-8699,1,5,2,434658,434658,434725,0,67,434976,true,L-m-0 L-l-0 
job-8701,3,12,8,434766,434766,434785,0,19,435013,true,L-m-0 L-m-0 L-l-0 L-s-0 C-s-0 C-s-2 C-s-1 C-m-0 
job-8702,6,12,2,434813,434813,434828,0,15,435103,true,L-m-0 C-m-0 
job-8700,1,10,1,434709,434709,434864,0,155,435163,true,L-l-0 
job-8697,2,4,5,434570,434570,434899,0,329,435166,true,L-m-0 L-l-0 L-l-0 L-l-0 L-l-0 
job-8704,6,6,8,434906,434906,434940,0,34,434979,true,L-l-0 L-l-0 C-m-0 C-m-2 C-m-1 C-l-0 C-l-0 C-l-2 
job-8703,2,7,3,434854,434854,434954,0,100,435022,true,L-m-0 L-m-0 L-m-0 
job-8705,1,11,4,434962,434962,435100,0,138,435302,true,L-s-0 L-m-0 L-m-0 L-l-0 
job-8707,2,10,7,435074,435074,435146,0,72,435318,true,C-s-2 C-s-1 C-m-0 C-m-0 C-m-0 C-m-2 C-m-2 
job-8708,2,6,2,435120,435120,435226,0,106,435405,true,L-m-0 L-m-0 
job-8709,5,7,4,435181,435181,435308,0,127,435312,true,L-l-0 C-m-0 C-m-2 C-m-1 
job-8711,2,4,2,435284,435284,435326,0,42,435603,true,L-m-0 L-l-0 
job-8706,1,7,8,435007,435007,435335,0,328,435451,true,L-m-0 L-l-0 L-l-0 L-l-0 L-l-0 L-l-0 C-s-0 C-s-0 
job-8710,4,4,8,435232,435232,435357,0,125,435587,true,L-m-0 L-s-0 C-s-2 C-s-1 C-l-0 C-l-0 C-l-0 C-l-2 
job-8713,5,11,4,435364,435364,435385,0,21,435450,true,L-l-0 L-m-0 C-m-0 C-m-2 
job-8712,4,9,1,435324,435324,435393,0,69,435558,true,L-l-0 
job-8714,3,8,8,435422,435422,435569,0,147,435809,true,L-s-0 L-m-0 L-m-0 L-l-0 L-l-0 L-l-0 L-l-0 C-s-0 
job-8716,6,12,7,435535,435535,435651,0,116,435784,true,C-m-1 C-l-0 C-l-0 C-l-2 C-l-2 C-l-1 C-l-1 
job-8718,5,9,5,435630,435651,435696,21,45,435691,false,C-l-0 C-l-0 C-l-2 C-l-2 C-l-1 
job-8715,5,11,2,435488,435488,435722,0,234,435852,true,C-m-0 C-m-2 
job-8719,6,8,2,435682,435696,435763,14,67,435979,true,C-l-0 C-l-0 
job-8723,1,12,4,435856,435856,435923,0,67,436165,true,L-l-0 L-l-0 C-l-2 C-l-0 
job-8724,1,11,2,435899,435899,435931,0,32,436103,true,C-l-0 C-l-1 
job-8722,5,11,3,435810,435810,435961,0,151,436239,true,C-l-0 C-l-0 C-l-1 
job-8720,5,9,3,435727,435727,436000,0,273,436233,true,C-m-0 C-m-2 C-l-2 
job-8725,3,5,3,435946,435946,436023,0,77,436306,true,C-l-1 C-l-1 C-s-2 
job-8726,3,5,6,435996,435996,436042,0,46,436286,true,C-l-1 C-l-1 C-s-1 C-l-0 C-l-0 C-l-0 
job-8721,3,9,8,435767,435767,436064,0,297,436312,true,L-m-0 C-m-0 C-m-2 C-m-1 C-l-2 C-l-2 L-s-0 C-s-0 
job-8727,4,11,4,436038,436038,436116,0,78,436141,true,C-m-0 C-m-2 C-l-2 C-l-1 
job-8728,6,10,5,436083,436116,436138,33,22,436108,false,C-m-0 C-m-2 C-l-2 C-l-2 C-l-1 
job-8717,5,4,4,435580,435651,436148,71,497,436092,false,L-m-0 L-l-0 L-l-0 C-m-1 
job-8729,4,12,6,436124,436124,436210,0,86,436481,true,C-l-1 L-s-0 C-s-0 C-s-1 C-s-2 C-l-0 
job-8730,2,12,2,436167,436167,436250,0,83,436477,true,C-l-1 C-l-1 
job-8731,5,6,3,436218,436218,436278,0,60,436480,true,C-l-1 L-m-0 L-l-0 
job-8732,4,7,4,436256,436256,436281,0,25,436374,true,L-l-0 C-l-1 L-s-0 C-s-0 
job-8733,2,4,4,436309,436309,436504,0,195,436786,true,L-s-0 L-s-0 L-m-0 L-m-0 
job-8734,1,7,5,436363,436363,436653,0,290,436900,true,L-m-0 L-m-0 L-m-0 L-l-0 L-l-0 
job-8735,5,11,6,436424,436424,436666,0,242,436705,true,L-l-0 L-l-0 C-m-0 C-m-2 C-m-1 C-l-1 
job-8737,4,4,3,436514,436666,436687,152,21,436809,true,C-l-1 L-s-0 C-s-0 
job-8739,1,10,6,436617,436666,436701,49,35,436655,false,L-m-0 C-m-0 C-m-0 C-m-2 C-m-2 C-m-1 
job-8736,5,12,7,436463,436666,436731,203,65,436817,true,L-m-0 L-l-0 L-l-0 C-m-0 C-m-2 C-m-1 C-l-1 
job-8740,6,8,1,436670,436670,436740,0,70,436942,true,C-l-0 
job-8741,3,11,2,436715,436715,436886,0,171,437068,true,C-m-0 C-m-2 
job-8744,2,11,7,436866,436866,436928,0,62,437158,true,C-l-0 C-l-0 L-s-0 C-s-0 C-s-1 C-s-2 C-l-2 
job-8743,2,5,8,436820,436820,437002,0,182,437070,true,L-l-0 L-l-0 C-m-1 C-m-0 C-m-0 C-m-2 C-m-2 C-l-0 
job-8742,6,10,6,436765,436765,437079,0,314,437354,true,L-m-0 L-l-0 C-m-1 C-l-1 C-l-1 C-l-0 
job-8747,4,12,4,437008,437079,437122,71,43,437299,true,C-m-0 C-m-2 C-s-2 C-l-2 
job-8749,1,10,4,437117,437117,437127,0,10,437179,true,L-m-0 C-m-1 C-m-1 C-l-1 
job-8746,5,10,7,436964,437079,437158,115,79,437295,true,L-m-0 L-l-0 L-l-0 C-l-0 C-m-1 C-l-1 C-l-1 
job-8748,4,5,2,437062,437079,437189,17,110,437355,true,C-l-2 C-l-2 
job-8750,2,10,5,437173,437173,437209,0,36,437308,true,L-m-0 L-m-0 L-l-0 L-l-0 L-l-0 
job-8751,5,12,5,437218,437218,437269,0,51,437552,true,L-m-0 L-l-0 L-l-0 C-l-0 C-m-1 
job-8745,4,8,6,436917,436928,437275,11,347,437349,true,C-m-0 C-m-2 C-l-0 L-s-0 C-s-0 C-s-1 
job-8752,4,12,1,437271,437271,437297,0,26,437568,true,L-m-0 
job-8738,2,6,2,436563,436666,437332,103,666,437339,true,L-m-0 L-l-0 
job-8755,2,11,1,437422,437422,437479,0,57,437602,true,C-s-2 
job-8754,2,4,8,437380,437380,437567,0,187,437687,true,L-m-0 L-l-0 L-l-0 L-l-0 C-s-0 C-s-0 C-s-1 C-s-1 
job-8753,3,8,5,437334,437334,437579,0,245,437874,true,L-s-0 L-m-0 L-m-0 L-l-0 L-l-0 
job-8758,1,12,7,437569,437569,437590,0,21,437690,true,L-m-0 L-l-0 L-l-0 C-m-1 C-m-1 C-m-0 C-m-0 
job-8757,6,4,6,437528,437528,437638,0,110,437710,true,C-m-1 C-l-0 C-l-0 C-l-2 C-l-2 C-l-1 
job-8759,6,4,8,437617,437638,437651,21,13,437888,true,L-m-0 L-l-0 L-l-0 C-m-1 C-l-0 C-l-0 C-l-2 C-l-2 
job-8756,5,6,2,437476,437476,437691,0,215,437965,true,C-m-0 C-m-2 
job-8760,1,12,1,437675,437675,437704,0,29,437818,true,C-m-0 
job-8762,2,6,3,437764,437764,437782,0,18,438001,true,L-s-0 L-l-0 L-l-0 
job-8761,1,9,4,437721,437721,437829,0,108,438051,true,L-s-0 L-m-0 L-m-0 L-m-0 
job-8763,4,6,7,437830,437830,437889,0,59,437948,true,L-s-0 L-m-0 L-m-0 L-l-0 L-l-0 L-l-0 C-s-0 
job-8766,2,7,3,437980,437980,438006,0,26,438127,true,L-s-0 L-s-0 L-m-0 
job-8765,2,5,5,437925,437925,438032,0,107,438278,true,C-s-1 C-s-2 C-m-2 C-m-2 C-m-2 
job-8768,2,8,5,438093,438093,438114,0,21,438265,true,C-m-2 C-s-0 C-s-0 C-m-1 C-m-1 
job-8767,4,12,7,438037,438037,438123,0,86,438171,true,C-m-2 L-s-0 L-m-0 L-m-0 L-l-0 L-l-0 L-l-0 
job-8764,2,10,6,437875,437875,438136,0,261,438382,true,C-s-1 C-s-2 C-m-0 C-m-0 C-m-0 C-m-2 
job-8769,1,10,2,438153,438153,438268,0,115,438500,true,L-s-0 L-m-0 
job-8771,5,9,1,438243,438243,438293,0,50,438300,true,C-m-0 
job-8770,4,9,3,438196,438196,438297,0,101,438356,true,L-m-0 L-l-0 L-l-0 
job-8772,4,7,6,438291,438291,438312,0,21,438508,true,L-m-0 L-l-0 L-s-0 C-s-1 C-s-2 C-s-0 
job-8773,1,9,1,438348,438348,438443,0,95,438573,true,L-s-0 
job-8774,5,8,4,438405,438405,438556,0,151,438715,true,L-m-0 L-l-0 L-l-0 C-m-0 
job-8775,2,8,5,438450,438450,438556,0,106,438592,true,L-m-0 L-l-0 C-m-0 L-s-0 L-s-0 
job-8776,3,12,8,438508,438508,438596,0,88,438652,true,C-s-1 C-s-2 C-s-0 C-m-2 C-m-2 C-m-1 C-m-1 C-l-0 
job-8777,1,7,2,438560,438560,438626,0,66,438701,true,C-m-2 C-m-1 
job-8779,3,12,2,438661,438661,438682,0,21,438891,true,C-m-1 L-s-0 
job-8778,1,6,6,438612,438612,438702,0,90,438721,true,C-m-2 C-m-2 C-m-2 C-m-2 C-m-1 C-m-1 
job-8781,4,6,1,438752,438752,438822,0,70,438978,true,C-s-1 
job-8783,5,9,6,438842,438842,438863,0,21,438871,true,C-m-1 C-m-0 C-l-0 C-l-0 C-l-2 C-l-2 
job-8780,4,9,6,438703,438703,438890,0,187,438908,true,L-s-0 L-m-0 L-m-0 L-l-0 L-l-0 L-l-0 
job-8784,6,10,7,438874,438874,438893,0,19,438941,true,C-m-1 C-m-0 C-l-0 C-l-0 C-l-2 C-l-2 C-l-1 
job-8782,1,9,6,438806,438806,438894,0,88,439099,true,C-s-2 C-s-0 C-m-2 C-m-2 C-m-2 C-m-1 
job-8785,5,6,8,438918,438918,438936,0,18,438993,true,L-m-0 L-l-0 L-l-0 C-m-2 C-m-1 C-m-0 C-l-0 C-l-0 
job-8786,3,4,3,438961,438961,438981,0,20,439257,true,L-s-0 L-m-0 L-m-0 
job-8790,3,10,3,439147,439147,439158,0,11,439385,true,L-m-0 L-s-0 C-s-2 
job-8789,6,4,3,439103,439103,439182,0,79,439362,true,L-l-0 C-m-2 C-m-1 
job-8788,5,12,1,439052,439052,439263,0,211,439495,true,L-l-0 
job-8791,5,4,6,439193,439193,439272,0,79,439278,true,L-l-0 C-m-2 C-m-1 C-m-0 C-l-0 C-l-0 
job-8787,5,12,1,439007,439007,439337,0,330,439352,true,L-m-0 
job-8792,4,9,6,439239,439239,439343,0,104,439375,true,L-s-0 C-s-2 C-s-0 C-s-1 C-l-2 C-l-2 
job-8794,6,11,1,439345,439345,439395,0,50,439395,false,C-l-2 
job-8795,3,8,1,439399,439399,439444,0,45,439503,true,L-m-0 
job-8796,5,8,3,439449,439449,439543,0,94,439715,true,L-m-0 C-l-2 L-l-0 
job-8798,2,9,5,439530,439530,439575,0,45,439845,true,L-l-0 L-s-0 C-s-2 C-s-0 C-s-1 
job-8799,2,11,3,439580,439580,439614,0,34,439853,true,L-m-0 L-l-0 L-l-0 
job-8800,4,8,6,439642,439642,439718,0,76,439736,true,L-m-0 L-l-0 L-l-0 C-l-2 L-s-0 C-s-2 
job-8801,1,6,7,439699,439699,439731,0,32,439848,true,L-m-0 C-l-2 C-s-0 C-s-0 C-s-1 C-s-1 C-m-2 
job-8793,3,12,2,439277,439277,439753,0,476,439964,true,L-m-0 C-l-2 
job-8802,6,10,3,439740,439740,439761,0,21,439768,true,L-l-0 C-m-2 C-m-1 
job-8797,4,8,2,439492,439492,439771,0,279,439985,true,L-l-0 C-l-2 
job-8804,5,7,2,439844,439844,439899,0,55,440012,true,L-l-0 C-m-2 
job-8805,3,12,8,439896,439896,439969,0,73,440266,true,L-l-0 C-m-2 C-s-2 C-s-0 C-s-1 C-m-1 C-m-1 C-m-0 
job-8803,3,10,4,439793,439793,439997,0,204,440228,true,L-s-0 L-m-0 L-m-0 L-l-0 
job-8807,5,7,7,439991,439991,440011,0,20,440083,true,L-l-0 C-m-2 C-m-0 C-l-2 C-m-1 C-l-0 C-l-0 
job-8808,6,4,6,440043,440043,440080,0,37,440310,true,L-m-0 L-l-0 C-m-2 C-m-0 C-l-2 C-m-1 
job-8810,5,10,1,440131,440131,440157,0,26,440265,true,C-m-1 
job-8809,1,11,7,440086,440086,440161,0,75,440316,true,L-m-0 L-l-0 L-l-0 C-m-2 C-m-0 C-l-2 L-s-0 
job-8806,1,12,8,439947,439947,440169,0,222,440338,true,L-m-0 L-l-0 L-l-0 C-m-2 C-m-0 C-l-2 C-l-2 C-l-2 
job-8813,3,12,2,440278,440278,440315,0,37,440602,true,C-m-2 C-m-0 
job-8814,3,11,2,440327,440327,440350,0,23,440611,true,C-m-2 C-m-0 
job-8815,5,9,2,440368,440368,440425,0,57,440620,true,C-l-2 C-l-2 
job-8812,5,6,5,440235,440235,440444,0,209,440588,true,L-l-0 L-l-0 C-m-2 C-m-0 C-m-1 
job-8816,4,9,8,440413,440413,440477,0,64,440596,true,L-m-0 C-s-2 C-s-0 C-s-1 C-l-0 C-l-0 C-l-0 C-l-1 
job-8811,2,11,3,440191,440191,440533,0,342,440733,true,L-s-0 L-m-0 L-m-0 
job-8818,6,5,2,440515,440515,440606,0,91,440801,true,L-l-0 C-m-2 
job-8819,1,5,6,440576,440576,440624,0,48,440822,true,L-l-0 L-l-0 C-m-2 C-m-2 C-l-1 C-l-1 
job-8817,2,7,6,440464,440464,440656,0,192,440865,true,C-l-1 C-l-1 C-l-1 C-l-1 L-l-0 L-l-0 
job-8820,5,7,3,440625,440625,440727,0,102,440790,true,L-l-0 L-m-0 C-m-2 
job-8821,6,6,5,440674,440674,440795,0,121,440933,true,L-l-0 C-m-0 C-m-1 C-l-1 C-l-1 
job-8822,3,5,2,440721,440721,440831,0,110,441012,true,L-m-0 C-m-2 
job-8824,3,9,6,440828,440828,440855,0,27,441044,true,L-m-0 C-m-2 L-s-0 L-l-0 L-l-0 L-l-0 
job-8823,2,4,1,440765,440765,440866,0,101,441115,true,L-m-0 
job-8827,4,9,5,440969,440969,441004,0,35,441137,true,C-l-1 L-s-0 C-s-2 C-s-0 C-s-1 
job-8826,1,9,1,440916,440916,441076,0,160,441341,true,L-m-0 
job-8828,2,11,4,441013,441013,441144,0,131,441242,true,C-m-2 C-m-0 C-m-1 C-l-1 
job-8829,6,7,5,441050,441144,441192,94,48,441269,true,C-l-1 C-l-0 C-l-0 C-l-2 C-l-2 
job-8825,6,5,7,440873,440873,441200,0,327,441271,true,L-m-0 L-l-0 L-l-0 C-m-2 C-m-0 C-m-1 C-l-1 
job-8831,6,12,2,441152,441192,441223,40,31,441313,true,C-l-0 C-l-2 
job-8830,4,9,6,441096,441192,441223,96,31,441244,true,C-l-1 L-s-0 C-s-2 C-s-0 C-s-1 C-l-0 
job-8832,1,5,2,441211,441211,441225,0,14,441293,true,C-l-0 C-l-0 
job-8833,4,12,8,441267,441267,441330,0,63,441459,true,L-s-0 L-m-0 L-m-0 L-l-0 L-l-0 L-l-0 C-s-2 C-s-0 
job-8834,6,5,8,441325,441325,441386,0,61,441403,true,C-m-2 C-m-0 C-m-1 C-l-0 C-l-0 C-l-2 C-l-2 C-l-1 
job-8837,4,10,4,441461,441461,441501,0,40,441611,true,C-l-0 C-l-0 C-l-0 C-l-2 
job-8836,3,12,6,441407,441407,441516,0,109,441792,true,L-s-0 C-s-2 C-s-0 C-s-1 C-m-1 C-m-1 
job-8835,6,5,5,441361,441386,441537,25,151,441789,true,L-m-0 L-l-0 L-l-0 C-m-2 C-m-0 
job-8838,5,8,8,441509,441537,441564,28,27,441558,false,L-m-0 L-l-0 L-l-0 C-m-2 C-m-0 C-m-1 C-l-0 C-l-0 
job-8839,3,7,7,441558,441558,441603,0,45,441728,true,L-m-0 C-m-2 C-m-0 C-m-1 L-s-0 C-s-2 C-s-0 
job-8840,1,10,5,441608,441608,441621,0,13,441863,true,L-s-0 L-m-0 L-m-0 L-m-0 L-l-0 
job-8842,2,11,7,441717,441717,441731,0,14,441827,true,L-m-0 L-l-0 L-l-0 L-l-0 L-l-0 C-s-2 C-s-0 
job-8843,2,12,3,441763,441763,441803,0,40,442093,true,L-m-0 L-l-0 L-l-0 
job-8841,3,6,3,441668,441668,441814,0,146,441825,true,L-s-0 L-m-0 L-m-0 
job-8844,2,12,2,441818,441818,441898,0,80,442131,true,L-s-0 L-m-0 
job-8845,3,12,5,441874,441874,441936,0,62,442152,true,L-m-0 L-l-0 L-l-0 L-l-0 L-l-0 
job-8846,2,7,6,441915,441915,441948,0,33,441988,true,L-m-0 L-m-0 L-s-0 L-s-0 C-s-2 C-s-2 
job-8848,3,10,7,442016,442016,442033,0,17,442217,true,L-m-0 L-l-0 L-l-0 L-l-0 L-l-0 C-s-2 C-s-0 
job-8847,1,5,7,441967,441967,442074,0,107,442130,true,L-s-0 L-s-0 L-s-0 L-m-0 L-m-0 L-m-0 L-m-0 
job-8851,4,12,8,442168,442168,442198,0,30,442449,true,L-l-0 L-s-0 C-s-2 C-s-0 C-s-1 C-l-0 C-l-0 C-l-0 
job-8850,6,11,5,442120,442120,442266,0,146,442287,true,L-m-0 L-l-0 C-m-2 C-m-0 C-m-1 
job-8849,1,8,2,442072,442072,442272,0,200,442484,true,L-m-0 L-l-0 
job-8852,1,10,1,442234,442234,442283,0,49,442500,true,L-m-0 
job-8854,4,12,2,442347,442347,442392,0,45,442469,true,L-l-0 L-l-0 
job-8853,2,8,5,442290,442290,442419,0,129,442502,true,L-s-0 L-s-0 L-m-0 L-m-0 L-m-0 
job-8855,2,11,2,442397,442397,442421,0,24,442507,true,L-l-0 L-l-0 
job-8858,4,11,5,442531,442531,442544,0,13,442732,true,C-s-2 C-s-0 C-s-1 C-l-0 C-l-0 
job-8857,5,12,3,442495,442495,442584,0,89,442610,true,C-m-2 C-m-0 C-m-1 
job-8859,3,11,6,442579,442579,442628,0,49,442814,true,C-m-2 C-m-0 C-m-1 C-s-2 C-s-0 C-s-1 
job-8861,3,7,6,442677,442677,442695,0,18,442986,true,C-s-2 C-s-0 C-s-1 C-m-2 C-m-2 C-m-0 
job-8862,3,5,2,442718,442718,442749,0,31,442928,true,C-s-2 C-s-0 
job-8856,3,6,7,442458,442458,442767,0,309,442955,true,L-s-0 L-m-0 L-m-0 L-l-0 L-l-0 L-l-0 L-l-0 
job-8860,1,6,1,442624,442624,442862,0,238,443036,true,L-s-0 
job-8864,4,12,3,442823,442823,442916,0,93,443089,true,C-s-2 C-s-0 C-s-1 
job-8865,2,10,5,442877,442877,442917,0,40,442984,true,L-m-0 L-l-0 C-m-2 C-m-0 C-m-1 
job-8863,5,7,8,442770,442770,442924,0,154,443070,true,L-m-0 L-l-0 L-l-0 C-m-2 C-m-0 C-m-1 C-l-0 C-l-0 
job-8866,6,10,7,442934,442934,442995,0,61,443125,true,L-m-0 L-l-0 L-l-0 C-m-2 C-m-0 C-m-1 C-l-0 
job-8869,6,9,2,443075,443075,443139,0,64,443217,true,L-l-0 L-l-0 
job-8868,2,9,8,443028,443028,443187,0,159,443324,true,C-l-2 C-l-1 C-l-0 C-l-0 C-l-0 L-s-0 L-m-0 L-m-0 
job-8867,5,6,5,442976,442976,443213,0,237,443318,true,C-l-0 C-l-2 C-l-2 C-l-1 C-l-1 
job-8870,5,11,8,443135,443213,443230,78,17,443430,true,L-m-0 L-l-0 L-l-0 C-m-2 C-m-0 C-m-1 C-l-2 C-l-2 
job-8873,6,9,6,443282,443282,443307,0,25,443447,true,C-m-2 C-m-0 C-m-1 C-l-2 C-l-2 C-l-1 
job-8871,2,4,2,443186,443213,443329,27,116,443463,true,L-m-0 L-l-0 
job-8872,4,6,5,443231,443231,443376,0,145,443388,true,L-m-0 L-l-0 L-l-0 L-s-0 C-s-2 
job-8874,4,9,4,443336,443336,443400,0,64,443682,true,L-m-0 L-l-0 C-s-0 C-s-1 
job-8875,4,5,7,443386,443386,443497,0,111,443571,true,L-m-0 L-l-0 L-l-0 L-s-0 C-s-2 C-m-2 C-m-2 
job-8877,3,6,2,443480,443480,443499,0,19,443782,true,C-m-0 C-m-0 
job-8880,4,6,3,443630,443630,443651,0,21,443947,true,C-m-0 C-m-0 C-m-1 
job-8876,2,8,8,443441,443441,443659,0,218,443807,true,L-m-0 L-m-0 L-l-0 L-l-0 C-s-0 C-s-0 C-s-1 C-s-1 
job-8879,4,5,6,443581,443581,443741,0,160,443849,true,L-l-0 L-l-0 L-s-0 C-s-2 C-m-2 C-m-2 
job-8878,1,4,1,443528,443528,443780,0,252,444013,true,L-m-0 
job-8882,3,6,8,443726,443726,443805,0,79,444065,true,L-l-0 C-s-0 C-s-1 C-m-0 C-m-0 C-m-1 C-m-1 C-l-2 
job-8881,3,12,2,443668,443668,443841,0,173,444082,true,L-m-0 L-m-0 
job-8883,2,8,1,443770,443770,443892,0,122,444003,true,L-l-0 
job-8885,6,4,5,443878,443878,443965,0,87,444015,true,L-m-0 C-m-0 C-m-1 C-m-2 C-l-2 
job-8886,2,8,7,443937,443937,443991,0,54,444211,true,L-l-0 C-m-0 C-m-1 C-m-2 C-l-2 C-l-2 C-l-2 
job-8888,1,4,7,444045,444045,444062,0,17,444087,true,L-m-0 L-m-0 L-l-0 L-l-0 C-m-0 C-m-0 C-m-0 
job-8887,4,7,5,443991,443991,444128,0,137,444401,true,L-m-0 C-s-0 C-s-1 C-s-2 C-m-0 
job-8890,6,8,8,444145,444145,444189,0,44,444350,true,L-m-0 C-m-2 C-l-2 C-l-2 C-l-1 C-l-1 C-l-0 C-l-0 
job-8891,1,4,5,444203,444203,444223,0,20,444380,true,L-m-0 L-m-0 L-m-0 L-m-0 L-m-0 
job-8884,2,6,8,443830,443830,444249,0,419,444483,true,L-m-0 L-l-0 L-l-0 L-l-0 L-l-0 L-l-0 L-s-0 L-s-0 
job-8892,1,9,4,444247,444247,444372,0,125,444572,true,L-m-0 L-m-0 L-l-0 L-l-0 
job-8894,4,4,5,444357,444357,444373,0,16,444384,true,C-s-0 C-s-1 C-s-2 C-m-2 C-m-2 
job-8889,4,4,2,444090,444090,444427,0,337,444609,true,C-m-0 C-m-1 
job-8895,4,10,6,444406,444406,444521,0,115,444742,true,L-m-0 C-s-0 C-s-1 C-s-2 C-m-2 C-m-2 
job-8897,2,7,5,444509,444509,444579,0,70,444706,true,L-l-0 C-m-0 C-m-0 C-m-1 C-m-1 
job-8898,1,6,2,444569,444569,444583,0,14,444728,true,L-s-0 L-m-0 
job-8896,1,8,1,444465,444465,444590,0,125,444666,true,L-m-0 
job-8893,3,10,7,444301,444301,444625,0,324,444863,true,L-m-0 L-l-0 L-l-0 L-l-0 C-m-0 C-m-1 L-s-0 
job-8899,1,4,6,444628,444628,444669,0,41,444845,true,L-s-0 L-s-0 L-s-0 L-s-0 L-m-0 L-m-0 
job-8901,5,4,3,444728,444728,444760,0,32,444933,true,C-m-0 C-m-1 C-m-2 
job-8902,5,7,2,444784,444784,444807,0,23,444975,true,C-m-0 C-m-1 
job-8900,3,4,8,444681,444681,444828,0,147,444977,true,L-s-0 L-m-0 L-m-0 L-l-0 L-l-0 L-l-0 L-l-0 C-s-0 
job-8903,3,11,4,444826,444826,444839,0,13,444891,true,C-s-1 C-s-2 C-m-0 C-m-0 
job-8904,6,7,8,444889,444889,444959,0,70,445220,true,L-m-0 L-l-0 L-l-0 C-m-0 C-m-1 C-m-2 C-l-2 C-l-2 
job-8906,3,8,7,444992,444992,445068,0,76,445082,true,C-l-0 C-l-0 L-s-0 L-m-0 L-m-0 L-l-0 L-l-0 
job-8907,5,12,2,445054,445054,445068,0,14,445296,true,L-l-0 C-m-0 
job-8905,5,4,3,444944,444944,445148,0,204,445444,true,C-l-1 C-l-1 C-l-0 
job-8908,2,4,8,445103,445103,445169,0,66,445175,true,C-l-1 C-l-0 C-l-0 C-l-0 L-s-0 L-s-0 L-m-0 L-m-0 
job-8909,2,7,1,445153,445153,445204,0,51,445337,true,L-m-0 
job-8910,4,8,4,445204,445204,445291,0,87,445351,true,L-s-0 L-m-0 L-m-0 L-l-0 
job-8911,6,9,6,445246,445246,445377,0,131,445407,true,L-l-0 C-m-0 C-m-1 C-m-2 C-l-0 C-l-0 
job-8912,6,9,8,445293,445377,445407,84,30,445613,true,L-m-0 L-l-0 L-l-0 C-m-0 C-m-1 C-m-2 C-l-0 C-l-0 
job-8914,4,7,6,445391,445391,445444,0,53,445463,true,L-s-0 C-s-0 C-s-1 C-s-2 C-l-1 C-l-1 
job-8913,1,5,8,445342,445377,445492,35,115,445706,true,L-m-0 L-m-0 C-m-0 C-m-0 C-m-1 C-m-1 C-m-2 C-m-2 
job-8916,1,8,7,445491,445491,445512,0,21,445673,true,L-m-0 C-m-0 C-m-0 C-m-1 C-m-1 C-m-2 C-m-2 
job-8915,4,12,1,445439,445439,445643,0,204,445856,true,L-m-0 
job-8918,1,10,7,445597,445597,445650,0,53,445859,true,L-l-0 L-l-0 L-l-0 C-s-0 C-s-1 C-s-2 C-m-0 
job-8917,1,11,3,445545,445545,445664,0,119,445783,true,L-m-0 L-s-0 L-l-0 
job-8920,6,8,3,445687,445687,445735,0,48,445832,true,L-m-0 L-l-0 L-l-0 
job-8921,1,10,4,445737,445737,445759,0,22,445993,true,L-s-0 L-m-0 L-m-0 L-m-0 
job-8919,3,5,1,445635,445635,445793,0,158,445860,true,L-s-0 
job-8923,1,12,2,445828,445828,445868,0,40,446023,true,L-m-0 L-l-0 
job-8922,6,11,2,445783,445783,445928,0,145,445981,true,L-m-0 L-l-0 
job-8924,6,8,2,445883,445883,446085,0,202,446330,true,L-l-0 C-m-0 
job-8926,2,9,7,445970,445970,446092,0,122,446290,true,L-l-0 L-l-0 L-l-0 C-m-0 C-m-2 C-m-2 L-m-0 
job-8925,3,12,7,445925,445925,446107,0,182,446254,true,L-s-0 C-s-0 C-s-1 C-s-2 C-m-1 C-m-1 C-m-2 
job-8928,4,5,4,446090,446090,446117,0,27,446327,true,L-l-0 C-m-0 C-l-0 C-l-0 
job-8929,4,7,1,446134,446134,446147,0,13,446397,true,L-m-0 
job-8927,4,5,4,446020,446020,446258,0,238,446557,true,L-m-0 C-l-1 C-l-1 C-l-1 
job-8930,4,6,7,446185,446185,446283,0,98,446565,true,L-m-0 L-s-0 L-l-0 L-l-0 L-l-0 C-s-0 C-s-1 
job-8932,1,9,6,446296,446296,446350,0,54,446593,true,L-s-0 L-m-0 L-m-0 L-m-0 L-l-0 L-l-0 
job-8933,2,5,4,446349,446349,446363,0,14,446400,true,L-s-0 L-m-0 L-l-0 L-l-0 
job-8931,4,7,1,446239,446239,446405,0,166,446654,true,C-s-2 
job-8934,6,5,1,446393,446393,446491,0,98,446755,true,L-m-0 
job-8936,5,11,5,446495,446495,446514,0,19,446590,true,L-m-0 C-m-2 C-m-1 C-m-0 C-l-1 
job-8935,4,6,3,446447,446447,446601,0,154,446870,true,L-s-0 L-l-0 L-l-0 
job-8937,5,6,4,446545,446545,446634,0,89,446925,true,L-m-0 C-m-2 C-m-1 C-m-0 
job-8939,1,10,5,446644,446644,446747,0,103,447040,true,L-m-0 L-m-0 L-l-0 L-l-0 C-m-2 
job-8938,2,12,7,446599,446599,446763,0,164,447017,true,L-m-0 L-l-0 L-l-0 C-m-2 C-m-1 C-m-0 C-s-2 
job-8940,4,7,1,446695,446695,446796,0,101,446898,true,C-m-2 
job-8942,4,7,8,446784,446784,446801,0,17,446959,true,C-m-2 L-s-0 L-m-0 L-m-0 L-l-0 L-l-0 L-l-0 C-s-2 
job-8943,2,9,5,446844,446844,446863,0,19,447006,true,C-m-1 C-m-0 L-s-0 L-m-0 L-m-0 
job-8941,3,8,4,446741,446741,446877,0,136,447038,true,C-m-1 C-m-1 C-m-0 C-m-0 
job-8944,6,7,8,446892,446892,447187,0,295,447242,true,L-m-0 L-l-0 L-l-0 C-m-1 C-m-0 C-m-2 C-l-1 C-l-1 
job-8949,4,8,4,447166,447187,447230,21,43,447416,true,C-l-0 C-l-0 C-l-2 C-l-2 
job-8947,2,9,2,447050,447187,447239,137,52,447136,false,L-m-0 C-m-2 
job-8945,6,5,5,446942,447187,447242,245,55,447196,false,L-m-0 L-l-0 L-l-0 C-m-1 C-m-0 
job-8950,6,8,8,447227,447242,447304,15,62,447514,true,C-l-0 L-m-0 L-l-0 L-l-0 C-m-1 C-m-0 C-l-2 C-l-2 
job-8948,3,6,4,447116,447187,447319,71,132,447535,true,C-l-1 C-l-1 C-l-1 C-l-0 
job-8951,4,10,5,447269,447304,447338,35,34,447434,true,C-l-0 C-l-0 L-m-0 L-m-0 L-l-0 
job-8946,3,9,7,446998,447187,447340,189,153,447154,false,L-s-0 C-s-2 C-s-0 C-s-1 C-m-2 C-m-2 C-l-1 
job-8953,5,11,1,447360,447360,447429,0,69,447721,true,L-l-0 
job-8952,2,6,2,447312,447312,447513,0,201,447753,true,L-l-0 L-l-0 
job-8956,1,5,6,447520,447520,447580,0,60,447644,true,L-m-0 L-m-0 L-l-0 L-l-0 L-l-0 L-l-0 
job-8957,3,4,3,447570,447570,447677,0,107,447768,true,L-l-0 C-s-2 C-s-0 
job-8954,1,7,8,447415,447415,447736,0,321,447824,true,L-l-0 L-l-0 L-l-0 L-s-0 L-s-0 L-m-0 L-m-0 L-m-0 
job-8958,2,7,5,447615,447615,447754,0,139,447765,true,L-m-0 L-l-0 L-l-0 L-l-0 C-m-2 
job-8959,6,5,1,447682,447682,447815,0,133,447826,true,C-l-0 
job-8960,6,12,6,447730,447754,447830,24,76,448072,true,C-l-0 L-m-0 L-l-0 L-l-0 C-l-2 C-l-2 
job-8961,3,7,8,447784,447830,447877,46,47,447991,true,L-s-0 L-m-0 L-m-0 L-l-0 L-l-0 L-l-0 L-l-0 C-s-2 
job-8962,4,8,3,447848,447848,447908,0,60,448014,true,C-s-0 C-s-1 C-l-2 
job-8955,6,12,5,447469,447469,447977,0,508,448132,true,C-m-2 C-m-1 C-m-0 C-l-1 C-l-1 
job-8965,4,12,8,447972,447972,447983,0,11,448160,true,L-s-0 L-l-0 L-l-0 L-l-0 C-s-0 C-s-1 C-s-2 C-l-0 
job-8963,2,11,4,447887,447887,447992,0,105,448265,true,C-m-2 C-m-1 C-m-0 C-l-2 
job-8967,3,6,1,448064,448064,448116,0,52,448149,true,L-l-0 
job-8964,5,4,3,447930,447930,448135,0,205,448275,true,C-l-2 C-l-2 L-m-0 
job-8968,1,10,7,448110,448110,448157,0,47,448195,true,L-s-0 L-l-0 L-l-0 L-l-0 C-l-2 C-l-2 C-s-0 
job-8969,5,5,3,448166,448166,448187,0,21,448471,true,L-m-0 L-l-0 C-m-2 
job-8966,3,6,4,448021,448021,448199,0,178,448494,true,L-m-0 L-s-0 L-l-0 L-l-0 
job-8970,1,4,5,448208,448208,448270,0,62,448469,true,L-s-0 L-s-0 L-s-0 L-s-0 L-m-0 
job-8971,3,10,6,448251,448251,448314,0,63,448395,true,L-m-0 L-m-0 L-l-0 L-l-0 L-l-0 L-l-0 
job-8972,4,4,2,448296,448296,448453,0,157,448537,true,L-s-0 C-s-0 
job-8973,3,11,8,448357,448357,448535,0,178,448551,true,L-m-0 L-m-0 L-l-0 L-l-0 L-l-0 L-l-0 C-s-1 C-s-2 
job-8974,1,12,8,448392,448392,448552,0,160,448635,true,C-m-2 C-m-2 C-m-1 C-m-1 C-m-0 C-m-0 C-l-2 C-l-2 
job-8975,6,12,4,448428,448428,448565,0,137,448639,true,C-l-2 C-l-1 C-l-1 C-l-0 
job-8977,6,11,4,448531,448552,448594,21,42,448641,true,L-l-0 L-l-0 C-m-2 C-m-1 
job-8979,2,11,3,448629,448629,448656,0,27,448753,true,C-l-0 C-l-2 C-l-2 
job-8976,3,12,6,448476,448535,448674,59,139,448806,true,C-l-2 C-l-0 C-l-0 L-s-0 L-m-0 L-m-0 
job-8980,1,8,4,448691,448691,448703,0,12,448754,true,C-l-0 C-l-0 C-l-0 C-l-0 
job-8981,6,12,5,448747,448747,448841,0,94,448907,true,C-l-0 C-l-2 L-m-0 L-l-0 L-l-0 
job-8982,6,8,1,448799,448799,448862,0,63,449153,true,C-m-2 
job-8978,4,4,2,448580,448580,448887,0,307,449138,true,C-l-0 C-l-2 
job-8984,2,4,3,448893,448893,448958,0,65,449191,true,C-m-2 C-m-2 C-m-2 
job-8983,2,12,6,448846,448846,449008,0,162,449278,true,C-m-2 C-l-0 C-l-0 C-l-0 C-l-2 C-l-2 
job-8986,2,4,1,449007,449007,449043,0,36,449152,true,C-m-2 
job-8988,6,6,1,449101,449101,449184,0,83,449206,true,C-l-2 
job-8989,6,11,1,449150,449150,449207,0,57,449208,true,L-m-0 
job-8990,3,10,6,449196,449196,449228,0,32,449515,true,C-l-2 C-l-2 L-s-0 L-l-0 L-l-0 L-l-0 
job-8985,6,9,2,448946,448946,449265,0,319,449461,true,C-l-0 C-l-2 
job-8987,5,7,1,449050,449050,449284,0,234,449482,true,C-l-0 
job-8992,1,7,7,449287,449287,449501,0,214,449618,true,C-l-2 C-l-2 C-l-2 C-l-2 C-l-2 C-l-2 L-s-0 
job-8991,5,4,1,449231,449231,449561,0,330,449854,true,C-l-2 
job-8995,2,12,2,449435,449561,449588,126,27,449546,false,L-m-0 L-l-0 
job-8993,5,10,4,449337,449337,449602,0,265,449670,true,L-m-0 L-l-0 L-l-0 C-m-2 
job-8997,2,9,6,449525,449588,449602,63,14,449693,true,L-m-0 L-l-0 C-m-1 C-m-0 C-s-2 C-s-0 
job-8994,6,5,8,449375,449561,449605,186,44,449464,false,C-m-1 C-m-0 C-l-2 C-l-2 C-l-0 C-l-0 C-l-1 C-l-1 
job-8996,3,12,3,449485,449561,449656,76,95,449808,true,C-m-2 L-s-0 C-s-1 
job-8999,5,10,3,449629,449629,449699,0,70,449906,true,L-m-0 L-l-0 C-m-2 
job-9000,5,10,2,449679,449679,449744,0,65,449830,true,C-m-1 C-m-0 
job-9001,6,7,4,449730,449730,449765,0,35,449989,true,L-l-0 C-m-2 C-l-2 C-l-2 
job-8998,1,7,6,449581,449602,449780,21,178,449875,true,L-m-0 L-m-0 L-m-0 L-l-0 L-l-0 L-l-0 
job-9004,5,6,5,449858,449858,449869,0,11,449886,true,C-m-2 C-l-2 C-l-2 C-l-0 C-l-0 
job-9003,5,8,3,449810,449810,449906,0,96,450117,true,L-l-0 L-m-0 C-m-0 
job-9005,1,9,1,449907,449907,449943,0,36,449977,true,L-l-0 
job-9002,6,12,2,449774,449774,449945,0,171,450101,true,L-l-0 C-m-1 
job-9006,4,10,7,449961,449961,450072,0,111,450358,true,L-s-0 L-m-0 L-m-0 L-l-0 L-l-0 L-l-0 C-s-1 
job-9007,1,6,7,450018,450018,450094,0,76,450330,true,C-s-2 C-s-2 C-s-0 C-s-0 C-m-1 C-m-1 C-m-1 
job-9008,6,9,4,450068,450068,450307,0,239,450352,true,C-m-0 C-m-2 C-l-2 C-l-2 
job-9010,4,9,8,450193,450193,450429,0,236,450678,true,L-s-0 L-l-0 L-l-0 L-l-0 C-s-1 C-s-2 C-s-0 C-m-1 
job-9013,1,7,3,450356,450429,450439,73,10,450393,false,L-m-0 L-m-0 L-m-0 
job-9011,5,12,1,450244,450244,450449,0,205,450599,true,C-l-0 
job-9014,2,5,5,450424,450429,450477,5,48,450611,true,C-m-1 C-m-0 C-m-2 L-s-0 L-s-0 
job-9009,5,6,1,450130,450130,450547,0,417,450678,true,L-m-0 
job-9012,6,5,8,450302,450429,450596,127,167,450583,false,C-l-0 L-l-0 L-l-0 C-m-1 C-m-0 C-m-2 C-l-2 C-l-2 
job-9016,4,5,1,450539,450596,450621,57,25,450645,true,L-s-0 
job-9017,5,8,3,450594,450596,450700,2,104,450749,true,C-l-0 C-l-0 C-l-1 
job-9018,4,12,3,450636,450636,450722,0,86,450870,true,C-l-1 L-s-0 C-s-1 
job-9015,6,6,8,450480,450596,450955,116,359,450867,false,L-m-0 L-l-0 L-l-0 C-m-1 C-m-0 C-m-2 C-l-2 C-l-2 
job-9020,4,9,8,450732,450955,451002,223,47,451041,true,L-s-0 C-s-1 C-s-2 C-s-0 C-m-2 C-m-2 C-l-2 C-l-2 
job-9022,4,6,7,450844,451002,451084,158,82,450967,false,C-l-2 C-l-2 C-l-1 C-l-1 L-s-0 C-s-1 C-s-2 
job-9019,5,4,5,450682,450955,451104,273,149,451062,false,L-m-0 L-l-0 L-l-0 C-m-1 C-m-0 
job-9026,5,8,6,451075,451104,451153,29,49,451386,true,L-m-0 C-m-1 C-m-0 C-l-1 L-l-0 L-l-0 
job-9024,3,11,5,450961,451084,451169,123,85,451232,true,L-m-0 C-m-1 C-m-0 C-l-0 C-l-2 
job-9023,4,5,5,450905,451002,451244,97,242,451209,false,C-s-0 C-m-2 C-m-2 C-l-0 C-l-0 
job-9028,2,4,1,451165,451169,451319,4,150,451437,true,L-m-0 
job-9025,3,4,2,451019,451084,451376,65,292,451569,true,C-l-2 C-l-1 
job-9027,6,9,5,451124,451169,451378,45,209,451482,true,L-m-0 L-l-0 L-l-0 C-m-1 C-m-0 
job-9031,3,5,1,451330,451378,451462,48,84,451610,true,C-m-2 
job-9029,6,5,7,451217,451378,451521,161,143,451443,false,C-l-2 C-l-1 L-m-0 L-l-0 L-l-0 C-m-1 C-m-0 
job-9033,5,12,2,451434,451521,451543,87,22,451562,true,C-m-1 C-m-0 
job-9021,4,10,2,450791,450955,451589,164,634,451707,true,C-l-2 C-l-1 
job-9030,4,12,4,451278,451378,451596,100,218,451684,true,L-s-0 C-s-0 C-s-1 C-s-2 
job-9032,6,8,5,451382,451521,451608,139,87,451506,false,C-l-2 C-l-1 L-m-0 L-l-0 L-l-0 
job-9035,2,8,6,451532,451608,451620,76,12,451751,true,L-m-0 C-m-1 C-m-0 C-m-2 L-s-0 L-s-0 
job-9034,6,5,8,451484,451608,451635,124,27,451769,true,L-m-0 L-l-0 L-l-0 C-m-1 C-m-0 C-m-2 C-l-2 C-l-2 
job-9037,6,7,1,451638,451638,451684,0,46,451930,true,C-l-1 
job-9036,4,8,4,451587,451608,451708,21,100,451892,true,C-s-0 C-s-1 C-s-2 C-l-1 
job-9038,1,7,8,451698,451698,451719,0,21,451962,true,C-l-1 C-l-1 C-l-1 C-l-1 C-l-1 L-s-0 L-s-0 L-m-0 
job-9039,3,8,3,451745,451745,451795,0,50,451871,true,L-s-0 L-m-0 L-m-0 
job-9042,1,7,2,451877,451877,451908,0,31,451961,true,L-l-0 C-m-1 
job-9040,2,8,6,451788,451788,451909,0,121,451978,true,L-m-0 L-l-0 L-l-0 L-l-0 L-l-0 L-l-0 
job-9044,4,5,6,451966,451966,451994,0,28,452177,true,L-l-0 L-l-0 C-s-0 C-s-1 C-s-2 C-l-0 
job-9041,6,4,8,451833,451833,452084,0,251,452305,true,L-m-0 C-m-1 C-m-0 C-m-2 C-l-1 C-l-1 C-l-2 C-l-2 
job-9045,1,4,4,452010,452010,452117,0,107,452415,true,L-s-0 L-m-0 L-m-0 L-l-0 
job-9047,2,4,7,452095,452095,452117,0,22,452253,true,L-m-0 L-m-0 L-m-0 L-l-0 L-l-0 L-l-0 C-s-0 
job-9048,1,9,3,452160,452160,452176,0,16,452247,true,L-l-0 L-l-0 L-l-0 
job-9049,4,7,8,452202,452202,452238,0,36,452358,true,L-l-0 L-l-0 L-m-0 L-m-0 C-s-0 C-s-1 C-s-2 C-m-1 
job-9050,4,6,4,452243,452243,452276,0,33,452382,true,L-l-0 L-l-0 L-m-0 L-m-0 
job-9046,1,4,1,452052,452052,452290,0,238,452536,true,L-l-0 
job-9051,5,6,2,452301,452301,452325,0,24,452384,true,L-l-0 L-m-0 
job-9043,3,8,2,451925,451925,452346,0,421,452425,true,L-s-0 L-l-0 
job-9053,6,12,4,452419,452419,452434,0,15,452731,true,L-m-0 L-l-0 L-l-0 C-m-1 
job-9052,1,6,2,452358,452358,452456,0,98,452637,true,L-s-0 L-s-0 
job-9054,2,8,8,452475,452475,452520,0,45,452662,true,L-s-0 L-s-0 L-m-0 L-m-0 L-m-0 L-m-0 L-l-0 L-l-0 
job-9056,1,12,8,452570,452570,452607,0,37,452773,true,L-l-0 L-l-0 C-s-0 C-s-1 C-s-2 C-m-1 C-m-1 C-m-0 
job-9055,2,10,6,452522,452522,452649,0,127,452775,true,L-s-0 L-m-0 L-m-0 L-m-0 L-l-0 L-l-0 
job-9057,2,12,6,452608,452608,452674,0,66,452717,true,L-l-0 L-l-0 C-s-0 C-s-1 C-s-2 C-m-1 
job-9061,4,6,1,452812,452812,452844,0,32,452918,true,C-m-1 
job-9058,2,8,3,452656,452656,452870,0,214,453144,true,L-l-0 L-l-0 L-l-0 
job-9059,6,4,1,452700,452700,452878,0,178,452894,true,L-l-0 
job-9060,4,4,6,452759,452759,452959,0,200,452961,true,L-s-0 L-m-0 L-m-0 C-s-0 C-s-1 C-s-2 
job-9062,1,9,3,452860,452860,452978,0,118,453112,true,C-m-1 C-m-1 C-m-1 
job-9063,4,4,4,452905,452905,453083,0,178,453362,true,C-m-1 L-l-0 L-l-0 L-l-0 
job-9064,3,12,2,452954,452954,453095,0,141,453309,true,C-m-0 C-m-0 
job-9066,3,4,7,453051,453051,453196,0,145,453431,true,L-m-0 C-s-0 C-s-1 C-s-2 C-m-2 C-m-2 C-l-1 
job-9068,4,11,3,453153,453153,453233,0,80,453492,true,C-l-1 L-l-0 L-l-0 
job-9065,2,12,5,452999,452999,453260,0,261,453314,true,C-m-1 C-m-1 L-s-0 L-m-0 L-m-0 
job-9070,3,6,6,453252,453252,453265,0,13,453424,true,L-m-0 L-l-0 L-l-0 L-l-0 C-m-0 C-l-1 
job-9069,3,12,8,453201,453201,453349,0,148,453509,true,L-l-0 C-l-1 C-s-0 C-s-1 C-s-2 C-m-2 C-m-2 C-m-0 
job-9072,2,5,2,453336,453336,453377,0,41,453533,true,C-m-2 C-m-0 
job-9067,4,4,2,453105,453105,453384,0,279,453682,true,C-m-1 C-l-1 
job-9071,1,11,3,453292,453292,453397,0,105,453628,true,L-l-0 L-l-0 L-l-0 
job-9074,5,4,3,453447,453447,453477,0,30,453589,true,L-m-0 L-l-0 L-l-0 
job-9073,3,8,2,453399,453399,453624,0,225,453689,true,L-s-0 L-m-0 
job-9075,4,11,1,453491,453491,453662,0,171,453955,true,L-m-0 
job-9076,4,8,8,453536,453536,453706,0,170,453941,true,L-l-0 L-l-0 L-l-0 C-s-0 C-s-1 C-s-2 C-m-2 C-m-2 
job-9078,6,4,7,453650,453662,453757,12,95,453929,true,L-m-0 C-l-1 C-l-1 C-l-2 C-l-2 C-l-0 C-l-0 
job-9080,4,8,2,453741,453741,453778,0,37,454037,true,L-l-0 C-s-0 
job-9079,4,7,4,453693,453706,453827,13,121,454072,true,C-m-1 L-s-0 L-l-0 L-l-0 
job-9077,3,6,3,453597,453597,453855,0,258,454011,true,C-m-0 C-m-0 C-m-1 
job-9081,6,5,5,453782,453782,453926,0,144,454154,true,L-m-0 C-m-2 C-l-1 C-l-1 C-l-2 
job-9084,3,7,1,453929,453929,453969,0,40,454007,true,L-l-0 
job-9083,6,12,7,453875,453926,454075,51,149,454057,false,L-l-0 C-l-2 L-m-0 C-m-2 C-m-1 C-m-0 C-l-1 
job-9082,3,8,6,453825,453825,454125,0,300,454287,true,L-l-0 C-l-2 C-l-2 C-s-0 C-s-1 C-s-2 
job-9086,4,6,8,454018,454075,454371,57,296,454447,true,C-m-2 C-m-2 C-m-1 C-m-1 C-m-0 C-m-0 C-l-1 C-l-1 
job-9087,5,9,5,454062,454371,454381,309,10,454140,false,C-l-2 C-m-2 C-m-1 C-m-0 C-l-1 
job-9085,4,8,6,453975,454075,454392,100,317,454359,false,L-l-0 L-l-0 C-l-2 L-s-0 L-m-0 L-m-0 
job-9088,5,10,8,454110,454381,454450,271,69,454271,false,C-l-2 C-m-2 C-m-1 C-m-0 C-l-1 C-l-1 C-l-0 C-l-0 
job-9089,5,11,6,454144,454450,454520,306,70,454365,false,L-m-0 L-l-0 L-l-0 C-m-2 C-m-1 C-m-0 
job-9091,1,9,8,454238,454450,454550,212,100,454492,false,L-m-0 L-m-0 L-l-0 L-l-0 C-m-2 C-m-2 C-m-1 C-m-1 
job-9090,6,4,5,454189,454450,454586,261,136,454401,false,C-l-1 C-l-1 C-l-0 C-l-0 C-l-2 
job-9092,4,4,7,454279,454520,454617,241,97,454593,false,L-m-0 L-l-0 L-l-0 C-m-2 C-m-1 C-l-2 L-s-0 
job-9093,1,11,4,454332,454520,454634,188,114,454725,true,L-l-0 L-l-0 C-l-2 C-l-2 
job-9097,5,9,7,454523,454617,454648,94,31,454627,false,L-m-0 L-l-0 L-l-0 C-m-2 C-l-2 C-l-0 C-m-1 
job-9094,4,10,5,454381,454520,454670,139,150,454558,false,C-s-0 C-s-1 C-s-2 C-m-0 C-m-0 
job-9098,2,6,1,454578,454617,454684,39,67,454880,true,C-m-1 
job-9095,2,6,2,454427,454520,454777,93,257,454809,true,L-m-0 C-m-2 
job-9102,4,12,3,454786,454786,454850,0,64,455104,true,L-m-0 C-m-2 C-l-2 
job-9099,2,6,4,454628,454628,454861,0,233,454869,true,C-l-0 C-l-1 L-s-0 L-s-0 
job-9096,5,6,4,454479,454586,454879,107,293,455030,true,C-l-2 C-l-1 C-l-1 C-l-0 
job-9101,1,8,7,454731,454731,454883,0,152,455104,true,C-m-1 C-m-1 C-l-0 C-l-0 C-l-0 C-l-0 C-l-2 
job-9103,3,11,8,454837,454837,454912,0,75,454973,true,L-l-0 L-l-0 L-l-0 L-l-0 C-s-0 C-s-1 C-s-2 C-m-0 
job-9100,2,10,5,454679,454679,454951,0,272,455075,true,L-m-0 L-m-0 C-m-2 C-m-2 C-m-1 
job-9106,3,11,7,454995,454995,455019,0,24,455300,true,L-m-0 C-m-2 C-m-1 C-s-0 C-s-1 C-s-2 C-m-0 
job-9107,1,10,2,455037,455037,455080,0,43,455198,true,L-m-0 L-m-0 
job-9104,3,4,2,454877,454877,455114,0,237,455151,true,L-m-0 C-m-1 
job-9105,4,7,5,454944,454944,455162,0,218,455390,true,C-m-2 L-s-0 L-l-0 L-l-0 L-l-0 
job-9108,4,7,6,455086,455086,455192,0,106,455413,true,L-m-0 C-m-2 C-m-1 C-s-0 C-s-1 C-s-2 
job-9110,1,11,8,455165,455165,455192,0,27,455448,true,L-m-0 L-m-0 C-m-0 C-m-0 C-m-2 C-m-2 C-m-1 C-m-1 
job-9112,4,6,6,455249,455249,455328,0,79,455610,true,C-l-0 L-s-0 L-m-0 L-m-0 L-l-0 L-l-0 
job-9109,5,4,2,455124,455124,455347,0,223,455444,true,C-m-0 C-l-0 
job-9111,1,7,5,455200,455200,455400,0,200,455631,true,C-m-0 C-m-0 C-m-0 C-l-0 C-l-0 
job-9115,6,4,4,455367,455367,455457,0,90,455755,true,C-m-2 C-l-0 L-m-0 C-m-1 
job-9116,1,5,2,455424,455424,455560,0,136,455650,true,L-m-0 L-m-0 
job-9118,5,9,6,455526,455526,455560,0,34,455707,true,C-m-1 C-m-0 C-l-0 C-l-0 C-l-1 C-l-1 
job-9114,6,7,1,455328,455328,455565,0,237,455566,true,L-l-0 
job-9117,1,10,7,455484,455484,455599,0,115,455866,true,L-m-0 L-m-0 L-l-0 L-l-0 C-m-2 C-m-2 L-s-0 
job-9113,2,10,6,455295,455295,455693,0,398,455791,true,L-l-0 L-l-0 C-s-0 C-s-1 C-s-2 C-m-2 
job-9120,2,5,7,455629,455629,455707,0,78,455863,true,L-m-0 L-m-0 L-m-0 L-l-0 L-l-0 L-l-0 C-s-0 
job-9122,3,7,5,455724,455724,455738,0,14,455994,true,L-m-0 L-m-0 L-l-0 L-l-0 L-l-0 
job-9121,6,12,2,455678,455678,455770,0,92,456043,true,C-m-1 C-m-2 
job-9123,2,5,8,455771,455771,455792,0,21,455994,true,L-m-0 L-m-0 L-m-0 L-l-0 L-l-0 L-l-0 L-l-0 L-l-0 
job-9119,1,7,4,455571,455571,455813,0,242,455862,true,L-m-0 L-l-0 C-m-1 C-m-1 
job-9124,1,8,2,455820,455820,455878,0,58,456137,true,L-s-0 L-s-0 
job-9126,6,8,3,455903,455903,455916,0,13,456207,true,L-m-0 L-l-0 L-l-0 
job-9125,1,5,2,455869,455869,455968,0,99,456115,true,L-m-0 L-m-0 
job-9127,4,7,7,455952,455952,455975,0,23,455992,true,L-m-0 L-s-0 L-l-0 L-l-0 L-l-0 C-s-0 C-s-1 
job-9128,1,7,7,456010,456010,456071,0,61,456323,true,L-s-0 L-s-0 L-m-0 L-m-0 L-m-0 L-m-0 L-l-0 
job-9130,1,4,6,456106,456106,456134,0,28,456327,true,L-m-0 L-m-0 L-m-0 L-l-0 L-l-0 C-m-1 
job-9131,2,7,1,456160,456160,456217,0,57,456473,true,L-m-0 
job-9132,3,5,4,456209,456209,456224,0,15,456515,true,C-m-1 C-m-2 C-m-0 C-l-0 
job-9129,5,7,7,456071,456071,456257,0,186,456356,true,L-m-0 L-l-0 L-l-0 C-m-1 C-m-2 C-m-0 C-l-0 
job-9134,5,7,7,456310,456310,456324,0,14,456495,true,L-l-0 L-l-0 C-m-1 C-m-2 C-m-0 C-l-0 C-l-0 
job-9133,1,4,8,456261,456261,456412,0,151,456552,true,L-s-0 L-s-0 L-s-0 L-s-0 L-m-0 L-m-0 L-m-0 L-m-0 
job-9135,2,11,5,456352,456352,456429,0,77,456477,true,L-m-0 L-l-0 L-l-0 L-l-0 L-l-0 
job-9137,2,6,1,456429,456429,456451,0,22,456668,true,L-s-0 
job-9138,5,11,4,456485,456485,456557,0,72,456806,true,L-m-0 L-l-0 L-l-0 C-m-1 
job-9136,4,10,2,456392,456392,456559,0,167,456684,true,C-s-0 C-s-1 
job-9139,3,4,6,456526,456526,456606,0,80,456860,true,L-m-0 C-m-1 L-s-0 C-s-2 C-m-2 C-m-2 
job-9141,1,12,3,456614,456614,456676,0,62,456948,true,L-m-0 C-m-1 L-s-0 
job-9140,3,9,7,456577,456577,456708,0,131,456914,true,L-m-0 C-m-1 L-l-0 L-l-0 L-l-0 L-l-0 C-s-0 
job-9142,6,12,1,456671,456671,456720,0,49,456779,true,C-m-2 
job-9143,5,11,7,456717,456717,456734,0,17,456849,true,L-m-0 L-l-0 L-l-0 C-m-1 C-m-0 C-l-0 C-l-0 
job-9144,1,7,7,456768,456768,456792,0,24,457016,true,L-s-0 L-s-0 L-m-0 L-m-0 L-m-0 L-m-0 L-l-0 
job-9146,6,5,1,456853,456853,456876,0,23,457103,true,L-l-0 
job-9145,1,9,6,456815,456815,456906,0,91,456913,true,L-s-0 L-m-0 L-m-0 L-m-0 L-l-0 L-l-0 
job-9147,3,10,2,456893,456893,456967,0,74,457156,true,L-l-0 L-l-0 
job-9148,3,5,3,456940,456940,457010,0,70,457059,true,L-l-0 L-l-0 L-s-0 
job-9150,2,10,7,457057,457057,457070,0,13,457301,true,L-m-0 L-l-0 L-l-0 L-l-0 C-m-2 L-s-0 C-s-0 
job-9149,5,10,3,457001,457001,457085,0,84,457151,true,L-l-0 L-m-0 C-m-2 
job-9151,5,7,5,457109,457109,457262,0,153,457310,true,L-m-0 L-l-0 L-l-0 C-m-2 C-m-1 
job-9155,2,7,1,457307,457307,457333,0,26,457494,true,C-m-0 
job-9152,2,9,4,457155,457155,457344,0,189,457536,true,L-m-0 L-l-0 C-m-2 C-m-1 
job-9153,6,11,8,457213,457262,457418,49,156,457582,true,L-m-0 L-l-0 C-m-2 C-m-1 C-m-0 C-l-0 C-l-0 C-l-1 
job-9154,3,10,2,457265,457265,457421,0,156,457688,true,L-l-0 C-l-1 
job-9158,2,12,6,457446,457446,457465,0,19,457502,true,L-l-0 L-l-0 C-l-2 C-l-1 C-l-1 C-s-0 
job-9156,6,5,1,457357,457357,457498,0,141,457637,true,C-l-2 
job-9157,4,4,8,457396,457418,457502,22,84,457729,true,L-l-0 L-l-0 C-l-2 C-l-1 C-l-1 L-s-0 L-m-0 L-m-0 
job-9159,6,12,1,457509,457509,457630,0,121,457794,true,L-m-0 
job-9163,1,6,2,457707,457707,457756,0,49,457998,true,L-m-0 L-l-0 
job-9161,6,12,1,457614,457614,457763,0,149,457894,true,C-m-2 
job-9162,5,10,1,457657,457657,457828,0,171,457982,true,L-m-0 
job-9164,2,8,7,457761,457761,457843,0,82,458071,true,L-l-0 C-m-2 C-s-0 C-s-0 C-s-2 C-s-2 C-s-1 
job-9165,2,12,6,457825,457825,457844,0,19,457954,true,C-m-2 C-m-2 C-m-1 C-m-1 C-m-0 C-m-0 
job-9166,2,12,8,457872,457872,457891,0,19,457945,true,L-m-0 L-m-0 C-s-0 C-s-2 C-s-1 C-m-2 C-m-2 C-m-1 
job-9160,2,8,8,457567,457567,457922,0,355,457963,true,L-m-0 L-s-0 L-s-0 L-l-0 L-l-0 L-l-0 L-l-0 L-l-0 
job-9167,4,6,7,457920,457920,457946,0,26,458041,true,L-m-0 C-s-0 C-s-2 C-s-1 C-m-2 C-m-2 C-m-1 
job-9168,6,5,6,457968,457968,458036,0,68,458304,true,L-m-0 L-l-0 L-l-0 C-m-2 C-m-1 C-m-0 
job-9169,4,8,5,458023,458023,458129,0,106,458246,true,L-s-0 C-s-0 C-s-2 C-s-1 C-l-2 
job-9170,5,5,4,458075,458075,458233,0,158,458336,true,C-l-2 L-m-0 L-l-0 L-l-0 
job-9173,4,5,1,458237,458237,458288,0,51,458530,true,L-m-0 
job-9171,1,12,3,458125,458125,458314,0,189,458418,true,L-m-0 L-m-0 L-l-0 
job-9172,2,4,3,458175,458175,458396,0,221,458625,true,C-l-2 C-l-2 C-l-2 
job-9175,4,11,2,458331,458331,458447,0,116,458484,true,L-l-0 L-m-0 
job-9177,1,12,8,458434,458434,458508,0,74,458679,true,C-l-2 C-s-0 C-s-2 C-s-1 C-m-2 C-m-2 C-m-1 C-m-1 
job-9174,2,10,7,458288,458288,458511,0,223,458667,true,L-l-0 L-l-0 L-l-0 C-l-2 C-l-2 C-l-2 L-s-0 
job-9176,4,12,1,458371,458371,458585,0,214,458829,true,L-m-0 
job-9179,4,9,6,458552,458552,458641,0,89,458872,true,L-l-0 L-l-0 C-m-0 C-m-2 C-m-1 L-s-0 
job-9180,1,11,1,458605,458605,458649,0,44,458859,true,L-m-0 
job-9178,2,8,8,458498,458498,458673,0,175,458812,true,L-m-0 L-m-0 L-l-0 L-l-0 C-m-2 C-m-1 C-m-0 C-m-0 
job-9181,5,6,4,458661,458661,458685,0,24,458860,true,L-l-0 C-m-2 C-m-1 C-l-2 
job-9182,6,9,1,458716,458716,458726,0,10,458744,true,L-m-0 
job-9184,6,10,2,458823,458823,458849,0,26,459022,true,L-l-0 L-l-0 
job-9183,6,12,1,458774,458774,458899,0,125,458960,true,L-m-0 
job-9186,1,5,8,458932,458932,459031,0,99,459080,true,L-s-0 L-m-0 L-m-0 L-m-0 L-m-0 L-m-0 L-m-0 C-s-0 
job-9188,2,7,2,459013,459013,459038,0,25,459291,true,C-s-0 C-m-1 
job-9189,5,8,5,459056,459056,459100,0,44,459294,true,L-m-0 C-l-2 C-l-2 C-l-1 C-l-1 
job-9185,3,9,5,458874,458874,459142,0,268,459370,true,L-s-0 L-l-0 L-l-0 L-l-0 L-l-0 
job-9190,1,11,3,459099,459099,459168,0,69,459241,true,L-m-0 L-m-0 C-m-1 
job-9192,5,10,3,459192,459192,459224,0,32,459424,true,L-l-0 L-m-0 C-l-2 
job-9187,4,6,7,458979,458979,459231,0,252,459322,true,C-s-2 C-s-1 C-m-0 C-m-0 C-m-2 C-m-2 C-m-1 
job-9191,5,12,1,459147,459147,459263,0,116,459348,true,L-l-0 
job-9193,4,12,7,459244,459244,459481,0,237,459767,true,L-l-0 L-s-0 L-m-0 L-m-0 C-s-2 C-s-1 C-s-0 
job-9194,4,9,2,459303,459303,459485,0,182,459774,true,L-l-0 L-l-0 
job-9196,4,9,6,459407,459407,459525,0,118,459661,true,C-m-2 C-m-1 C-m-1 C-l-2 C-l-2 C-l-2 
job-9195,3,4,3,459347,459347,459647,0,300,459702,true,C-m-0 C-m-0 C-m-2 
job-9199,6,6,5,459572,459647,459659,75,12,459648,false,C-m-0 C-m-2 C-m-1 C-l-2 C-l-2 
job-9200,1,8,5,459616,459647,459737,31,90,459838,true,L-m-0 L-m-0 C-m-2 C-m-1 C-m-1 
job-9197,1,9,6,459464,459464,459751,0,287,459878,true,C-m-2 C-m-0 C-m-0 C-l-1 C-l-1 C-l-1 
job-9201,3,6,2,459665,459665,459765,0,100,459856,true,C-m-0 C-m-0 
job-9198,6,4,6,459521,459521,459855,0,334,459967,true,C-l-1 L-m-0 L-l-0 L-l-0 C-l-0 C-l-0 
job-9203,1,9,8,459753,459855,459888,102,33,459819,false,L-m-0 L-m-0 C-m-0 C-m-0 C-m-2 C-m-2 C-m-1 C-m-1 
job-9202,6,10,7,459704,459855,459895,151,40,459848,false,L-m-0 L-l-0 L-l-0 C-m-0 C-m-2 C-m-1 C-l-0 
job-9206,1,11,8,459916,459916,459939,0,23,460135,true,L-m-0 C-m-0 C-m-2 C-m-1 C-s-1 C-s-0 C-l-1 C-l-1 
job-9204,6,12,7,459811,459895,460008,84,113,460147,true,L-m-0 L-l-0 L-l-0 C-m-0 C-m-2 C-m-1 C-l-0 
job-9205,3,6,4,459867,459895,460010,28,115,460000,false,C-l-0 C-l-0 L-s-0 C-s-2 
job-9208,3,4,1,460024,460024,460062,0,38,460204,true,L-s-0 
job-9207,1,9,3,459962,459962,460085,0,123,460122,true,L-s-0 L-m-0 L-m-0 
job-9210,6,9,1,460114,460114,460166,0,52,460267,true,L-m-0 
job-9213,3,11,6,460258,460258,460303,0,45,460349,true,L-m-0 C-l-0 C-l-1 C-l-1 C-l-1 C-l-1 
job-9212,4,7,7,460207,460207,460327,0,120,460444,true,L-m-0 L-l-0 C-m-2 C-m-1 C-m-1 C-l-0 C-l-0 
job-9209,1,8,6,460075,460075,460387,0,312,460480,true,L-m-0 L-l-0 L-l-0 L-l-0 L-l-0 L-l-0 
job-9214,4,8,7,460296,460303,460390,7,87,460574,true,C-l-0 C-l-1 C-l-1 C-l-1 C-l-2 C-l-2 C-l-2 
job-9215,5,12,6,460350,460390,460427,40,37,460684,true,L-m-0 L-l-0 L-l-0 C-m-1 C-l-1 C-l-1 
job-9217,2,8,8,460438,460438,460498,0,60,460520,true,C-l-0 C-l-0 L-m-0 L-m-0 L-m-0 L-m-0 L-l-0 L-l-0 
job-9218,3,4,7,460491,460491,460502,0,11,460603,true,L-l-0 L-l-0 C-m-1 C-m-1 C-l-1 C-l-1 C-l-1 
job-9211,4,10,7,460165,460165,460614,0,449,460885,true,L-s-0 C-s-2 C-s-1 C-s-0 C-m-0 C-m-0 C-m-2 
job-9219,5,4,2,460541,460541,460624,0,83,460879,true,L-m-0 L-l-0 
job-9221,1,5,6,460648,460648,460699,0,51,460760,true,L-m-0 L-m-0 L-m-0 L-m-0 C-m-2 C-m-2 
job-9222,5,7,2,460690,460690,460721,0,31,460801,true,L-l-0 L-l-0 
job-9223,2,8,5,460740,460740,460783,0,43,460948,true,L-m-0 L-m-0 C-m-2 C-m-2 C-l-0 
job-9220,2,10,1,460590,460590,460837,0,247,460843,true,L-m-0 
job-9225,4,12,2,460834,460834,460869,0,35,461064,true,C-m-2 C-l-0 
job-9224,5,9,7,460794,460794,460919,0,125,460981,true,L-m-0 L-l-0 L-l-0 C-m-0 C-m-1 C-l-1 C-l-1 
job-9216,4,7,6,460396,460396,460947,0,551,461200,true,C-m-2 C-l-2 C-l-2 C-l-2 C-l-0 C-l-0 
job-9226,5,10,1,460883,460919,460999,36,80,461034,true,L-m-0 
job-9229,5,4,6,461040,461040,461058,0,18,461060,true,L-l-0 L-l-0 C-m-2 C-m-0 C-m-1 C-l-2 
job-9228,4,9,1,461000,461000,461200,0,200,461435,true,L-m-0 
job-9230,1,5,8,461090,461090,461230,0,140,461279,true,L-s-0 L-m-0 L-l-0 L-l-0 L-l-0 L-l-0 L-l-0 L-l-0 
job-9231,2,7,1,461149,461149,461274,0,125,461305,true,L-l-0 
job-9232,3,8,6,461198,461198,461297,0,99,461557,true,L-l-0 C-s-2 C-s-1 C-s-0 C-m-2 C-m-2 
job-9235,6,5,4,461361,461361,461373,0,12,461577,true,C-m-2 C-m-0 C-m-1 C-l-2 
job-9233,6,5,1,461251,461251,461393,0,142,461569,true,L-m-0 
job-9237,1,11,2,461450,461450,461509,0,59,461521,true,C-m-1 C-l-2 
job-9227,1,8,3,460948,460948,461533,0,585,461696,true,L-m-0 L-m-0 L-s-0 
job-9238,5,8,2,461503,461503,461538,0,35,461772,true,C-m-1 C-l-2 
job-9239,1,4,4,461556,461556,461569,0,13,461781,true,L-m-0 L-m-0 L-m-0 L-m-0 
job-9234,4,8,6,461302,461302,461633,0,331,461684,true,L-l-0 L-l-0 L-l-0 C-s-2 C-s-1 C-s-0 
job-9240,5,9,8,461604,461604,461680,0,76,461711,true,L-m-0 C-m-1 C-l-2 C-l-2 C-l-0 C-l-0 C-l-1 C-l-1 
job-9242,2,10,5,461713,461713,461729,0,16,461739,true,L-m-0 L-m-0 C-m-1 C-m-1 C-s-2 
job-9236,2,12,6,461402,461402,461739,0,337,461926,true,L-m-0 C-m-2 C-m-2 C-m-0 C-m-0 C-m-1 
job-9241,3,8,7,461651,461651,461744,0,93,461757,true,C-m-2 C-m-0 L-s-0 L-l-0 L-l-0 L-l-0 L-l-0 
job-9243,4,11,6,461764,461764,461829,0,65,462119,true,L-s-0 L-m-0 L-m-0 L-l-0 L-l-0 L-l-0 
job-9244,4,11,4,461809,461809,461835,0,26,462074,true,C-s-2 C-s-1 C-s-0 C-m-2 
job-9246,1,5,1,461908,461908,461944,0,36,462103,true,L-m-0 
job-9245,6,9,5,461857,461857,461980,0,123,462097,true,L-m-0 L-l-0 L-l-0 C-m-2 C-m-0 
job-9248,1,9,6,462017,462017,462090,0,73,462218,true,L-s-0 C-s-2 C-s-1 C-s-0 C-m-1 C-m-1 
job-9247,3,5,6,461960,461960,462103,0,143,462223,true,L-s-0 C-s-2 C-s-1 C-s-0 C-m-1 C-m-1 
job-9250,1,9,8,462118,462118,462161,0,43,462204,true,L-m-0 L-l-0 L-l-0 L-l-0 L-s-0 C-s-2 C-s-1 C-s-0 
job-9249,3,9,4,462064,462064,462169,0,105,462467,true,L-m-0 L-m-0 L-l-0 L-l-0 
job-9251,5,5,1,462172,462172,462196,0,24,462365,true,L-m-0 
job-9253,1,9,4,462284,462284,462421,0,137,462472,true,L-l-0 L-l-0 C-s-2 C-s-1 
job-9254,6,5,7,462330,462330,462444,0,114,462677,true,C-m-1 C-m-2 C-m-0 C-l-2 C-l-2 C-l-0 C-l-0 
job-9255,2,10,3,462382,462382,462536,0,154,462623,true,C-m-1 C-m-2 C-m-0 
job-9258,4,4,5,462544,462544,462599,0,55,462638,true,C-m-1 C-m-2 C-m-0 C-l-1 C-l-1 
job-9257,3,12,3,462490,462490,462601,0,111,462744,true,C-m-1 C-m-2 C-m-0 
job-9260,3,8,8,462644,462644,462668,0,24,462788,true,C-m-1 C-m-1 C-l-1 C-l-1 C-l-1 C-m-2 C-m-2 C-m-0 
job-9256,1,10,7,462427,462427,462684,0,257,462858,true,L-l-0 L-l-0 C-s-2 C-s-1 C-s-0 C-l-1 C-l-1 
job-9252,4,11,5,462212,462212,462743,0,531,462765,true,L-s-0 L-m-0 L-m-0 L-l-0 L-l-0 
job-9259,1,7,1,462586,462586,462819,0,233,462968,true,C-m-1 
job-9262,6,4,7,462747,462747,462823,0,76,462847,true,L-l-0 C-m-1 L-m-0 C-m-2 C-m-0 C-l-1 C-l-1 
job-9266,3,5,4,462927,462927,462949,0,22,462958,true,C-m-1 C-m-1 C-m-2 C-m-2 
job-9265,4,7,4,462886,462886,463002,0,116,463177,true,L-l-0 L-m-0 L-m-0 C-s-0 
job-9264,3,9,1,462844,462844,463018,0,174,463220,true,L-l-0 
job-9263,3,10,4,462798,462798,463052,0,254,463325,true,L-l-0 L-s-0 C-s-2 C-s-1 
job-9261,1,8,1,462699,462699,463084,0,385,463191,true,L-l-0 
job-9268,5,8,4,463028,463028,463214,0,186,463372,true,L-l-0 C-m-0 L-m-0 C-l-1 
job-9267,2,11,5,462975,462975,463241,0,266,463471,true,C-m-1 C-m-1 C-m-2 C-m-2 C-m-0 
job-9270,5,9,6,463120,463214,463242,94,28,463250,true,L-m-0 L-l-0 C-m-0 C-l-1 C-l-1 C-l-2 
job-9271,1,8,2,463169,463214,463249,45,35,463266,true,L-m-0 L-l-0 
job-9273,4,10,6,463263,463263,463277,0,14,463377,true,L-m-0 L-l-0 C-m-1 C-m-2 C-l-2 C-s-2 
job-9272,3,5,3,463219,463219,463293,0,74,463400,true,C-l-2 C-l-2 L-s-0 
job-9274,1,7,8,463303,463303,463358,0,55,463480,true,L-m-0 L-m-0 L-m-0 L-m-0 L-l-0 L-l-0 L-l-0 L-l-0 
job-9275,1,8,8,463374,463374,463390,0,16,463673,true,L-m-0 L-m-0 L-m-0 L-l-0 L-l-0 L-l-0 L-l-0 C-m-1 
job-9269,2,4,8,463070,463070,463501,0,431,463574,true,L-m-0 L-l-0 L-l-0 L-l-0 C-m-1 C-m-1 C-m-2 C-m-2 
job-9278,6,11,7,463525,463525,463535,0,10,463813,true,L-l-0 C-m-0 C-l-2 C-l-2 C-l-1 C-l-1 C-l-0 
job-9277,2,10,6,463471,463471,463550,0,79,463843,true,C-m-2 C-m-2 L-s-0 C-s-2 C-s-1 C-s-0 
job-9279,3,11,2,463589,463589,463683,0,94,463976,true,L-l-0 L-l-0 
job-9281,4,4,4,463676,463676,463722,0,46,463770,true,C-m-1 L-s-0 C-s-2 C-s-1 
job-9280,5,12,8,463638,463638,463767,0,129,463972,true,C-m-2 C-m-0 C-l-2 C-l-2 C-l-1 C-l-1 C-l-0 C-l-0 
job-9276,2,7,8,463420,463420,463821,0,401,463852,true,L-m-0 L-m-0 L-m-0 L-l-0 L-l-0 L-l-0 C-m-1 C-m-1 
job-9282,6,11,5,463719,463767,463869,48,102,463969,true,L-l-0 C-m-2 C-m-0 C-l-2 C-l-2 
job-9284,1,10,8,463802,463821,463928,19,107,463985,true,L-m-0 L-m-0 C-m-2 C-m-2 C-m-0 C-m-0 C-m-1 C-m-1 
job-9283,6,5,6,463764,463821,463948,57,127,464033,true,L-l-0 L-m-0 C-m-1 C-l-1 C-l-1 C-l-0 
job-9286,1,8,2,463929,463929,463957,0,28,464022,true,L-s-0 L-m-0 
job-9285,3,8,8,463873,463873,463983,0,110,464206,true,L-l-0 L-l-0 C-m-2 C-m-0 C-l-0 C-l-0 L-s-0 C-s-2 
job-9287,5,7,3,463978,463978,464034,0,56,464226,true,L-l-0 C-m-2 C-m-0 
job-9288,3,7,8,464038,464038,464058,0,20,464343,true,L-s-0 L-m-0 L-m-0 L-l-0 L-l-0 L-l-0 L-l-0 C-s-2 
job-9289,2,10,6,464088,464088,464171,0,83,464388,true,L-s-0 L-m-0 L-m-0 L-m-0 L-l-0 L-l-0 
job-9290,4,7,4,464143,464143,464177,0,34,464303,true,L-l-0 L-l-0 C-s-2 C-s-1 
job-9294,1,9,7,464326,464326,464349,0,23,464422,true,C-m-2 C-m-2 C-m-0 C-m-0 C-m-1 C-m-1 C-s-2 
job-9292,4,10,2,464235,464235,464359,0,124,464499,true,L-m-0 L-m-0 
job-9291,4,12,1,464190,464190,464405,0,215,464526,true,L-s-0 
job-9296,6,8,3,464437,464437,464486,0,49,464764,true,L-m-0 C-l-0 C-l-0 
job-9293,6,12,5,464276,464276,464516,0,240,464523,true,L-l-0 L-l-0 C-m-2 C-m-0 C-m-1 
job-9295,1,9,6,464389,464389,464552,0,163,464669,true,C-m-2 C-m-2 C-m-0 C-m-0 C-m-1 C-m-1 
job-9297,6,10,2,464479,464479,464592,0,113,464645,true,C-l-1 C-l-1 
job-9298,6,10,4,464529,464529,464613,0,84,464834,true,C-m-2 C-m-0 C-m-1 L-m-0 
job-9299,4,11,1,464585,464585,464681,0,96,464947,true,L-s-0 
job-9300,3,9,6,464650,464650,464713,0,63,464744,true,L-m-0 L-m-0 L-l-0 L-l-0 L-l-0 L-l-0 
job-9301,2,8,1,464689,464689,464778,0,89,465019,true,L-m-0 
job-9303,6,9,3,464796,464796,464813,0,17,464998,true,C-m-2 C-m-0 C-m-1 
job-9302,4,12,7,464746,464746,464875,0,129,465008,true,L-m-0 L-s-0 L-l-0 L-l-0 L-l-0 C-s-2 C-s-1 
job-9305,6,5,1,464897,464897,464917,0,20,465014,true,L-l-0 
job-9306,4,6,6,464949,464949,464982,0,33,465090,true,L-m-0 L-s-0 L-l-0 L-l-0 L-l-0 C-s-2 
job-9307,4,7,1,464996,464996,465009,0,13,465076,true,L-m-0 
job-9308,6,11,6,465047,465047,465164,0,117,465430,true,L-l-0 L-l-0 C-m-2 C-m-0 C-m-1 C-l-1 
job-9304,4,8,1,464844,464844,465190,0,346,465259,true,L-m-0 
job-9310,2,10,4,465136,465136,465227,0,91,465389,true,C-m-2 C-m-0 C-m-1 C-l-1 
job-9312,1,7,4,465242,465242,465282,0,40,465303,true,L-m-0 L-m-0 L-m-0 L-l-0 
job-9311,4,10,6,465186,465186,465372,0,186,465653,true,C-m-2 C-m-0 C-m-1 C-l-0 C-l-1 L-l-0 
job-9313,2,7,1,465290,465290,465390,0,100,465491,true,L-m-0 
job-9309,4,7,8,465094,465094,465444,0,350,465660,true,L-m-0 C-l-1 L-s-0 C-s-2 C-s-1 C-s-0 C-l-0 C-l-0 
job-9316,1,10,3,465459,465459,465473,0,14,465685,true,L-m-0 L-m-0 L-l-0 
job-9314,5,4,5,465349,465372,465475,23,103,465704,true,C-l-1 L-l-0 L-l-0 C-m-2 C-m-0 
job-9315,5,5,7,465409,465444,465522,35,78,465560,true,C-l-1 L-m-0 C-m-1 C-l-0 C-l-0 C-l-2 C-l-2 
job-9318,4,7,5,465567,465567,465664,0,97,465907,true,L-m-0 L-s-0 L-l-0 L-l-0 L-l-0 
job-9317,3,12,1,465516,465516,465684,0,168,465842,true,L-m-0 
job-9320,5,11,2,465675,465675,465701,0,26,465899,true,L-m-0 L-l-0 
job-9321,6,7,5,465735,465735,465785,0,50,465886,true,L-m-0 L-l-0 L-l-0 C-l-0 C-l-0 
job-9319,6,10,3,465618,465618,465847,0,229,465954,true,C-m-1 C-m-2 C-m-0 
job-9322,4,9,7,465774,465774,465872,0,98,466095,true,L-s-0 C-s-2 C-s-1 C-s-0 C-l-2 C-l-2 C-l-2 
job-9323,2,8,7,465837,465837,465876,0,39,466080,true,C-m-1 C-m-2 C-m-0 L-m-0 L-m-0 L-m-0 L-m-0 
job-9325,3,8,4,465946,465946,466021,0,75,466290,true,L-l-0 L-l-0 L-l-0 L-l-0 
job-9324,2,5,6,465887,465887,466088,0,201,466106,true,L-s-0 L-s-0 L-m-0 L-m-0 L-m-0 L-m-0 
job-9327,3,12,5,466062,466062,466090,0,28,466226,true,C-m-0 L-l-0 L-l-0 L-l-0 L-l-0 
job-9326,3,4,8,466003,466003,466105,0,102,466246,true,C-s-2 C-s-1 C-s-0 C-m-1 C-m-1 C-m-2 C-m-2 C-m-0 
job-9328,1,6,7,466118,466118,466154,0,36,466355,true,L-s-0 L-s-0 L-m-0 L-m-0 L-m-0 L-m-0 L-m-0 
job-9330,1,7,4,466215,466215,466231,0,16,466267,true,L-m-0 L-l-0 L-l-0 L-l-0 
job-9329,3,12,5,466170,466170,466270,0,100,466307,true,L-s-0 L-m-0 L-m-0 L-l-0 L-l-0 
job-9332,2,9,8,466303,466303,466344,0,41,466619,true,L-l-0 L-l-0 L-s-0 L-m-0 L-m-0 L-m-0 C-s-1 C-s-0 
job-9333,2,6,1,466345,466345,466357,0,12,466544,true,L-l-0 
job-9331,3,11,3,466256,466256,466383,0,127,466587,true,L-l-0 L-l-0 C-s-2 
job-9334,5,8,3,466400,466400,466411,0,11,466534,true,L-m-0 L-l-0 L-l-0 
job-9337,3,7,6,466575,466575,466587,0,12,466604,true,C-s-1 C-s-0 C-m-1 C-m-1 C-m-2 C-m-2 
job-9335,3,12,4,466463,466463,466614,0,151,466786,true,L-s-0 L-m-0 L-m-0 L-l-0 
job-9338,6,4,3,466621,466621,466651,0,30,466743,true,L-m-0 C-m-1 C-m-2 
job-9336,2,7,7,466513,466513,466673,0,160,466910,true,L-m-0 L-l-0 L-l-0 L-l-0 L-l-0 C-s-2 C-s-2 
job-9339,6,10,7,466681,466681,466696,0,15,466965,true,L-m-0 L-l-0 L-l-0 C-m-1 C-m-2 C-m-0 C-l-2 
job-9340,1,9,4,466738,466738,466767,0,29,467014,true,L-s-0 L-m-0 L-m-0 L-m-0 
job-9341,2,10,1,466785,466785,466828,0,43,466870,true,L-s-0 
job-9342,2,9,8,466836,466836,466863,0,27,466981,true,L-s-0 L-m-0 L-m-0 L-m-0 L-l-0 L-l-0 L-l-0 L-l-0 
job-9344,6,11,1,466921,466921,466981,0,60,467052,true,L-l-0 
job-9343,3,4,2,466877,466877,467028,0,151,467115,true,L-s-0 L-m-0 
job-9347,2,4,7,467091,467091,467111,0,20,467310,true,L-s-0 L-m-0 C-m-1 C-m-2 C-m-0 C-l-2 C-l-0 
job-9345,5,7,8,466964,466964,467124,0,160,467337,true,L-m-0 L-l-0 C-m-1 C-m-2 C-m-0 C-l-2 C-l-2 C-l-0 
job-9346,1,8,6,467019,467019,467155,0,136,467385,true,L-s-0 L-l-0 L-l-0 L-l-0 L-l-0 L-l-0 
job-9349,4,12,7,467188,467188,467227,0,39,467410,true,L-s-0 L-l-0 L-l-0 L-l-0 C-s-0 C-m-1 C-m-1 
job-9351,5,8,4,467279,467279,467290,0,11,467551,true,L-l-0 L-l-0 C-m-1 C-m-2 
job-9348,3,11,4,467137,467137,467296,0,159,467407,true,L-m-0 L-m-0 C-s-2 C-s-1 
job-9350,1,10,2,467235,467235,467314,0,79,467454,true,L-m-0 L-s-0 
job-9352,4,11,8,467328,467328,467507,0,179,467717,true,L-s-0 L-m-0 L-m-0 L-l-0 L-l-0 L-l-0 C-s-2 C-s-1 
job-9354,3,12,7,467432,467507,467527,75,20,467499,false,L-s-0 L-m-0 L-m-0 L-l-0 L-l-0 L-l-0 L-l-0 
job-9353,6,4,7,467380,467380,467627,0,247,467799,true,C-m-1 C-m-2 C-m-0 C-l-2 C-l-2 C-l-0 C-l-0 
job-9356,6,10,6,467516,467627,467650,111,23,467705,true,C-l-1 L-m-0 L-l-0 L-l-0 C-m-1 C-m-2 
job-9355,4,9,4,467478,467507,467723,29,216,467920,true,C-s-2 C-s-1 C-s-0 C-l-1 
job-9357,5,10,8,467571,467650,467883,79,233,467806,false,C-l-1 L-m-0 L-l-0 L-l-0 C-m-1 C-m-2 C-m-0 C-l-2 
job-9362,4,6,7,467780,467883,467896,103,13,467819,false,C-l-1 C-l-1 C-l-1 C-l-2 C-l-2 C-l-2 C-l-0 
job-9360,2,5,8,467706,467883,467908,177,25,467934,true,L-m-0 C-m-1 C-m-2 C-m-0 C-s-2 C-s-2 C-s-1 C-s-1 
job-9363,2,6,4,467847,467883,467960,36,77,468145,true,C-l-0 C-l-0 C-l-0 C-l-0 
job-9359,4,11,1,467664,467883,467990,219,107,467960,false,L-s-0 
job-9358,6,7,6,467608,467883,467994,275,111,467755,false,L-m-0 L-l-0 L-l-0 C-m-1 C-m-2 C-m-0 
job-9364,3,10,4,467888,467896,468063,8,167,468164,true,C-l-0 C-l-1 C-l-1 C-l-1 
job-9361,4,11,1,467742,467883,468074,141,191,467941,false,C-s-0 
job-9365,6,4,6,467939,467994,468139,55,145,468343,true,C-l-0 L-m-0 L-l-0 L-l-0 C-m-1 C-m-2 
job-9367,4,4,1,468031,468139,468189,108,50,468334,true,C-l-0 
job-9368,2,9,2,468084,468139,468192,55,53,468417,true,L-m-0 L-l-0 
job-9366,5,11,7,467982,468139,468345,157,206,468243,false,L-m-0 L-l-0 L-l-0 C-m-1 C-m-2 C-m-0 C-l-0 
job-9369,4,5,1,468130,468139,468356,9,217,468434,true,L-s-0 
job-9371,6,12,8,468229,468345,468406,116,61,468560,true,L-m-0 C-m-2 L-l-0 L-l-0 C-m-0 C-l-0 C-l-0 C-l-1 
job-9372,5,5,7,468279,468406,468508,127,102,468508,false,L-m-0 C-m-1 C-m-2 L-l-0 L-l-0 C-m-0 C-l-0 
job-9373,1,9,6,468324,468406,468519,82,113,468475,false,L-m-0 L-m-0 L-l-0 L-l-0 C-m-2 C-m-2 
job-9376,5,5,4,468473,468473,468521,0,48,468697,true,C-l-1 C-l-1 C-l-2 C-l-2 
job-9375,4,5,2,468425,468425,468525,0,100,468728,true,C-l-0 L-s-0 
job-9370,1,5,5,468184,468184,468541,0,357,468652,true,L-m-0 C-m-1 C-m-1 C-m-1 C-m-2 
job-9377,5,11,4,468518,468518,468615,0,97,468738,true,L-l-0 L-l-0 C-m-1 C-m-0 
job-9378,3,10,5,468568,468568,468663,0,95,468930,true,C-m-1 L-s-0 L-m-0 L-m-0 C-s-0 
job-9374,1,9,1,468376,468406,468675,30,269,468848,true,C-m-0 
job-9380,4,7,7,468666,468666,468691,0,25,468948,true,C-m-0 C-m-1 L-s-0 L-m-0 L-m-0 L-l-0 L-l-0 
job-9381,6,11,1,468710,468710,468763,0,53,469042,true,L-m-0 
job-9379,3,10,2,468615,468615,468772,0,157,469004,true,C-m-1 C-m-0 
job-9382,3,7,2,468756,468756,468780,0,24,468876,true,C-m-0 C-m-1 
job-9383,1,11,3,468791,468791,468834,0,43,469047,true,L-s-0 L-m-0 L-m-0 
job-9384,4,9,7,468840,468840,468905,0,65,469121,true,L-s-0 L-m-0 L-m-0 L-l-0 L-l-0 L-l-0 C-s-0 
job-9386,3,4,1,468944,468944,468963,0,19,469084,true,L-s-0 
job-9385,3,10,8,468899,468899,469042,0,143,469340,true,C-s-2 C-s-1 C-m-0 C-m-0 C-m-1 C-m-1 C-m-2 C-m-2 
job-9387,6,12,1,468991,468991,469067,0,76,469189,true,L-m-0 
job-9390,1,8,3,469144,469144,469168,0,24,469425,true,L-s-0 L-m-0 L-m-0 
job-9388,5,8,6,469034,469034,469202,0,168,469211,true,L-l-0 L-l-0 C-l-1 C-l-1 C-l-2 C-l-2 
job-9389,3,4,2,469086,469086,469286,0,200,469584,true,L-s-0 L-m-0 
job-9391,3,12,2,469194,469194,469312,0,118,469337,true,L-m-0 C-s-2 
job-9393,2,11,2,469293,469293,469312,0,19,469501,true,L-m-0 L-l-0 
job-9392,5,11,4,469242,469242,469324,0,82,469466,true,L-l-0 L-l-0 C-m-0 C-m-1 
job-9395,5,4,4,469398,469398,469418,0,20,469439,true,L-l-0 L-l-0 C-m-0 C-m-1 
job-9396,6,11,8,469447,469447,469493,0,46,469511,true,L-l-0 L-l-0 C-m-0 C-m-1 C-m-2 C-l-1 C-l-1 C-l-2 
job-9394,4,11,2,469336,469336,469510,0,174,469611,true,L-s-0 L-m-0 
job-9399,3,5,8,469601,469601,469613,0,12,469757,true,C-m-0 C-m-0 C-m-1 C-m-1 C-m-2 C-m-2 C-l-1 C-l-1 
job-9398,3,8,5,469559,469559,469682,0,123,469908,true,L-m-0 L-s-0 C-s-2 C-s-1 C-s-0 
job-9397,2,7,7,469504,469504,469716,0,212,469750,true,L-m-0 L-m-0 L-l-0 L-l-0 L-l-0 L-l-0 L-l-0 
job-9401,5,12,3,469688,469688,469741,0,53,469985,true,C-m-1 C-m-2 C-l-1 
job-9400,2,11,3,469640,469640,469749,0,109,470027,true,L-l-0 C-m-0 C-m-0 
job-9404,5,6,7,469839,469839,469854,0,15,470087,true,C-m-1 C-m-2 C-l-1 C-l-1 C-l-2 C-l-2 C-l-0 
job-9403,5,5,3,469792,469792,469859,0,67,470016,true,L-l-0 L-m-0 C-m-0 
job-9402,3,8,1,469748,469748,469904,0,156,470140,true,L-l-0 
job-9405,5,12,8,469891,469891,470114,0,223,470151,true,L-l-0 L-m-0 C-m-0 C-m-1 C-m-2 C-l-1 C-l-1 C-l-2 
job-9407,3,5,6,469983,470114,470124,131,10,470051,false,C-l-1 C-l-1 L-s-0 C-s-2 C-s-1 C-s-0 
job-9406,6,12,7,469944,470114,470147,170,33,470181,true,L-m-0 L-l-0 L-l-0 C-m-0 C-m-1 C-m-2 C-l-1 
job-9409,1,12,6,470074,470124,470237,50,113,470422,true,L-m-0 C-m-0 C-m-1 C-m-2 C-l-1 C-l-1 
job-9410,4,11,4,470121,470124,470253,3,129,470472,true,C-l-1 L-s-0 C-s-2 C-s-1 
job-9408,4,4,6,470035,470114,470278,79,164,470494,true,C-l-2 C-l-2 C-l-2 C-l-0 C-l-0 C-l-0 
job-9412,5,11,2,470227,470278,470317,51,39,470331,true,C-l-1 C-l-2 
job-9413,1,9,3,470268,470278,470349,10,71,470364,true,L-m-0 L-m-0 L-l-0 
job-9414,5,5,3,470329,470329,470433,0,104,470631,true,C-l-1 C-l-2 C-l-2 
job-9415,3,7,6,470382,470382,470454,0,72,470610,true,L-m-0 C-m-0 C-m-1 C-m-2 L-s-0 C-s-2 
job-9411,5,11,7,470180,470180,470460,0,280,470574,true,L-m-0 C-m-0 C-m-1 C-m-2 C-l-1 L-l-0 L-l-0 
job-9417,4,4,5,470481,470481,470503,0,22,470525,true,C-l-1 C-l-0 L-s-0 L-m-0 L-m-0 
job-9418,3,8,5,470524,470524,470640,0,116,470678,true,C-l-1 C-l-1 C-l-0 C-l-0 L-s-0 
job-9419,5,11,8,470571,470640,470682,69,42,470889,true,C-l-1 C-l-0 L-m-0 L-l-0 L-l-0 C-m-0 C-m-1 C-m-2 
job-9421,2,4,2,470666,470666,470709,0,43,470845,true,C-l-0 C-l-2 
job-9420,2,9,6,470623,470640,470780,17,140,470774,false,L-m-0 L-l-0 C-m-0 C-m-1 C-m-2 C-l-1 
job-9423,4,5,4,470766,470766,470792,0,26,471063,true,C-l-1 C-l-0 L-s-0 C-s-2 
job-9422,4,5,6,470717,470717,470835,0,118,470999,true,L-m-0 L-l-0 L-l-0 C-m-0 C-m-1 C-m-2 
job-9424,3,9,6,470817,470817,470872,0,55,470961,true,L-m-0 L-l-0 C-m-0 C-m-1 C-m-2 C-l-1 
job-9416,5,8,4,470439,470439,470956,0,517,471237,true,C-l-1 C-l-2 C-l-2 C-l-0 
job-9425,4,9,5,470867,470867,470980,0,113,471137,true,L-m-0 L-l-0 L-l-0 C-m-0 C-m-1 
job-9427,3,10,7,470951,470951,470997,0,46,471228,true,C-m-0 C-m-1 C-l-1 C-l-1 C-l-0 C-l-0 L-s-0 
job-9426,3,7,2,470903,470903,471012,0,109,471252,true,L-m-0 L-l-0 
job-9428,5,5,8,471001,471001,471021,0,20,471198,true,L-m-0 L-l-0 C-m-0 C-m-1 C-m-2 C-l-2 C-l-2 C-l-1 
job-9430,3,6,4,471096,471096,471161,0,65,471316,true,L-m-0 L-l-0 L-l-0 L-l-0 
job-9429,1,4,7,471047,471047,471233,0,186,471337,true,L-s-0 L-s-0 L-s-0 L-s-0 L-m-0 L-m-0 L-m-0 
job-9431,1,12,3,471150,471150,471239,0,89,471277,true,L-m-0 L-l-0 L-l-0 
job-9433,6,4,7,471233,471233,471331,0,98,471567,true,L-m-0 C-m-0 C-m-1 C-m-2 C-l-2 C-l-2 C-l-1 
job-9432,1,11,2,471188,471188,471350,0,162,471596,true,L-l-0 L-l-0 
job-9435,6,6,8,471335,471335,471372,0,37,471435,true,L-m-0 L-l-0 C-m-0 C-m-1 C-m-2 C-l-2 C-l-2 C-l-1 
job-9434,1,4,5,471288,471288,471444,0,156,471544,true,L-m-0 L-m-0 L-l-0 L-l-0 L-l-0 
job-9437,1,5,2,471433,471433,471506,0,73,471528,true,L-l-0 L-l-0 
job-9439,5,10,5,471510,471510,471545,0,35,471649,true,C-m-0 C-m-1 C-m-2 C-l-2 C-l-2 
job-9436,1,7,4,471385,471385,471560,0,175,471750,true,L-m-0 L-m-0 L-m-0 L-l-0 
job-9440,4,4,3,471560,471560,471593,0,33,471646,true,L-m-0 L-l-0 C-s-0 
job-9438,4,11,6,471474,471474,471687,0,213,471933,true,L-m-0 L-l-0 L-l-0 L-s-0 C-s-2 C-s-1 
job-9441,1,10,2,471608,471608,471724,0,116,471998,true,L-m-0 L-m-0 
job-9443,1,8,3,471708,471708,471728,0,20,471740,true,L-m-0 L-l-0 L-l-0 
job-9442,1,7,8,471668,471668,471732,0,64,471787,true,L-l-0 L-l-0 L-l-0 C-s-0 C-s-0 C-m-0 C-m-0 C-m-0 
job-9445,2,10,3,471796,471796,471817,0,21,471855,true,L-l-0 L-l-0 L-l-0 
job-9447,2,9,1,471895,471895,471926,0,31,472083,true,L-l-0 
job-9446,2,9,4,471851,471851,471936,0,85,472082,true,L-l-0 L-l-0 L-l-0 L-l-0 
job-9444,2,8,5,471748,471748,471940,0,192,472139,true,L-s-0 L-s-0 L-m-0 L-m-0 L-m-0 
job-9449,6,12,4,471993,471993,472069,0,76,472342,true,C-l-2 C-l-2 C-l-1 C-l-1 
job-9448,6,12,6,471944,471944,472115,0,171,472339,true,L-m-0 L-l-0 L-l-0 C-m-0 C-m-1 C-m-2 
job-9451,4,4,5,472092,472092,472159,0,67,472180,true,L-s-0 C-s-0 C-s-2 C-s-1 C-l-2 
job-9450,1,5,3,472044,472044,472162,0,118,472191,true,L-m-0 L-m-0 C-m-0 
job-9452,6,7,2,472156,472156,472169,0,13,472352,true,L-m-0 C-m-0 
job-9453,5,9,8,472201,472201,472214,0,13,472382,true,L-m-0 L-l-0 L-l-0 C-m-0 C-m-1 C-m-2 C-l-2 C-l-2 
job-9454,4,7,6,472246,472246,472319,0,73,472521,true,L-s-0 L-m-0 L-m-0 L-l-0 L-l-0 L-l-0 
job-9455,2,7,3,472299,472299,472346,0,47,472578,true,C-s-0 C-s-0 C-s-2 
job-9456,3,7,1,472356,472356,472451,0,95,472633,true,L-s-0 
job-9457,1,6,8,472401,472401,472482,0,81,472705,true,L-s-0 L-m-0 L-m-0 L-m-0 L-m-0 L-m-0 L-l-0 L-l-0 
job-9458,5,6,2,472461,472461,472489,0,28,472742,true,L-l-0 L-l-0 
job-9459,6,12,8,472514,472514,472571,0,57,472771,true,L-m-0 L-l-0 L-l-0 C-m-0 C-m-1 C-m-2 C-l-2 C-l-2 
job-9460,1,5,6,472567,472567,472599,0,32,472618,true,L-m-0 L-m-0 C-m-0 C-m-0 C-m-1 C-m-1 
job-9461,2,8,5,472616,472616,472693,0,77,472865,true,L-s-0 L-s-0 L-m-0 L-m-0 L-m-0 
job-9463,4,8,3,472744,472744,472760,0,16,472815,true,L-s-0 L-m-0 L-m-0 
job-9462,4,5,3,472672,472672,472836,0,164,473047,true,L-l-0 L-l-0 L-l-0 
job-9465,2,12,3,472859,472859,472947,0,88,472948,true,L-m-0 C-m-0 L-l-0 
job-9467,6,9,4,472959,472959,472969,0,10,473132,true,L-l-0 C-l-1 C-l-1 C-l-0 
job-9466,6,8,5,472911,472911,472978,0,67,473133,true,L-l-0 C-m-1 C-m-2 C-l-2 C-l-2 
job-9464,3,10,7,472803,472803,473066,0,263,473067,true,L-s-0 L-m-0 L-m-0 C-s-0 C-s-2 C-s-1 C-m-0 
job-9468,6,9,7,473012,473012,473086,0,74,473316,true,L-l-0 L-l-0 C-m-1 C-m-2 C-l-2 C-l-2 C-l-1 
job-9469,5,5,6,473062,473086,473158,24,72,473316,true,L-m-0 L-l-0 L-l-0 C-m-1 C-m-2 C-m-0 
job-9470,6,10,6,473110,473110,473202,0,92,473334,true,C-l-2 C-l-2 C-l-1 C-l-1 C-l-0 C-l-0 
job-9472,1,4,3,473206,473206,473251,0,45,473416,true,L-s-0 L-m-0 L-m-0 
job-9474,1,8,8,473313,473313,473356,0,43,473451,true,L-s-0 L-m-0 L-m-0 L-l-0 L-l-0 L-l-0 C-m-2 C-m-2 
job-9475,6,9,1,473360,473360,473423,0,63,473575,true,C-m-0 
job-9473,4,6,6,473263,473263,473429,0,166,473509,true,C-s-0 C-s-2 C-s-1 C-m-1 C-m-1 C-m-2 
job-9476,3,10,4,473400,473400,473484,0,84,473676,true,L-l-0 C-m-2 C-l-2 C-l-2 
job-9478,6,12,1,473504,473504,473611,0,107,473784,true,C-l-0 
job-9477,6,9,8,473453,473484,473643,31,159,473834,true,C-m-2 C-m-1 C-m-0 C-l-2 C-l-2 C-l-1 C-l-1 C-l-0 
job-9471,3,7,6,473166,473166,473645,0,479,473661,true,L-s-0 L-m-0 L-m-0 L-l-0 L-l-0 L-l-0 
job-9481,4,12,7,473660,473660,473678,0,18,473780,true,C-m-2 L-s-0 L-m-0 L-m-0 L-l-0 L-l-0 L-l-0 
job-9480,4,6,5,473609,473643,473705,34,62,473745,true,C-l-0 C-s-0 C-s-2 C-s-1 C-m-2 
job-9479,6,11,1,473563,473611,473756,48,145,473868,true,C-l-0 
job-9484,3,11,2,473811,473811,473826,0,15,473984,true,C-m-2 C-m-2 
job-9485,1,12,8,473866,473866,473878,0,12,474053,true,L-m-0 C-l-0 C-l-0 C-m-2 C-m-2 C-m-1 C-m-1 C-m-0 
job-9483,4,9,5,473761,473761,473909,0,148,473986,true,C-l-0 L-s-0 C-s-0 C-s-2 C-s-1 
job-9486,5,10,2,473922,473922,473995,0,73,474010,true,C-l-0 C-m-2 
job-9487,3,12,5,473977,473977,474077,0,100,474261,true,C-m-2 L-s-0 C-s-0 C-s-2 C-s-1 
job-9488,6,9,8,474022,474077,474166,55,89,474320,true,C-l-0 C-m-2 C-m-1 C-m-0 C-l-2 C-l-2 C-l-1 C-l-1 
job-9490,5,9,1,474124,474166,474182,42,16,474144,false,C-m-1 
job-9491,5,7,1,474189,474189,474227,0,38,474466,true,C-m-1 
job-9482,6,9,4,473707,473707,474317,0,610,474455,true,C-l-0 L-m-0 L-l-0 L-l-0 
job-9493,4,10,3,474267,474267,474350,0,83,474357,true,C-m-1 C-m-0 C-m-0 
job-9492,1,8,4,474224,474224,474364,0,140,474467,true,L-m-0 L-m-0 C-m-2 C-m-1 
job-9489,3,10,8,474067,474166,474378,99,212,474463,true,C-l-0 C-l-0 L-s-0 C-s-0 C-s-2 C-s-1 C-m-2 C-m-2 
job-9495,2,11,1,474372,474372,474391,0,19,474673,true,L-m-0 
job-9496,6,5,1,474426,474426,474501,0,75,474539,true,C-l-0 
job-9494,6,10,5,474318,474318,474549,0,231,474586,true,L-m-0 C-l-0 L-l-0 L-l-0 C-l-2 
job-9498,1,4,5,474511,474511,474591,0,80,474691,true,C-l-2 C-l-2 C-l-2 C-l-0 C-l-0 
job-9497,1,7,5,474470,474470,474608,0,138,474894,true,L-m-0 L-m-0 C-l-2 C-l-2 C-l-2 
job-9500,4,9,8,474602,474602,474654,0,52,474874,true,C-l-2 C-l-2 L-s-0 L-l-0 L-l-0 L-l-0 C-s-0 C-s-2 
job-9501,2,12,8,474658,474658,474707,0,49,474951,true,L-m-0 L-s-0 L-l-0 L-l-0 L-l-0 L-l-0 C-s-0 C-s-2 
job-9499,6,6,1,474553,474553,474724,0,171,474998,true,L-m-0 
job-9503,2,12,5,474764,474764,474782,0,18,474977,true,L-l-0 C-m-2 C-m-0 C-m-1 C-l-2 
job-9502,5,11,8,474710,474710,474798,0,88,475089,true,L-l-0 L-l-0 C-m-2 C-m-0 C-m-1 C-l-2 C-l-2 C-l-0 
job-9504,6,6,3,474807,474807,474883,0,76,475126,true,L-m-0 L-l-0 L-l-0 
job-9507,1,12,5,474933,474933,474993,0,60,475271,true,L-m-0 L-l-0 L-l-0 L-l-0 L-l-0 
job-9505,4,10,8,474853,474853,475002,0,149,475094,true,L-s-0 C-s-0 C-s-2 C-s-1 C-m-2 C-m-2 C-m-0 C-m-0 
job-9506,2,6,3,474889,474889,475009,0,120,475271,true,L-m-0 L-m-0 L-m-0 
job-9509,4,8,8,475024,475024,475150,0,126,475217,true,C-l-2 C-l-2 L-s-0 L-m-0 L-m-0 L-l-0 L-l-0 L-l-0 
job-9510,2,8,1,475062,475062,475157,0,95,475175,true,C-l-2 
job-9512,6,6,8,475165,475165,475224,0,59,475519,true,C-l-2 L-m-0 L-l-0 L-l-0 C-m-2 C-m-0 C-l-0 C-l-0 
job-9513,3,6,1,475208,475208,475263,0,55,475536,true,C-l-2 
job-9511,2,10,2,475115,475115,475291,0,176,475318,true,C-s-0 C-s-2 
job-9508,1,8,5,474976,474976,475330,0,354,475594,true,C-m-1 C-m-1 C-m-1 C-m-1 C-l-2 
job-9516,5,7,6,475356,475356,475380,0,24,475551,true,C-m-1 C-m-0 C-l-0 C-l-0 C-l-1 C-l-1 
job-9514,6,6,4,475268,475268,475382,0,114,475677,true,C-l-2 L-m-0 L-l-0 L-l-0 
job-9517,1,11,7,475421,475421,475441,0,20,475642,true,C-m-2 C-m-2 C-l-2 C-l-2 C-l-2 L-s-0 L-m-0 
job-9515,5,6,2,475316,475316,475525,0,209,475624,true,C-l-2 C-m-2 
job-9518,6,4,5,475482,475482,475571,0,89,475837,true,C-l-2 L-m-0 L-l-0 L-l-0 C-m-1 
job-9519,6,9,5,475543,475543,475579,0,36,475792,true,C-l-2 C-m-2 C-m-0 C-l-0 C-l-0 
job-9520,3,8,2,475585,475585,475602,0,17,475621,true,L-s-0 L-m-0 
job-9522,1,11,3,475677,475677,475704,0,27,475786,true,C-s-0 C-s-2 C-s-1 
job-9521,4,11,6,475628,475628,475733,0,105,475952,true,L-s-0 L-m-0 L-m-0 L-l-0 L-l-0 L-l-0 
job-9523,5,11,7,475721,475721,476011,0,290,476280,true,C-m-1 C-m-2 C-m-0 C-l-2 C-l-2 C-l-0 C-l-0 
job-9525,3,12,4,475825,476011,476039,186,28,475881,false,L-s-0 C-s-0 C-s-2 C-s-1 
job-9526,4,12,7,475881,476011,476045,130,34,475976,false,C-l-2 C-l-2 C-l-2 C-l-0 C-l-0 C-l-0 C-l-1 
job-9528,3,7,3,475991,476045,476065,54,20,476208,true,C-l-0 C-l-0 C-l-1 
job-9524,6,11,6,475775,476011,476079,236,68,475933,false,L-m-0 L-l-0 L-l-0 C-m-1 C-m-2 C-m-0 
job-9527,4,6,8,475931,476045,476097,114,52,476106,true,L-s-0 C-s-0 C-s-2 C-s-1 C-l-2 C-l-2 C-l-2 C-l-0 
job-9530,3,9,5,476085,476085,476113,0,28,476372,true,L-m-0 L-m-0 C-m-1 C-m-1 C-m-2 
job-9529,2,5,7,476032,476045,476122,13,77,476230,true,L-m-0 C-m-1 C-m-2 C-m-0 C-l-0 C-l-1 C-l-1 
job-9532,2,4,6,476175,476175,476341,0,166,476377,true,L-m-0 C-s-0 C-s-0 C-s-2 C-s-2 C-s-1 
job-9534,2,4,8,476282,476282,476382,0,100,476548,true,C-s-1 C-l-2 C-l-2 C-l-2 C-l-2 C-l-2 C-l-2 C-l-0 
job-9531,3,11,7,476128,476128,476399,0,271,476642,true,L-s-0 L-m-0 L-m-0 L-l-0 L-l-0 L-l-0 L-l-0 
job-9535,3,6,2,476331,476331,476427,0,96,476523,true,C-l-0 C-l-0 
job-9537,4,6,4,476438,476438,476449,0,11,476559,true,C-l-0 C-l-0 C-l-1 C-l-1 
job-9533,4,11,6,476229,476229,476499,0,270,476732,true,C-m-1 C-m-1 C-m-2 C-m-2 C-m-0 C-m-0 
job-9536,1,12,7,476381,476381,476513,0,132,476645,true,C-s-1 C-l-0 C-l-0 C-s-0 C-s-2 C-l-1 C-l-1 
job-9538,6,8,4,476494,476494,476732,0,238,476963,true,C-l-0 C-l-1 L-m-0 L-l-0 
job-9541,6,9,2,476644,476644,476814,0,170,477102,true,C-m-0 C-l-2 
job-9540,4,10,5,476592,476592,476826,0,234,476967,true,C-s-0 C-s-2 C-m-1 C-m-1 C-m-2 
job-9542,2,11,6,476699,476699,476844,0,145,477086,true,L-m-0 C-m-0 C-m-2 C-m-2 C-l-2 C-l-2 
job-9539,3,10,8,476543,476543,476868,0,325,477107,true,L-l-0 L-l-0 C-l-0 C-l-0 C-l-1 C-l-1 L-s-0 C-s-1 
job-9543,4,4,6,476753,476814,476872,61,58,477086,true,L-m-0 L-l-0 C-m-0 C-l-0 C-l-1 C-l-2 
job-9544,3,9,6,476803,476826,476887,23,61,477117,true,C-m-2 C-l-2 C-s-0 C-s-2 C-m-1 C-m-1 
job-9546,6,7,3,476878,476878,476894,0,16,477067,true,L-m-0 L-l-0 C-m-0 
job-9545,2,4,4,476836,476836,476923,0,87,477199,true,L-m-0 L-l-0 C-m-1 C-m-0 
job-9549,4,7,4,477043,477043,477099,0,56,477207,true,C-s-1 C-m-1 C-m-1 C-m-2 
job-9547,4,11,2,476940,476940,477127,0,187,477254,true,L-s-0 L-m-0 
job-9548,3,12,7,476994,476994,477132,0,138,477146,true,L-m-0 L-l-0 L-l-0 L-l-0 L-l-0 C-s-0 C-s-2 
job-9551,5,5,3,477146,477146,477196,0,50,477274,true,L-m-0 L-l-0 L-l-0 
job-9550,6,5,5,477092,477092,477233,0,141,477296,true,C-m-0 C-l-2 C-l-2 C-l-0 C-l-0 
job-9552,3,10,5,477205,477205,477346,0,141,477498,true,L-s-0 L-m-0 L-m-0 L-l-0 L-l-0 
job-9554,2,12,3,477300,477300,477348,0,48,477418,true,L-m-0 C-m-1 C-m-2 
job-9553,3,11,8,477255,477255,477365,0,110,477594,true,L-l-0 L-l-0 C-s-0 C-s-2 C-s-1 C-m-0 C-m-0 C-m-1 
job-9555,3,7,5,477357,477357,477380,0,23,477445,true,L-l-0 L-l-0 C-m-1 L-s-0 L-m-0 
job-9556,1,8,6,477406,477406,477513,0,107,477524,true,L-s-0 L-s-0 L-m-0 L-m-0 L-m-0 L-m-0 
job-9557,5,4,1,477451,477451,477539,0,88,477594,true,L-l-0 
job-9558,3,9,8,477510,477510,477602,0,92,477723,true,L-l-0 L-l-0 C-s-0 C-s-2 C-s-1 C-m-0 C-m-0 C-m-1 
job-9561,5,9,7,477643,477643,477677,0,34,477855,true,L-l-0 C-m-0 C-m-2 C-l-2 C-l-2 C-l-0 C-l-0 
job-9560,2,4,6,477593,477593,477729,0,136,478012,true,C-m-1 C-m-0 L-m-0 L-m-0 L-m-0 L-m-0 
job-9562,3,12,8,477695,477695,477811,0,116,478044,true,L-l-0 L-l-0 C-m-1 C-m-0 C-m-0 C-s-0 C-s-2 C-s-1 
job-9559,3,12,4,477553,477553,477833,0,280,478128,true,L-l-0 L-l-0 C-m-1 L-s-0 
job-9566,4,5,4,477879,477879,477932,0,53,478202,true,L-l-0 L-s-0 C-s-0 C-s-2 
job-9564,4,6,8,477787,477787,477956,0,169,478127,true,C-m-2 C-l-2 C-l-2 C-l-2 C-l-0 C-l-0 C-l-0 C-l-1 
job-9563,2,10,5,477744,477744,477986,0,242,478133,true,L-m-0 L-m-0 L-m-0 C-m-2 C-m-2 
job-9567,3,11,6,477930,477932,477991,2,59,478032,true,L-l-0 L-l-0 L-s-0 C-s-0 C-s-2 C-s-1 
job-9565,6,6,3,477832,477832,477994,0,162,478202,true,L-l-0 C-l-1 C-m-0 
job-9568,5,8,4,477990,477990,478001,0,11,478269,true,C-l-1 L-m-0 C-m-2 C-m-1 
job-9570,6,11,4,478085,478085,478106,0,21,478317,true,L-l-0 C-m-0 C-m-2 C-m-1 
job-9569,1,11,4,478043,478043,478173,0,130,478304,true,L-s-0 L-m-0 L-m-0 L-l-0 
job-9571,2,10,8,478133,478133,478180,0,47,478218,true,L-m-0 L-l-0 L-l-0 L-l-0 C-s-0 C-s-2 C-s-1 C-m-0 
job-9573,6,9,4,478231,478231,478256,0,25,478526,true,L-l-0 L-l-0 C-m-0 C-m-2 
job-9572,2,6,6,478181,478181,478342,0,161,478480,true,L-s-0 L-s-0 L-m-0 L-m-0 L-m-0 L-m-0 
job-9574,5,7,8,478270,478270,478386,0,116,478491,true,L-l-0 L-l-0 C-m-0 C-m-2 C-m-1 C-l-1 C-l-1 C-l-2 
job-9575,1,7,5,478324,478324,478474,0,150,478565,true,L-l-0 L-l-0 C-m-0 C-m-0 C-m-0 
job-9576,6,4,6,478370,478386,478506,16,120,478689,true,L-l-0 L-m-0 C-m-2 C-m-1 C-l-1 C-l-1 
job-9577,5,5,5,478406,478406,478507,0,101,478655,true,C-m-0 C-l-2 C-l-2 C-l-0 C-l-0 
job-9580,6,7,2,478537,478537,478558,0,21,478827,true,C-l-1 C-l-1 
job-9579,5,8,7,478483,478507,478576,24,69,478578,true,C-m-0 C-m-2 C-m-1 C-l-2 C-l-2 C-l-0 C-l-0 
job-9581,1,6,8,478580,478580,478617,0,37,478880,true,L-m-0 L-m-0 L-s-0 L-s-0 C-s-0 C-s-0 C-s-2 C-s-2 
job-9583,3,6,2,478688,478688,478708,0,20,478745,true,L-s-0 C-s-0 
job-9578,6,7,3,478445,478506,478742,61,236,478708,false,L-m-0 L-l-0 L-l-0 
job-9584,5,4,6,478732,478732,478742,0,10,478840,true,C-l-2 C-l-2 C-l-0 C-l-0 C-l-1 C-l-1 
job-9586,2,11,5,478826,478826,478838,0,12,478907,true,C-m-0 C-m-2 C-m-1 C-s-0 C-s-2 
job-9582,6,12,3,478638,478638,478843,0,205,479122,true,C-m-0 C-m-2 C-m-1 
job-9585,4,8,6,478779,478779,478914,0,135,479151,true,L-s-0 L-m-0 L-m-0 L-l-0 L-l-0 L-l-0 
job-9587,3,9,4,478876,478876,478919,0,43,478975,true,C-s-0 C-s-2 C-s-1 C-m-0 
job-9588,5,8,4,478934,478934,479062,0,128,479145,true,L-m-0 L-l-0 L-l-0 C-m-0 
job-9589,5,6,8,478979,478979,479113,0,134,479270,true,C-m-2 C-m-1 C-l-2 C-l-2 C-l-0 C-l-0 C-l-1 C-l-1 
job-9592,5,10,2,479129,479129,479155,0,26,479343,true,C-m-0 C-l-2 
job-9590,6,9,5,479024,479113,479205,89,92,479350,true,L-m-0 L-l-0 L-l-0 C-m-2 C-m-1 
job-9591,4,10,3,479085,479113,479207,28,94,479397,true,L-s-0 C-s-0 C-s-2 
job-9594,4,12,8,479215,479215,479246,0,31,479284,true,L-s-0 L-m-0 L-m-0 L-l-0 L-l-0 L-l-0 C-s-0 C-s-2 
job-9595,2,4,1,479269,479269,479340,0,71,479577,true,C-m-0 
job-9593,5,10,7,479165,479165,479417,0,252,479475,true,C-m-0 C-l-2 C-l-2 C-l-0 C-l-0 C-l-1 C-l-1 
job-9597,2,6,3,479375,479375,479446,0,71,479556,true,C-m-0 C-l-0 C-l-1 
job-9598,2,6,4,479431,479431,479481,0,50,479755,true,C-m-0 C-m-0 C-l-0 C-l-0 
job-9596,1,6,2,479330,479330,479510,0,180,479630,true,C-m-0 C-l-2 
job-9599,5,4,2,479482,479482,479511,0,29,479620,true,C-m-0 C-l-2 
job-9600,6,11,1,479528,479528,479641,0,113,479747,true,L-m-0 
job-9602,2,12,8,479609,479609,479660,0,51,479917,true,L-m-0 C-m-0 C-m-2 L-s-0 C-s-0 C-s-2 C-s-1 C-m-1 
job-9603,2,9,4,479654,479654,479701,0,47,479773,true,L-m-0 L-m-0 C-m-1 C-m-1 
job-9601,6,10,4,479567,479567,479831,0,264,480022,true,L-l-0 L-l-0 C-m-0 C-m-2 
job-9605,5,10,2,479768,479768,479849,0,81,480069,true,C-m-1 C-l-2 
job-9606,6,4,7,479810,479831,479878,21,47,479882,true,C-l-2 L-l-0 L-l-0 C-m-0 C-m-2 C-l-0 C-l-0 
job-9607,4,4,7,479865,479865,479930,0,65,480134,true,C-l-2 L-s-0 C-s-0 C-s-2 C-s-1 C-m-1 C-m-1 
job-9604,6,5,1,479709,479709,479978,0,269,480039,true,L-m-0 
job-9609,2,8,8,479949,479949,480031,0,82,480070,true,L-m-0 C-l-2 C-l-2 L-s-0 L-s-0 C-s-0 C-s-0 C-s-2 
job-9611,3,5,2,480056,480056,480135,0,79,480415,true,L-m-0 L-m-0 
job-9610,1,9,1,479997,479997,480150,0,153,480448,true,L-m-0 
job-9614,6,4,7,480198,480198,480211,0,13,480325,true,L-m-0 C-m-0 C-m-2 C-l-0 C-l-0 C-l-1 C-l-1 
job-9608,4,4,5,479917,479917,480222,0,305,480444,true,C-l-2 C-l-2 L-l-0 L-l-0 L-l-0 
job-9613,1,5,1,480157,480157,480309,0,152,480401,true,L-s-0 
job-9612,3,11,7,480115,480115,480345,0,230,480410,true,C-l-2 L-s-0 C-s-0 C-s-2 C-s-1 C-m-1 C-m-1 
job-9616,2,6,7,480330,480330,480489,0,159,480769,true,L-m-0 L-m-0 L-m-0 L-m-0 L-l-0 L-l-0 L-l-0 
job-9617,3,5,6,480384,480384,480501,0,117,480789,true,L-l-0 L-l-0 C-m-1 C-m-1 C-l-2 L-s-0 
job-9619,4,6,7,480483,480483,480509,0,26,480722,true,C-s-2 C-s-1 C-m-0 C-m-0 C-m-2 C-m-2 C-l-0 
job-9618,2,4,1,480435,480435,480552,0,117,480810,true,C-s-0 
job-9615,2,4,5,480266,480266,480555,0,289,480809,true,C-m-1 C-l-2 C-l-2 C-l-2 C-l-2 
job-9621,5,12,2,480596,480596,480618,0,22,480904,true,C-l-2 L-m-0 
job-9620,4,12,2,480551,480551,480656,0,105,480793,true,C-m-1 C-l-2 
job-9623,6,11,1,480696,480696,480717,0,21,480832,true,L-m-0 
job-9624,5,7,3,480736,480736,480755,0,19,480966,true,L-m-0 L-l-0 L-l-0 
job-9625,1,11,7,480779,480779,480822,0,43,480962,true,C-m-1 L-s-0 L-m-0 L-m-0 L-l-0 L-l-0 L-l-0 
job-9622,4,11,1,480643,480643,480838,0,195,481008,true,C-m-1 
job-9627,2,8,2,480889,480889,480912,0,23,480994,true,L-m-0 L-s-0 
job-9628,5,10,2,480949,480949,481047,0,98,481135,true,L-l-0 L-l-0 
job-9630,5,12,6,481032,481032,481069,0,37,481076,true,C-m-1 C-m-0 C-m-2 C-l-2 C-l-2 C-l-0 
job-9629,1,4,4,480985,480985,481127,0,142,481381,true,L-m-0 L-m-0 L-m-0 L-l-0 
job-9631,6,8,5,481088,481088,481176,0,88,481446,true,L-l-0 C-m-1 C-m-0 C-m-2 C-l-2 
job-9626,5,4,1,480830,480830,481248,0,418,481360,true,L-m-0 
job-9632,5,7,5,481140,481140,481336,0,196,481619,true,L-l-0 C-l-2 C-l-0 C-l-0 C-l-1 
job-9634,4,10,2,481237,481336,481389,99,53,481387,false,L-s-0 C-s-0 
job-9633,5,8,8,481185,481336,481443,151,107,481513,true,L-m-0 L-l-0 L-l-0 C-m-1 C-m-0 C-m-2 C-l-0 C-l-0 
job-9636,5,11,6,481342,481443,481517,101,74,481654,true,C-l-0 C-l-0 C-l-2 C-l-2 C-l-1 C-l-1 
job-9638,2,7,8,481451,481517,481532,66,15,481479,false,L-m-0 C-m-1 C-m-0 C-m-2 C-l-0 C-l-0 C-l-0 C-l-0 
job-9637,3,12,5,481402,481517,481671,115,154,481564,false,L-s-0 C-s-0 C-s-2 C-s-1 C-l-0 
job-9635,6,11,6,481286,481443,481857,157,414,481941,true,L-m-0 L-l-0 L-l-0 C-m-1 C-m-0 C-m-2 
job-9641,4,9,7,481589,481857,481885,268,28,481666,false,L-s-0 C-s-0 C-s-2 C-s-1 C-l-2 C-l-2 C-l-2 
job-9640,4,11,1,481539,481857,481924,318,67,481887,false,C-l-0 
job-9644,5,7,2,481733,481885,481977,152,92,481841,false,C-l-2 C-l-2 
job-9645,3,5,4,481774,481924,481984,150,60,482101,true,C-l-0 C-l-0 C-s-2 C-s-1 
job-9642,4,7,1,481633,481857,482008,224,151,481876,false,C-l-1 
job-9647,3,11,2,481886,481977,482022,91,45,482169,true,C-l-2 C-l-2 
job-9648,5,9,3,481944,482022,482033,78,11,482063,true,C-l-0 C-l-2 C-l-2 
job-9643,4,9,4,481683,481885,482103,202,218,482197,true,C-l-1 C-l-1 L-s-0 C-s-0 
job-9646,1,9,5,481830,481924,482126,94,202,482107,false,L-m-0 L-m-0 C-s-2 C-s-1 C-m-1 
job-9639,6,7,7,481495,481857,482131,362,274,481821,false,L-m-0 L-l-0 L-l-0 C-m-1 C-m-0 C-m-2 C-l-0 
job-9652,3,6,3,482154,482154,482197,0,43,482479,true,C-l-1 C-l-1 C-l-1 
job-9650,1,10,3,482056,482056,482224,0,168,482306,true,C-m-1 C-m-0 C-m-0 
job-9653,3,5,3,482205,482205,482246,0,41,482535,true,C-l-1 C-l-1 C-l-1 
job-9651,6,9,4,482106,482131,482249,25,118,482224,false,C-m-0 C-m-1 C-l-0 C-l-2 
job-9649,3,4,7,481995,482033,482269,38,236,482312,true,C-s-2 C-s-1 C-l-1 C-l-0 C-l-0 C-l-2 C-l-2 
job-9654,4,7,3,482252,482252,482311,0,59,482532,true,C-l-0 C-l-2 C-l-1 
job-9655,4,5,3,482292,482292,482330,0,38,482484,true,C-l-0 C-l-0 C-l-2 
job-9656,2,7,5,482349,482349,482378,0,29,482598,true,L-s-0 L-s-0 L-m-0 L-m-0 L-m-0 
job-9657,4,9,2,482392,482392,482424,0,32,482601,true,L-s-0 L-m-0 
job-9658,5,12,2,482450,482450,482479,0,29,482777,true,L-m-0 L-l-0 
job-9659,5,7,7,482499,482499,482509,0,10,482678,true,L-m-0 L-l-0 L-l-0 C-m-0 C-m-1 C-m-2 C-l-0 
job-9660,3,11,7,482547,482547,482558,0,11,482676,true,L-s-0 L-m-0 L-m-0 L-l-0 L-l-0 L-l-0 L-l-0 
job-9661,5,7,5,482595,482595,482650,0,55,482834,true,L-m-0 L-l-0 L-l-0 C-m-0 C-m-1 
job-9662,2,9,5,482650,482650,482722,0,72,482966,true,L-s-0 L-m-0 L-m-0 L-m-0 L-l-0 
job-9664,1,11,4,482751,482751,482917,0,166,483163,true,L-l-0 L-l-0 L-l-0 L-m-0 
job-9665,3,7,6,482796,482796,482945,0,149,483126,true,L-s-0 L-m-0 L-m-0 C-s-2 C-s-1 C-s-0 
job-9666,1,10,6,482847,482847,482952,0,105,482952,false,C-m-0 C-m-0 C-m-0 C-m-1 C-m-1 C-m-1 
job-9669,4,9,1,482991,482991,483025,0,34,483087,true,L-m-0 
job-9668,2,10,8,482930,482930,483030,0,100,483224,true,L-m-0 L-l-0 L-l-0 L-l-0 C-l-0 C-l-0 C-l-0 C-l-0 
job-9663,1,6,3,482707,482707,483076,0,369,483221,true,L-s-0 L-l-0 L-l-0 
job-9667,2,9,3,482887,482887,483121,0,234,483241,true,C-m-2 C-m-2 C-m-2 
job-9670,1,6,8,483047,483047,483123,0,76,483406,true,L-s-0 L-l-0 L-l-0 L-l-0 L-l-0 L-l-0 L-l-0 L-m-0 
job-9671,3,7,5,483090,483090,483242,0,152,483353,true,L-s-0 L-m-0 L-m-0 L-l-0 C-s-2 
job-9674,6,10,5,483238,483238,483319,0,81,483368,true,C-m-0 C-m-1 C-l-0 C-l-0 C-l-2 
job-9672,4,12,2,483137,483137,483339,0,202,483460,true,L-l-0 L-l-0 
job-9673,2,9,6,483184,483184,483378,0,194,483595,true,L-m-0 C-s-1 C-s-0 C-m-2 C-m-2 C-m-2 
job-9675,5,5,4,483292,483292,483490,0,198,483777,true,L-m-0 C-l-2 C-l-1 C-l-1 
job-9679,2,8,7,483487,483487,483506,0,19,483650,true,L-m-0 C-m-2 C-m-0 C-m-0 C-m-1 C-m-1 C-m-1 
job-9677,4,10,8,483393,483393,483540,0,147,483545,true,C-l-2 L-s-0 L-l-0 L-l-0 L-l-0 C-s-1 C-s-0 C-s-2 
job-9676,1,10,5,483345,483345,483548,0,203,483774,true,L-m-0 C-l-1 C-l-1 C-l-2 C-l-2 
job-9680,3,4,6,483525,483525,483602,0,77,483720,true,L-m-0 L-m-0 C-m-0 C-l-2 C-l-2 C-l-1 
job-9681,3,11,1,483576,483576,483657,0,81,483934,true,C-l-2 
job-9678,3,12,3,483446,483446,483667,0,221,483957,true,C-m-2 C-m-2 C-m-0 
job-9683,2,5,8,483691,483691,483707,0,16,483973,true,C-m-0 C-m-0 C-l-2 C-l-2 L-m-0 L-m-0 L-m-0 L-m-0 
job-9682,4,4,4,483632,483632,483778,0,146,484030,true,C-m-0 C-l-2 C-l-2 L-s-0 
job-9685,2,8,4,483790,483790,483813,0,23,483999,true,L-l-0 L-l-0 C-m-0 C-m-0 
job-9686,4,4,3,483833,483833,483908,0,75,484022,true,L-l-0 C-m-0 C-l-2 
job-9684,4,9,6,483744,483744,483910,0,166,484087,true,C-m-0 C-l-2 L-m-0 L-m-0 L-l-0 L-l-0 
job-9687,3,5,7,483880,483880,483944,0,64,484040,true,C-l-2 L-s-0 C-s-1 C-s-0 C-s-2 C-m-2 C-m-2 
job-9688,4,9,8,483923,483923,484012,0,89,484204,true,C-l-2 C-l-2 L-m-0 L-m-0 L-l-0 L-l-0 L-l-0 C-m-0 
job-9689,2,4,4,483968,483968,484052,0,84,484244,true,C-m-0 C-m-0 C-l-2 C-l-2 
job-9690,5,6,8,484021,484021,484125,0,104,484175,true,C-l-2 L-m-0 L-l-0 L-l-0 C-m-2 C-m-1 C-l-1 C-l-1 
job-9691,6,5,6,484074,484125,484147,51,22,484191,true,L-m-0 L-l-0 L-l-0 C-m-2 C-m-1 C-m-0 
job-9695,1,10,2,484282,484282,484292,0,10,484491,true,L-l-0 L-l-0 
job-9692,1,5,8,484134,484134,484297,0,163,484504,true,L-m-0 L-m-0 C-m-2 C-m-2 C-m-1 C-m-1 C-m-0 C-m-0 
job-9693,3,12,7,484186,484186,484374,0,188,484628,true,L-m-0 C-m-2 C-m-1 C-m-0 L-s-0 L-l-0 L-l-0 
job-9694,2,5,1,484234,484234,484376,0,142,484586,true,L-m-0 
job-9697,4,4,6,484381,484381,484436,0,55,484600,true,L-l-0 C-l-2 L-s-0 L-m-0 L-m-0 C-s-1 
job-9696,5,7,7,484338,484338,484488,0,150,484708,true,L-l-0 C-m-2 C-m-1 C-m-0 C-l-1 C-l-1 C-l-2 
job-9698,2,5,3,484430,484430,484505,0,75,484803,true,L-l-0 C-m-2 C-m-1 
job-9699,4,12,8,484484,484484,484527,0,43,484556,true,L-l-0 C-l-2 L-s-0 L-m-0 L-m-0 C-s-1 C-s-0 C-s-2 
job-9701,5,10,3,484588,484588,484712,0,124,484723,true,C-m-2 C-m-1 C-m-0 
job-9700,3,12,7,484544,484544,484731,0,187,484836,true,L-s-0 L-m-0 L-m-0 L-l-0 L-l-0 L-l-0 L-l-0 
job-9703,4,4,8,484676,484731,484743,55,12,484888,true,C-l-0 L-s-0 L-m-0 L-m-0 L-l-0 L-l-0 L-l-0 C-s-1 
job-9704,4,8,8,484727,484743,484805,16,62,485034,true,C-l-0 L-s-0 L-m-0 L-m-0 L-l-0 L-l-0 L-l-0 C-s-1 
job-9702,5,10,8,484620,484712,484908,92,196,485039,true,C-m-2 C-m-1 C-m-0 C-l-1 C-l-1 C-l-2 C-l-2 C-l-0 
job-9708,4,11,2,484928,484928,484951,0,23,485065,true,L-s-0 C-s-1 
job-9707,2,10,3,484881,484908,484955,27,47,484956,true,L-m-0 L-l-0 C-m-2 
job-9705,5,7,8,484777,484908,484976,131,68,485029,true,L-m-0 L-l-0 L-l-0 C-m-2 C-m-1 C-m-0 C-l-1 C-l-1 
job-9706,1,4,1,484828,484908,485033,80,125,485217,true,L-m-0 
job-9712,5,5,5,485129,485129,485147,0,18,485274,true,L-m-0 C-m-2 C-m-1 C-m-0 C-l-1 
job-9711,4,9,2,485086,485086,485157,0,71,485322,true,C-s-1 C-s-0 
job-9710,3,9,3,485031,485031,485182,0,151,485214,true,L-l-0 L-l-0 L-l-0 
job-9713,6,7,3,485165,485165,485213,0,48,485348,true,C-m-2 C-m-1 C-m-0 
job-9709,1,9,4,484978,484978,485283,0,305,485349,true,L-m-0 L-m-0 L-m-0 L-s-0 
job-9714,1,5,1,485217,485217,485310,0,93,485391,true,L-s-0 
job-9715,3,4,5,485268,485268,485367,0,99,485662,true,L-m-0 L-l-0 L-l-0 L-l-0 L-l-0 
job-9717,5,4,7,485375,485375,485513,0,138,485695,true,L-l-0 L-l-0 C-m-2 C-m-1 C-m-0 C-l-1 C-l-1 
job-9719,6,11,8,485471,485513,485525,42,12,485623,true,L-l-0 L-l-0 C-m-2 C-m-1 C-m-0 C-l-1 C-l-1 C-l-2 
job-9718,4,6,2,485428,485428,485538,0,110,485680,true,L-m-0 L-s-0 
job-9716,4,10,1,485322,485322,485541,0,219,485744,true,L-m-0 
job-9720,6,6,8,485509,485525,485644,16,119,485743,true,L-l-0 L-l-0 C-m-2 C-m-1 C-m-0 C-l-1 C-l-1 C-l-2 
job-9721,6,9,5,485555,485644,485661,89,17,485638,false,L-m-0 L-l-0 L-l-0 C-m-2 C-m-1 
job-9722,2,5,1,485601,485644,485696,43,52,485769,true,L-m-0 
job-9724,6,4,8,485715,485715,485725,0,10,485955,true,L-m-0 L-l-0 L-l-0 C-m-2 C-m-1 C-l-2 C-l-2 C-l-0 
job-9727,5,8,4,485875,485875,485949,0,74,486124,true,C-m-2 C-m-1 C-l-2 C-l-2 
job-9728,5,7,2,485928,485928,485951,0,23,486223,true,C-l-0 C-l-0 
job-9723,6,4,3,485648,485648,486048,0,400,486256,true,C-m-0 C-l-1 C-l-1 
job-9730,2,10,6,486026,486026,486054,0,28,486104,true,C-s-0 C-s-2 C-m-2 C-m-2 C-m-2 C-m-1 
job-9729,1,8,8,485978,485978,486066,0,88,486304,true,L-m-0 L-m-0 L-l-0 L-l-0 L-l-0 C-m-0 C-m-0 C-s-1 
job-9725,5,10,2,485772,485772,486073,0,301,486310,true,L-m-0 L-l-0 
job-9731,5,10,4,486071,486071,486100,0,29,486261,true,C-m-0 C-m-2 C-m-1 C-l-1 
job-9732,5,9,3,486123,486123,486185,0,62,486219,true,L-l-0 L-m-0 C-m-0 
job-9733,1,5,4,486178,486178,486216,0,38,486254,true,L-m-0 L-m-0 L-m-0 L-l-0 
job-9726,4,12,2,485824,485824,486218,0,394,486386,true,L-l-0 L-s-0 
job-9736,5,5,1,486310,486310,486336,0,26,486615,true,L-m-0 
job-9737,3,11,2,486353,486353,486396,0,43,486461,true,L-l-0 C-s-1 
job-9738,2,6,1,486411,486411,486448,0,37,486550,true,L-s-0 
job-9734,1,9,6,486221,486221,486464,0,243,486534,true,L-s-0 L-m-0 L-m-0 L-m-0 L-l-0 L-l-0 
job-9735,3,12,1,486273,486273,486522,0,249,486594,true,L-l-0 
job-9739,6,4,5,486461,486461,486574,0,113,486869,true,L-l-0 C-m-0 C-m-2 C-m-1 C-l-1 
job-9741,3,4,1,486565,486565,486644,0,79,486737,true,L-l-0 
job-9740,1,10,7,486504,486504,486730,0,226,487019,true,L-l-0 L-l-0 L-l-0 C-m-0 C-m-0 C-m-2 C-m-2 
job-9744,6,12,2,486719,486719,486734,0,15,486948,true,C-m-1 C-l-1 
job-9742,3,11,5,486621,486621,486797,0,176,487038,true,L-l-0 C-m-0 C-m-2 L-s-0 L-m-0 
job-9747,4,6,5,486863,486863,486889,0,26,487031,true,L-m-0 L-l-0 L-s-0 C-s-1 C-s-0 
job-9746,1,5,1,486822,486822,486893,0,71,486989,true,L-m-0 
job-9745,5,5,8,486763,486763,486934,0,171,487098,true,L-l-0 C-m-0 C-m-2 C-m-1 C-l-1 C-l-1 C-l-2 C-l-2 
job-9748,6,5,5,486918,486934,486991,16,57,487110,true,L-l-0 C-m-0 C-m-2 C-m-1 C-l-1 
job-9749,3,10,1,486955,486955,487020,0,65,487217,true,L-m-0 
job-9743,3,7,2,486666,486666,487024,0,358,487252,true,L-m-0 L-l-0 
job-9751,5,8,8,487062,487062,487111,0,49,487178,true,L-m-0 L-l-0 C-m-0 C-m-2 C-m-1 C-l-1 C-l-1 C-l-2 
job-9750,1,12,6,487011,487011,487140,0,129,487368,true,L-m-0 L-l-0 L-l-0 L-l-0 L-s-0 C-s-1 
job-9753,2,5,1,487149,487149,487179,0,30,487326,true,L-m-0 
job-9754,1,4,1,487193,487193,487215,0,22,487268,true,L-m-0 
job-9756,6,5,7,487296,487296,487344,0,48,487348,true,C-m-2 C-m-1 C-l-1 C-l-1 C-l-2 C-l-2 C-l-0 
job-9752,4,5,7,487107,487111,487369,4,258,487425,true,L-m-0 L-l-0 L-l-0 C-s-0 C-s-2 C-m-0 C-m-0 
job-9758,3,5,8,487412,487412,487444,0,32,487567,true,L-m-0 L-m-0 L-s-0 L-l-0 L-l-0 L-l-0 L-l-0 C-s-0 
job-9757,6,7,8,487354,487354,487482,0,128,487693,true,C-m-2 C-m-1 C-l-1 C-l-1 C-l-2 C-l-2 C-l-0 C-l-0 
job-9760,4,8,7,487516,487516,487527,0,11,487822,true,L-s-0 C-s-0 C-s-2 C-s-1 C-m-2 C-m-2 C-m-1 
job-9759,6,9,4,487461,487461,487546,0,85,487751,true,L-m-0 L-l-0 L-l-0 C-m-0 
job-9755,2,10,1,487244,487244,487567,0,323,487829,true,L-m-0 
job-9761,2,12,3,487569,487569,487693,0,124,487931,true,L-s-0 L-m-0 L-m-0 
job-9764,2,11,3,487719,487719,487739,0,20,487980,true,L-s-0 L-m-0 L-m-0 
job-9763,6,4,8,487661,487661,487877,0,216,488116,true,L-l-0 C-m-0 C-m-2 C-m-1 C-l-1 C-l-1 C-l-2 C-l-2 
job-9766,1,5,8,487830,487877,487910,47,33,488138,true,L-s-0 L-s-0 L-m-0 L-m-0 L-m-0 L-m-0 C-m-0 C-m-0 
job-9762,2,4,4,487613,487613,487946,0,333,488063,true,L-s-0 L-m-0 L-m-0 L-l-0 
job-9765,5,11,8,487771,487877,487981,106,104,488043,true,L-l-0 L-l-0 C-m-0 C-m-2 C-m-1 C-l-1 C-l-1 C-l-2 
job-9769,4,6,5,487972,487981,487997,9,16,488152,true,L-s-0 C-s-2 C-s-1 C-m-0 C-m-0 
job-9768,5,4,6,487910,487981,488036,71,55,487968,false,C-m-2 C-m-1 C-l-2 L-m-0 L-l-0 L-l-0 
job-9770,5,8,3,488024,488024,488078,0,54,488104,true,C-m-0 C-l-1 C-l-1 
job-9771,1,6,6,488076,488076,488086,0,10,488251,true,C-s-0 C-m-0 C-m-0 C-m-0 C-m-2 C-m-2 
job-9767,3,8,5,487875,487877,488173,2,296,488429,true,C-m-2 C-m-1 C-l-2 C-l-2 C-s-0 
job-9773,5,6,5,488171,488171,488221,0,50,488283,true,C-l-2 L-m-0 L-l-0 L-l-0 C-m-0 
job-9774,2,6,3,488223,488223,488254,0,31,488538,true,C-s-0 C-m-2 C-m-1 
job-9775,4,10,6,488272,488272,488327,0,55,488365,true,C-m-2 C-m-1 L-s-0 L-m-0 L-m-0 L-l-0 
job-9776,3,5,2,488320,488320,488330,0,10,488514,true,L-l-0 L-l-0 
job-9772,1,7,6,488121,488121,488367,0,246,488429,true,C-s-0 C-m-2 C-m-2 C-m-2 C-m-1 C-m-1 
job-9777,3,12,8,488371,488371,488483,0,112,488750,true,L-s-0 L-m-0 L-m-0 L-l-0 L-l-0 L-l-0 L-l-0 C-s-0 
job-9780,1,5,1,488531,488531,488597,0,66,488650,true,C-m-1 
job-9781,2,6,1,488579,488579,488603,0,24,488873,true,L-s-0 
job-9778,4,12,5,488423,488423,488634,0,211,488648,true,C-s-2 C-s-1 C-m-2 C-m-2 C-m-1 
job-9779,3,9,1,488482,488482,488645,0,163,488733,true,C-m-1 
job-9782,5,11,5,488627,488627,488702,0,75,488898,true,L-m-0 L-l-0 L-l-0 C-m-0 C-l-2 
job-9783,1,8,8,488677,488677,488811,0,134,488896,true,L-m-0 L-m-0 L-l-0 L-l-0 C-m-0 C-m-0 C-l-2 C-l-2 
job-9785,5,4,1,488767,488767,488828,0,61,488906,true,C-m-2 
job-9784,6,7,4,488730,488730,488855,0,125,489070,true,L-m-0 L-l-0 C-m-0 C-l-2 
job-9786,1,12,6,488811,488811,488872,0,61,488917,true,L-m-0 L-m-0 L-l-0 L-l-0 L-l-0 C-m-0 
job-9787,1,10,8,488863,488863,488905,0,42,489009,true,L-l-0 C-m-0 C-m-0 L-s-0 C-s-2 C-s-1 C-s-0 C-m-2 
job-9789,4,5,2,488956,488956,489037,0,81,489197,true,L-s-0 C-s-2 
job-9792,4,6,2,489116,489116,489151,0,35,489163,true,C-l-0 L-s-0 
job-9788,6,5,8,488911,488911,489174,0,263,489195,true,L-m-0 L-l-0 L-l-0 C-m-0 C-m-2 C-m-1 C-l-2 C-l-2 
job-9790,6,10,3,489003,489003,489233,0,230,489387,true,C-l-1 C-l-1 C-l-0 
job-9791,1,10,2,489059,489059,489235,0,176,489277,true,L-m-0 L-m-0 
job-9795,6,6,4,489257,489257,489276,0,19,489476,true,C-l-0 C-m-1 C-l-1 C-l-1 
job-9794,5,9,2,489209,489209,489278,0,69,489312,true,C-m-0 C-m-2 
job-9796,1,7,5,489300,489300,489341,0,41,489356,true,L-s-0 L-m-0 L-m-0 L-m-0 C-l-0 
job-9793,3,7,8,489170,489174,489385,4,211,489397,true,L-m-0 C-l-0 C-l-0 L-s-0 L-l-0 L-l-0 L-l-0 L-l-0 
job-9797,3,11,2,489346,489346,489387,0,41,489403,true,L-m-0 C-l-0 
job-9798,3,5,5,489399,489399,489428,0,29,489611,true,L-s-0 L-m-0 L-m-0 L-l-0 L-l-0 
job-9800,6,8,5,489519,489519,489529,0,10,489591,true,L-l-0 L-l-0 C-m-0 C-m-2 C-m-1 
job-9799,1,4,7,489455,489455,489628,0,173,489795,true,L-s-0 L-s-0 L-s-0 L-s-0 L-m-0 L-m-0 L-m-0 
job-9801,1,4,3,489568,489568,489630,0,62,489640,true,L-m-0 L-m-0 L-m-0 
job-9802,3,5,7,489617,489617,489672,0,55,489833,true,L-l-0 L-l-0 L-l-0 L-l-0 C-s-2 C-s-1 C-s-0 
job-9803,6,4,8,489664,489664,489719,0,55,489825,true,L-m-0 C-m-0 C-m-2 C-m-1 C-l-0 C-l-0 C-l-1 C-l-1 
job-9804,3,5,7,489714,489714,489759,0,45,489784,true,L-s-0 L-l-0 L-l-0 L-l-0 L-l-0 C-s-2 C-s-1 
job-9805,6,10,4,489767,489767,489793,0,26,489867,true,L-m-0 L-l-0 L-l-0 C-m-0 
job-9806,2,10,3,489814,489814,489832,0,18,489921,true,L-s-0 L-m-0 L-m-0 
job-9807,2,4,4,489873,489873,489917,0,44,490139,true,L-s-0 L-s-0 L-m-0 L-m-0 
job-9809,1,8,3,489972,489972,489983,0,11,490016,true,L-m-0 L-l-0 L-l-0 
job-9810,5,4,5,490014,490014,490024,0,10,490179,true,L-m-0 L-l-0 L-l-0 C-m-0 C-m-2 
job-9812,6,11,7,490109,490109,490119,0,10,490194,true,C-m-0 C-m-2 C-m-1 C-l-0 C-l-0 C-l-1 C-l-1 
job-9811,4,4,4,490063,490063,490124,0,61,490356,true,L-m-0 L-l-0 L-l-0 L-l-0 
job-9808,1,9,3,489918,489918,490159,0,241,490448,true,L-s-0 L-m-0 L-m-0 
job-9814,2,4,2,490219,490219,490269,0,50,490465,true,C-s-1 C-s-1 
job-9813,4,7,7,490164,490164,490298,0,134,490352,true,L-s-0 L-m-0 L-m-0 L-l-0 L-l-0 L-l-0 C-s-2 
job-9815,2,4,7,490281,490281,490355,0,74,490480,true,C-s-1 C-s-1 C-s-0 C-s-0 C-m-0 C-m-0 C-m-0 
job-9816,1,5,4,490342,490342,490387,0,45,490576,true,C-m-0 C-m-0 L-s-0 L-s-0 
job-9817,5,10,4,490398,490398,490423,0,25,490630,true,L-m-0 L-l-0 L-l-0 C-m-0 
job-9818,5,10,8,490458,490458,490538,0,80,490665,true,L-m-0 L-l-0 L-l-0 C-m-0 C-m-2 C-m-1 C-l-0 C-l-0 
job-9819,6,12,5,490506,490538,490592,32,54,490731,true,L-m-0 L-l-0 L-l-0 C-m-0 C-m-2 
job-9820,2,8,5,490546,490546,490600,0,54,490648,true,L-m-0 C-m-0 C-m-2 L-s-0 L-s-0 
job-9821,6,10,6,490600,490600,490717,0,117,490928,true,L-m-0 L-l-0 L-l-0 C-m-0 C-m-2 C-m-1 
job-9822,6,5,6,490655,490655,490846,0,191,491020,true,C-l-0 C-l-0 C-l-1 C-l-1 C-l-2 C-l-2 
job-9824,6,11,8,490758,490846,490978,88,132,491049,true,L-m-0 C-m-0 C-m-2 L-l-0 L-l-0 C-m-1 C-l-0 C-l-0 
job-9825,5,12,5,490813,490978,490994,165,16,491118,true,L-m-0 C-m-0 C-m-2 L-l-0 L-l-0 
job-9828,3,7,2,490945,490978,491010,33,32,491109,true,C-l-1 C-l-2 
job-9829,1,6,8,490993,490993,491014,0,21,491097,true,L-s-0 L-m-0 C-s-1 C-s-0 C-m-0 C-m-2 C-l-1 C-l-2 
job-9823,1,12,3,490703,490703,491017,0,314,491183,true,L-m-0 C-m-0 C-m-2 
job-9827,4,7,8,490891,490978,491041,87,63,491106,true,C-s-2 C-m-1 C-m-1 C-l-0 C-l-0 C-l-0 C-l-1 C-l-1 
job-9826,2,10,4,490859,490978,491042,119,64,490952,false,L-l-0 L-s-0 C-s-1 C-s-0 
job-9832,5,11,3,491136,491136,491209,0,73,491248,true,C-m-2 C-m-1 C-l-0 
job-9833,5,11,5,491180,491180,491226,0,46,491381,true,C-l-0 C-l-1 C-l-1 C-l-2 C-l-2 
job-9830,4,9,8,491047,491047,491315,0,268,491401,true,L-s-0 L-m-0 L-m-0 L-l-0 L-l-0 L-l-0 C-s-2 C-s-1 
job-9836,2,4,7,491323,491323,491337,0,14,491452,true,C-m-0 C-m-2 C-m-1 C-l-1 L-s-0 L-s-0 L-m-0 
job-9835,5,9,2,491284,491284,491346,0,62,491523,true,C-l-1 C-l-1 
job-9831,6,7,1,491088,491088,491365,0,277,491391,true,C-m-0 
job-9837,3,8,8,491379,491379,491448,0,69,491448,false,L-s-0 L-m-0 L-m-0 L-l-0 L-l-0 L-l-0 L-l-0 C-s-2 
job-9838,2,10,8,491423,491423,491453,0,30,491710,true,L-m-0 C-m-2 C-m-1 C-s-1 C-s-0 C-m-0 C-m-0 C-m-0 
job-9834,6,4,4,491234,491234,491485,0,251,491755,true,C-m-2 C-m-1 C-l-0 C-l-0 
job-9839,6,11,7,491456,491456,491496,0,40,491677,true,L-m-0 L-l-0 L-l-0 C-m-0 C-l-1 C-l-1 C-l-2 
job-9842,1,6,7,491608,491608,491671,0,63,491788,true,C-m-0 C-m-0 C-m-0 C-m-0 C-l-0 C-l-0 C-l-0 
job-9843,2,5,1,491663,491663,491709,0,46,491944,true,C-l-0 
job-9844,2,11,6,491717,491717,491727,0,10,491745,true,C-m-0 C-m-0 C-l-0 C-l-0 C-l-0 C-l-0 
job-9845,4,5,2,491762,491762,491773,0,11,491785,true,C-m-0 C-l-0 
job-9841,4,6,8,491548,491548,491818,0,270,492103,true,C-s-2 C-s-1 C-s-0 C-m-2 C-m-2 C-m-1 C-m-1 C-m-0 
job-9840,4,6,6,491501,491501,491840,0,339,491940,true,L-s-0 L-m-0 L-m-0 L-l-0 L-l-0 L-l-0 
job-9847,5,11,7,491872,491872,491946,0,74,491985,true,C-m-0 L-m-0 L-l-0 L-l-0 C-m-2 C-m-1 C-l-0 
job-9846,1,10,1,491813,491813,491973,0,160,492038,true,C-m-0 
job-9848,5,10,7,491916,491946,492007,30,61,492271,true,C-m-0 L-m-0 L-l-0 L-l-0 C-m-2 C-m-1 C-l-0 
job-9849,4,4,1,491956,491956,492028,0,72,492155,true,C-l-0 
job-9850,2,12,3,492023,492023,492047,0,24,492098,true,C-l-0 C-l-0 C-l-0 
job-9851,1,7,6,492081,492081,492101,0,20,492143,true,L-s-0 L-s-0 L-m-0 L-m-0 L-m-0 L-m-0 
job-9852,3,4,6,492130,492130,492159,0,29,492180,true,L-s-0 L-m-0 L-m-0 L-l-0 L-l-0 L-l-0 
job-9853,4,5,6,492190,492190,492316,0,126,492561,true,L-s-0 L-m-0 L-m-0 L-l-0 L-l-0 L-l-0 
job-9856,2,11,7,492335,492335,492360,0,25,492558,true,C-m-1 C-m-1 L-s-0 L-m-0 L-m-0 L-l-0 L-l-0 
job-9855,1,9,3,492299,492299,492371,0,72,492643,true,C-m-2 C-m-2 C-m-1 
job-9857,4,11,7,492389,492389,492426,0,37,492599,true,C-m-2 L-s-0 L-m-0 L-m-0 L-l-0 L-l-0 L-l-0 
job-9858,2,9,2,492436,492436,492532,0,96,492675,true,C-m-2 C-m-2 
job-9854,4,8,6,492247,492247,492553,0,306,492567,true,C-s-2 C-s-1 C-s-0 C-m-0 C-m-0 C-m-2 
job-9859,1,6,4,492485,492485,492611,0,126,492868,true,L-s-0 L-s-0 L-m-0 L-m-0 
job-9862,1,10,3,492634,492634,492722,0,88,492932,true,L-m-0 L-m-0 L-l-0 
job-9863,2,8,1,492686,492686,492779,0,93,492815,true,C-m-0 
job-9864,5,8,3,492728,492728,492803,0,75,492978,true,L-m-0 C-m-2 C-l-0 
job-9861,6,10,2,492586,492586,492816,0,230,493016,true,C-m-0 C-m-1 
job-9865,1,6,2,492786,492786,492840,0,54,493058,true,L-l-0 L-l-0 
job-9860,3,12,5,492533,492533,492880,0,347,493159,true,L-m-0 C-m-2 L-l-0 L-l-0 L-l-0 
job-9867,3,7,4,492868,492868,492897,0,29,492915,true,L-m-0 L-l-0 C-m-2 L-s-0 
job-9866,1,6,1,492825,492825,493028,0,203,493094,true,L-m-0 
job-9868,3,6,3,492901,492901,493032,0,131,493068,true,L-m-0 L-m-0 L-s-0 
job-9870,2,11,3,493003,493003,493064,0,61,493096,true,L-l-0 L-l-0 L-l-0 
job-9871,2,6,3,493047,493047,493184,0,137,493215,true,L-s-0 L-s-0 L-m-0 
job-9869,5,6,1,492954,492954,493241,0,287,493274,true,L-l-0 
job-9875,3,11,8,493244,493244,493282,0,38,493446,true,L-m-0 L-l-0 C-l-0 C-l-0 L-s-0 C-l-1 C-l-1 C-l-1 
job-9873,3,7,7,493151,493151,493323,0,172,493499,true,C-s-0 C-m-2 C-m-2 C-m-0 C-m-0 C-m-1 C-m-1 
job-9872,2,10,7,493105,493105,493325,0,220,493550,true,L-m-0 L-m-0 L-l-0 L-l-0 L-l-0 C-s-2 C-s-1 
job-9876,3,10,6,493296,493296,493432,0,136,493605,true,L-m-0 L-l-0 C-l-0 C-l-0 L-s-0 C-l-1 
job-9874,5,11,1,493204,493204,493523,0,319,493722,true,C-l-0 
job-9879,3,8,3,493441,493441,493554,0,113,493794,true,L-m-0 L-l-0 L-l-0 
job-9877,4,7,1,493345,493345,493590,0,245,493642,true,L-m-0 
job-9881,1,7,6,493568,493568,493624,0,56,493693,true,L-m-0 L-m-0 L-m-0 L-l-0 L-l-0 L-l-0 
job-9882,1,9,5,493611,493611,493630,0,19,493744,true,L-m-0 L-l-0 L-l-0 C-m-2 C-m-2 
job-9878,5,9,5,493386,493386,493691,0,305,493948,true,L-l-0 C-l-1 C-m-2 C-m-0 C-m-1 
job-9880,5,11,1,493505,493505,493705,0,200,493810,true,C-l-0 
job-9884,1,11,8,493731,493731,493798,0,67,493995,true,L-l-0 C-m-2 C-m-2 C-m-0 C-m-0 C-m-1 C-m-1 C-l-0 
job-9885,3,9,7,493785,493785,493865,0,80,494138,true,L-l-0 C-l-0 C-l-0 L-s-0 L-m-0 L-m-0 C-s-0 
job-9887,4,4,2,493881,493881,493891,0,10,494156,true,L-m-0 L-l-0 
job-9886,1,5,3,493832,493832,493913,0,81,493944,true,L-s-0 L-m-0 L-m-0 
job-9888,5,6,1,493935,493935,494049,0,114,494139,true,L-l-0 
job-9883,2,9,8,493671,493671,494054,0,383,494228,true,L-l-0 L-l-0 L-l-0 C-m-2 C-m-0 C-m-1 C-l-0 C-l-0 
job-9890,1,6,6,494059,494059,494092,0,33,494236,true,C-m-2 L-s-0 L-s-0 L-m-0 L-m-0 L-m-0 
job-9889,2,7,3,493995,493995,494114,0,119,494153,true,C-m-2 C-m-2 C-m-2 
job-9891,6,10,8,494099,494099,494118,0,19,494308,true,L-m-0 L-l-0 L-l-0 C-m-0 C-m-1 C-l-0 C-l-0 C-l-1 
job-9892,3,8,1,494157,494157,494206,0,49,494234,true,L-s-0 
job-9893,6,10,4,494212,494212,494222,0,10,494446,true,L-m-0 L-l-0 L-l-0 C-m-2 
job-9894,3,9,1,494259,494259,494328,0,69,494458,true,L-s-0 
job-9895,5,11,1,494305,494305,494364,0,59,494564,true,L-m-0 
job-9898,4,9,7,494444,494444,494498,0,54,494638,true,L-m-0 C-l-0 C-s-0 C-s-2 C-s-1 C-l-1 C-l-1 
job-9897,6,8,4,494405,494405,494523,0,118,494703,true,C-m-2 C-m-0 C-m-1 C-l-0 
job-9899,4,5,2,494493,494493,494555,0,62,494709,true,C-l-1 C-l-2 
job-9900,3,10,7,494541,494541,494599,0,58,494830,true,L-m-0 C-l-1 C-l-1 C-l-2 C-l-2 C-s-0 C-s-2 
job-9896,3,9,6,494361,494361,494634,0,273,494675,true,L-m-0 L-s-0 L-l-0 L-l-0 L-l-0 L-l-0 
job-9901,1,4,1,494580,494580,494674,0,94,494747,true,L-s-0 
job-9904,4,6,3,494742,494742,494766,0,24,494851,true,L-s-0 L-l-0 L-l-0 
job-9902,1,7,3,494629,494629,494778,0,149,494955,true,L-m-0 L-m-0 L-m-0 
job-9903,5,4,1,494692,494692,494869,0,177,494963,true,L-m-0 
job-9906,3,4,1,494844,494844,494883,0,39,494949,true,L-s-0 
job-9905,3,4,1,494799,494799,494899,0,100,494928,true,L-m-0 
job-9908,5,5,7,494936,494936,494985,0,49,495006,true,L-m-0 L-l-0 L-l-0 C-m-2 C-m-0 C-m-1 C-l-1 
job-9909,4,4,1,494986,494986,494998,0,12,495189,true,L-m-0 
job-9912,5,8,4,495122,495122,495251,0,129,495298,true,L-l-0 C-m-2 C-m-0 C-m-1 
job-9914,6,12,2,495221,495221,495259,0,38,495482,true,C-l-2 C-l-2 
job-9907,1,5,3,494891,494891,495267,0,376,495410,true,L-m-0 L-m-0 L-m-0 
job-9915,6,10,6,495266,495266,495279,0,13,495381,true,L-l-0 C-m-2 C-m-0 C-m-1 C-l-2 C-l-2 
job-9913,4,5,2,495173,495173,495342,0,169,495492,true,C-l-1 C-l-1 
job-9910,1,8,6,495037,495037,495414,0,377,495522,true,L-m-0 L-m-0 L-s-0 L-s-0 L-l-0 L-l-0 
job-9916,1,7,6,495318,495318,495420,0,102,495651,true,L-m-0 L-m-0 L-l-0 C-m-2 C-l-1 C-l-1 
job-9917,1,4,3,495370,495370,495423,0,53,495719,true,C-s-0 C-s-2 C-s-1 
job-9919,5,5,2,495472,495472,495486,0,14,495598,true,L-m-0 C-m-0 
job-9911,1,11,7,495074,495074,495592,0,518,495844,true,L-l-0 L-l-0 C-s-0 C-s-2 C-s-1 C-m-2 C-m-2 
job-9920,1,11,5,495524,495524,495602,0,78,495719,true,L-l-0 L-s-0 L-m-0 L-m-0 C-m-0 
job-9921,4,11,4,495577,495577,495627,0,50,495682,true,C-m-0 C-m-1 C-m-1 C-l-1 
job-9922,5,9,6,495626,495626,495672,0,46,495935,true,L-l-0 C-l-1 L-m-0 C-l-2 C-l-2 C-l-0 
job-9918,6,7,2,495425,495425,495703,0,278,495735,true,L-l-0 C-m-2 
job-9923,2,12,8,495675,495675,495724,0,49,495793,true,L-l-0 L-l-0 L-l-0 C-m-2 L-s-0 L-m-0 L-m-0 C-s-0 
job-9925,1,4,8,495768,495768,495779,0,11,496061,true,L-l-0 L-l-0 L-l-0 L-l-0 L-l-0 L-l-0 L-l-0 L-s-0 
job-9924,5,7,1,495720,495720,495830,0,110,495834,true,L-l-0 
job-9926,4,8,6,495807,495807,495873,0,66,495957,true,L-l-0 L-s-0 L-m-0 L-m-0 C-s-0 C-s-2 
job-9928,6,5,1,495901,495901,495966,0,65,496224,true,L-l-0 
job-9930,6,6,3,495993,495993,496021,0,28,496206,true,L-l-0 C-l-1 C-l-1 
job-9929,3,8,6,495948,495948,496063,0,115,496091,true,L-s-0 L-m-0 L-m-0 C-s-0 C-s-2 C-s-1 
job-9927,6,10,4,495856,495856,496067,0,211,496198,true,L-l-0 C-m-2 C-m-1 C-m-0 
job-9931,6,4,5,496044,496044,496154,0,110,496387,true,L-l-0 C-l-1 C-l-1 C-l-2 C-l-2 
job-9932,5,10,1,496097,496097,496233,0,136,496234,true,L-l-0 
job-9935,3,8,6,496236,496236,496250,0,14,496503,true,L-l-0 L-s-0 C-s-0 C-s-2 C-s-1 C-l-1 
job-9936,1,7,7,496278,496278,496299,0,21,496578,true,L-l-0 C-m-2 C-m-1 C-m-1 C-m-0 C-m-0 L-s-0 
job-9934,1,7,8,496190,496190,496377,0,187,496465,true,L-m-0 L-m-0 L-l-0 L-l-0 L-l-0 L-l-0 L-l-0 C-m-2 
job-9933,6,4,4,496138,496138,496410,0,272,496437,true,L-m-0 C-m-2 C-m-1 C-m-0 
job-9939,3,5,8,496429,496429,496522,0,93,496668,true,L-m-0 L-m-0 C-s-1 C-m-2 C-m-2 C-m-1 C-m-1 C-m-0 
job-9937,4,12,4,496326,496326,496526,0,200,496719,true,L-l-0 L-s-0 C-s-0 C-s-2 
job-9940,5,7,4,496475,496522,496564,47,42,496778,true,L-m-0 C-m-2 C-m-1 C-m-0 
job-9942,2,5,3,496559,496559,496584,0,25,496841,true,L-l-0 L-l-0 C-m-2 
job-9941,1,8,5,496515,496522,496634,7,112,496908,true,L-m-0 L-m-0 L-m-0 L-l-0 L-l-0 
job-9944,2,6,3,496645,496645,496662,0,17,496901,true,L-s-0 L-m-0 L-m-0 
job-9938,6,8,7,496382,496382,496664,0,282,496737,true,L-l-0 C-l-1 C-l-1 C-l-2 C-l-2 C-l-0 C-l-0 
job-9943,2,6,4,496611,496611,496671,0,60,496673,true,L-m-0 L-l-0 L-l-0 L-s-0 
job-9945,3,4,4,496701,496701,496724,0,23,496793,true,L-s-0 L-m-0 L-m-0 L-l-0 
job-9946,3,10,4,496758,496758,496796,0,38,496859,true,L-s-0 L-m-0 L-m-0 L-l-0 
job-9947,6,10,2,496812,496812,496857,0,45,496940,true,L-m-0 L-l-0 
job-9948,5,8,1,496875,496875,496924,0,49,496972,true,L-m-0 
job-9950,2,12,1,496963,496963,496979,0,16,497225,true,L-l-0 
job-9951,3,6,8,497000,497000,497071,0,71,497152,true,C-m-2 C-m-1 C-m-0 L-s-0 L-m-0 L-m-0 C-s-0 C-s-2 
job-9949,5,7,5,496921,496921,497081,0,160,497226,true,L-l-0 L-l-0 C-m-2 C-m-1 C-m-0 
job-9952,3,4,3,497054,497054,497128,0,74,497227,true,C-s-1 C-l-1 C-l-1 
job-9953,6,11,8,497101,497101,497168,0,67,497250,true,C-l-1 L-m-0 L-l-0 L-l-0 C-m-2 C-m-1 C-m-0 C-l-2 
job-9954,3,11,4,497149,497149,497191,0,42,497483,true,C-l-1 C-l-1 C-l-2 C-l-2 
job-9958,5,9,3,497381,497381,497396,0,15,497600,true,C-m-1 C-m-0 C-l-1 
job-9959,3,9,2,497423,497423,497477,0,54,497725,true,C-s-1 C-s-0 
job-9957,6,7,3,497331,497331,497501,0,170,497624,true,L-l-0 L-l-0 C-m-2 
job-9955,1,9,3,497216,497216,497516,0,300,497782,true,L-s-0 L-m-0 L-m-0 
job-9956,2,7,3,497278,497278,497521,0,243,497728,true,L-s-0 L-m-0 L-m-0 
job-9961,3,7,5,497530,497530,497544,0,14,497603,true,C-m-2 L-s-0 L-m-0 L-m-0 L-l-0 
job-9963,2,5,4,497627,497627,497655,0,28,497673,true,L-m-0 L-l-0 L-l-0 L-l-0 
job-9960,1,12,3,497487,497487,497656,0,169,497769,true,C-m-2 C-m-2 C-s-1 
job-9962,6,8,3,497582,497582,497689,0,107,497837,true,C-m-2 L-m-0 L-l-0 
job-9964,6,12,7,497675,497675,497743,0,68,497964,true,L-l-0 C-m-1 C-m-0 C-l-1 C-l-1 C-l-2 C-l-2 
job-9965,1,11,6,497728,497728,497812,0,84,497923,true,L-l-0 L-l-0 L-l-0 C-m-1 C-m-0 L-s-0 
job-9966,3,6,1,497768,497768,497827,0,59,497897,true,L-l-0 
job-9967,1,12,1,497814,497814,497935,0,121,498073,true,L-l-0 
job-9969,4,6,4,497909,497909,497945,0,36,498072,true,L-l-0 C-l-2 L-s-0 C-s-1 
job-9968,6,9,8,497871,497871,497981,0,110,497981,false,L-l-0 L-m-0 C-m-1 C-m-0 C-m-2 C-l-1 C-l-1 C-l-2 
job-9970,6,9,7,497967,497981,498026,14,45,498242,true,L-m-0 L-l-0 L-l-0 C-m-1 C-m-0 C-m-2 C-l-1 
job-9971,2,4,5,498019,498019,498051,0,32,498133,true,L-m-0 C-m-1 C-m-0 C-m-2 C-l-1 
job-9973,4,8,7,498106,498106,498164,0,58,498185,true,L-s-0 C-s-1 C-s-0 C-s-2 C-l-1 C-l-1 C-l-1 
job-9972,5,11,6,498065,498065,498247,0,182,498365,true,L-m-0 L-l-0 L-l-0 C-m-1 C-m-0 C-m-2 
job-9974,5,7,7,498162,498247,498276,85,29,498408,true,L-m-0 L-l-0 L-l-0 C-m-1 C-m-0 C-m-2 C-l-1 
job-9975,3,12,2,498212,498247,498302,35,55,498337,true,L-m-0 C-m-1 
job-9976,5,7,2,498258,498258,498380,0,122,498425,true,C-l-1 C-l-2 
job-9977,5,11,1,498297,498297,498396,0,99,498695,true,L-m-0 
job-9979,5,8,6,498380,498380,498428,0,48,498572,true,L-l-0 L-l-0 C-m-1 C-m-0 C-m-2 C-l-1 
job-9978,3,8,1,498338,498338,498480,0,142,498702,true,L-m-0 
job-9981,3,5,3,498489,498489,498558,0,69,498683,true,L-m-0 L-s-0 L-l-0 
job-9980,2,8,2,498436,498436,498572,0,136,498783,true,L-m-0 L-m-0 
job-9982,4,8,5,498540,498540,498605,0,65,498749,true,L-l-0 L-l-0 C-s-1 C-s-0 C-s-2 
job-9984,4,10,3,498643,498643,498662,0,19,498729,true,C-l-1 L-s-0 L-l-0 
job-9983,5,4,5,498596,498596,498768,0,172,498909,true,L-m-0 C-m-1 C-m-0 C-m-2 C-l-1 
job-9985,5,6,6,498712,498712,498814,0,102,498930,true,C-l-1 L-l-0 L-l-0 C-l-2 C-l-2 C-l-0 
job-9989,4,8,2,498887,498887,498908,0,21,499106,true,L-l-0 C-m-2 
job-9988,6,5,3,498843,498843,498935,0,92,499059,true,L-l-0 C-m-1 C-m-0 
job-9990,6,11,4,498936,498936,498983,0,47,499062,true,L-l-0 C-m-1 C-m-0 C-m-2 
job-9991,2,7,3,498996,498996,499088,0,92,499148,true,L-m-0 L-l-0 L-l-0 
job-9992,5,7,1,499032,499032,499095,0,63,499286,true,L-l-0 
job-9987,4,6,1,498796,498796,499095,0,299,499237,true,L-m-0 
job-9986,2,9,8,498757,498757,499200,0,443,499232,true,L-m-0 L-l-0 C-m-1 C-m-0 C-m-2 C-l-2 C-l-1 C-l-0 
job-9994,1,4,2,499134,499134,499210,0,76,499332,true,L-m-0 L-m-0 
job-9997,5,9,6,499259,499259,499285,0,26,499367,true,C-m-0 C-m-2 C-l-2 C-l-2 C-l-1 C-l-1 
job-9993,3,4,3,499084,499084,499286,0,202,499498,true,C-m-1 C-m-1 C-m-0 
job-9995,2,6,3,499163,499163,499292,0,129,499385,true,L-m-0 L-m-0 L-l-0 
job-9999,5,12,7,499360,499360,499481,0,121,499606,true,C-m-0 C-m-2 C-l-2 C-l-2 C-l-1 C-l-1 C-l-0 
job-9996,1,12,5,499221,499221,499503,0,282,499774,true,L-m-0 L-l-0 L-l-0 L-l-0 C-m-1 
job-9998,1,9,8,499304,499304,499660,0,356,499711,true,L-m-0 L-m-0 L-l-0 C-m-1 C-m-1 L-s-0 C-s-1 C-s-0 

Total Jobs: ,10000
Deadline Met: ,9509.0
Deadline Met Percentage: ,95.09%
